depto_id,muni_id,date,urban,rural,total
05,05001,1985-12-31,1393864,56313,1450177
05,05001,1986-12-31,1421745,56223,1477968
05,05001,1987-12-31,1453959,55886,1509845
05,05001,1988-12-31,1486275,55543,1541818
05,05001,1989-12-31,1518299,55161,1573460
05,05001,1990-12-31,1549558,54751,1604309
05,05001,1991-12-31,1580612,54316,1634928
05,05001,1992-12-31,1611509,53875,1665384
05,05001,1993-12-31,1642909,53453,1696362
05,05001,1994-12-31,1673044,52972,1726016
05,05001,1995-12-31,1704227,52534,1756761
05,05001,1996-12-31,1735720,52111,1787831
05,05001,1997-12-31,1764426,51875,1816301
05,05001,1998-12-31,1795878,51513,1847391
05,05001,1999-12-31,1826719,51146,1877865
05,05001,2000-12-31,1857106,50753,1907859
05,05001,2001-12-31,1886530,50330,1936860
05,05001,2002-12-31,1915115,49900,1965015
05,05001,2003-12-31,1943194,49446,1992640
05,05001,2004-12-31,1970901,49029,2019930
05,05001,2005-12-31,1997763,48578,2046341
05,05001,2006-12-31,2026028,48167,2074195
05,05001,2007-12-31,2053966,47805,2101771
05,05001,2008-12-31,2081896,47440,2129336
05,05001,2009-12-31,2110007,47087,2157094
05,05001,2010-12-31,2138782,46757,2185539
05,05001,2011-12-31,2167110,46439,2213549
05,05001,2012-12-31,2194586,46104,2240690
05,05001,2013-12-31,2221256,45713,2266969
05,05001,2014-12-31,2248191,45410,2293601
05,05001,2015-12-31,2275687,45104,2320791
05,05001,2016-12-31,2306197,44880,2351077
05,05001,2017-12-31,2340332,44686,2385018
05,05001,2018-12-31,2382399,44730,2427129
05,05001,2019-12-31,2439470,44075,2483545
05,05001,2020-12-31,2490164,43260,2533424
05,05001,2021-12-31,2530461,42759,2573220
05,05001,2022-12-31,2570327,42631,2612958
05,05001,2023-12-31,2611104,42625,2653729
05,05001,2024-12-31,2657772,42671,2700443
05,05001,2025-12-31,2702693,42771,2745464
05,05001,2026-12-31,2744969,42943,2787912
05,05001,2027-12-31,2784305,43180,2827485
05,05001,2028-12-31,2820664,43461,2864125
05,05001,2029-12-31,2853796,43844,2897640
05,05001,2030-12-31,2883605,44285,2927890
05,05001,2031-12-31,2911306,44770,2956076
05,05001,2032-12-31,2938162,45252,2983414
05,05001,2033-12-31,2964147,45737,3009884
05,05001,2034-12-31,2989356,46213,3035569
05,05001,2035-12-31,3013579,46685,3060264
05,05002,1985-12-31,6255,21380,27635
05,05002,1986-12-31,6317,21207,27524
05,05002,1987-12-31,6382,20941,27323
05,05002,1988-12-31,6431,20676,27107
05,05002,1989-12-31,6476,20386,26862
05,05002,1990-12-31,6524,20093,26617
05,05002,1991-12-31,6578,19796,26374
05,05002,1992-12-31,6604,19486,26090
05,05002,1993-12-31,6672,19193,25865
05,05002,1994-12-31,6717,18879,25596
05,05002,1995-12-31,6757,18574,25331
05,05002,1996-12-31,6798,18296,25094
05,05002,1997-12-31,6848,18081,24929
05,05002,1998-12-31,6885,17799,24684
05,05002,1999-12-31,6933,17521,24454
05,05002,2000-12-31,6977,17239,24216
05,05002,2001-12-31,7020,16958,23978
05,05002,2002-12-31,7047,16685,23732
05,05002,2003-12-31,7079,16389,23468
05,05002,2004-12-31,7124,16105,23229
05,05002,2005-12-31,7158,15784,22942
05,05002,2006-12-31,7183,15522,22705
05,05002,2007-12-31,7231,15261,22492
05,05002,2008-12-31,7261,14976,22237
05,05002,2009-12-31,7302,14724,22026
05,05002,2010-12-31,7335,14487,21822
05,05002,2011-12-31,7380,14239,21619
05,05002,2012-12-31,7408,13963,21371
05,05002,2013-12-31,7453,13713,21166
05,05002,2014-12-31,7473,13469,20942
05,05002,2015-12-31,7498,13220,20718
05,05002,2016-12-31,7538,12996,20534
05,05002,2017-12-31,7651,12786,20437
05,05002,2018-12-31,7674,12693,20367
05,05002,2019-12-31,7777,12481,20258
05,05002,2020-12-31,7910,12377,20287
05,05002,2021-12-31,8365,12237,20602
05,05002,2022-12-31,8721,12199,20920
05,05002,2023-12-31,9048,12198,21246
05,05002,2024-12-31,9231,12213,21444
05,05002,2025-12-31,9381,12252,21633
05,05002,2026-12-31,9529,12289,21818
05,05002,2027-12-31,9671,12352,22023
05,05002,2028-12-31,9789,12443,22232
05,05002,2029-12-31,9907,12558,22465
05,05002,2030-12-31,10005,12679,22684
05,05002,2031-12-31,10104,12804,22908
05,05002,2032-12-31,10201,12934,23135
05,05002,2033-12-31,10295,13081,23376
05,05002,2034-12-31,10377,13233,23610
05,05002,2035-12-31,10452,13352,23804
05,05004,1985-12-31,531,2320,2851
05,05004,1986-12-31,525,2316,2841
05,05004,1987-12-31,552,2301,2853
05,05004,1988-12-31,596,2283,2879
05,05004,1989-12-31,578,2259,2837
05,05004,1990-12-31,587,2228,2815
05,05004,1991-12-31,615,2212,2827
05,05004,1992-12-31,616,2199,2815
05,05004,1993-12-31,612,2192,2804
05,05004,1994-12-31,653,2169,2822
05,05004,1995-12-31,636,2148,2784
05,05004,1996-12-31,628,2143,2771
05,05004,1997-12-31,636,2139,2775
05,05004,1998-12-31,653,2123,2776
05,05004,1999-12-31,640,2097,2737
05,05004,2000-12-31,683,2075,2758
05,05004,2001-12-31,664,2061,2725
05,05004,2002-12-31,681,2051,2732
05,05004,2003-12-31,693,2037,2730
05,05004,2004-12-31,715,2017,2732
05,05004,2005-12-31,723,1996,2719
05,05004,2006-12-31,692,1960,2652
05,05004,2007-12-31,692,1957,2649
05,05004,2008-12-31,696,1960,2656
05,05004,2009-12-31,707,1956,2663
05,05004,2010-12-31,716,1939,2655
05,05004,2011-12-31,731,1941,2672
05,05004,2012-12-31,735,1933,2668
05,05004,2013-12-31,756,1936,2692
05,05004,2014-12-31,766,1895,2661
05,05004,2015-12-31,773,1857,2630
05,05004,2016-12-31,783,1846,2629
05,05004,2017-12-31,800,1852,2652
05,05004,2018-12-31,824,1871,2695
05,05004,2019-12-31,833,1877,2710
05,05004,2020-12-31,847,1888,2735
05,05004,2021-12-31,910,1867,2777
05,05004,2022-12-31,959,1861,2820
05,05004,2023-12-31,1003,1861,2864
05,05004,2024-12-31,1013,1865,2878
05,05004,2025-12-31,1034,1869,2903
05,05004,2026-12-31,1054,1872,2926
05,05004,2027-12-31,1066,1885,2951
05,05004,2028-12-31,1079,1900,2979
05,05004,2029-12-31,1094,1906,3000
05,05004,2030-12-31,1107,1934,3041
05,05004,2031-12-31,1118,1942,3060
05,05004,2032-12-31,1134,1968,3102
05,05004,2033-12-31,1139,1989,3128
05,05004,2034-12-31,1146,2018,3164
05,05004,2035-12-31,1155,2036,3191
05,05021,1985-12-31,1624,3340,4964
05,05021,1986-12-31,1638,3323,4961
05,05021,1987-12-31,1688,3270,4958
05,05021,1988-12-31,1733,3240,4973
05,05021,1989-12-31,1750,3202,4952
05,05021,1990-12-31,1780,3158,4938
05,05021,1991-12-31,1803,3118,4921
05,05021,1992-12-31,1820,3077,4897
05,05021,1993-12-31,1851,3030,4881
05,05021,1994-12-31,1886,3001,4887
05,05021,1995-12-31,1863,2952,4815
05,05021,1996-12-31,1915,2918,4833
05,05021,1997-12-31,1931,2883,4814
05,05021,1998-12-31,1961,2853,4814
05,05021,1999-12-31,2004,2829,4833
05,05021,2000-12-31,2018,2775,4793
05,05021,2001-12-31,2040,2745,4785
05,05021,2002-12-31,2065,2696,4761
05,05021,2003-12-31,2077,2669,4746
05,05021,2004-12-31,2125,2630,4755
05,05021,2005-12-31,2137,2587,4724
05,05021,2006-12-31,2186,2539,4725
05,05021,2007-12-31,2201,2496,4697
05,05021,2008-12-31,2221,2458,4679
05,05021,2009-12-31,2251,2443,4694
05,05021,2010-12-31,2278,2401,4679
05,05021,2011-12-31,2299,2379,4678
05,05021,2012-12-31,2324,2325,4649
05,05021,2013-12-31,2365,2307,4672
05,05021,2014-12-31,2387,2287,4674
05,05021,2015-12-31,2411,2269,4680
05,05021,2016-12-31,2394,2226,4620
05,05021,2017-12-31,2437,2163,4600
05,05021,2018-12-31,2485,2172,4657
05,05021,2019-12-31,2564,2105,4669
05,05021,2020-12-31,2637,2061,4698
05,05021,2021-12-31,2734,2037,4771
05,05021,2022-12-31,2814,2031,4845
05,05021,2023-12-31,2889,2031,4920
05,05021,2024-12-31,2933,2026,4959
05,05021,2025-12-31,2991,2041,5032
05,05021,2026-12-31,3025,2048,5073
05,05021,2027-12-31,3082,2051,5133
05,05021,2028-12-31,3128,2067,5195
05,05021,2029-12-31,3163,2094,5257
05,05021,2030-12-31,3188,2110,5298
05,05021,2031-12-31,3231,2130,5361
05,05021,2032-12-31,3256,2151,5407
05,05021,2033-12-31,3282,2174,5456
05,05021,2034-12-31,3318,2199,5517
05,05021,2035-12-31,3337,2228,5565
05,05030,1985-12-31,8499,14042,22541
05,05030,1986-12-31,8645,14178,22823
05,05030,1987-12-31,8847,14238,23085
05,05030,1988-12-31,9059,14313,23372
05,05030,1989-12-31,9260,14377,23637
05,05030,1990-12-31,9406,14427,23833
05,05030,1991-12-31,9604,14484,24088
05,05030,1992-12-31,9795,14521,24316
05,05030,1993-12-31,9991,14570,24561
05,05030,1994-12-31,10180,14590,24770
05,05030,1995-12-31,10355,14640,24995
05,05030,1996-12-31,10515,14686,25201
05,05030,1997-12-31,10691,14781,25472
05,05030,1998-12-31,10858,14841,25699
05,05030,1999-12-31,11044,14893,25937
05,05030,2000-12-31,11213,14961,26174
05,05030,2001-12-31,11372,14975,26347
05,05030,2002-12-31,11535,15038,26573
05,05030,2003-12-31,11690,15043,26733
05,05030,2004-12-31,11844,15095,26939
05,05030,2005-12-31,11998,15123,27121
05,05030,2006-12-31,12153,15155,27308
05,05030,2007-12-31,12308,15174,27482
05,05030,2008-12-31,12466,15259,27725
05,05030,2009-12-31,12618,15302,27920
05,05030,2010-12-31,12793,15339,28132
05,05030,2011-12-31,12960,15394,28354
05,05030,2012-12-31,13047,15435,28482
05,05030,2013-12-31,13224,15556,28780
05,05030,2014-12-31,13331,15557,28888
05,05030,2015-12-31,13547,15589,29136
05,05030,2016-12-31,13730,15664,29394
05,05030,2017-12-31,13899,15764,29663
05,05030,2018-12-31,14184,16043,30227
05,05030,2019-12-31,14732,16045,30777
05,05030,2020-12-31,15246,16037,31283
05,05030,2021-12-31,15912,15856,31768
05,05030,2022-12-31,16452,15807,32259
05,05030,2023-12-31,16957,15805,32762
05,05030,2024-12-31,17286,15827,33113
05,05030,2025-12-31,17581,15862,33443
05,05030,2026-12-31,17852,15917,33769
05,05030,2027-12-31,18111,16008,34119
05,05030,2028-12-31,18343,16121,34464
05,05030,2029-12-31,18573,16250,34823
05,05030,2030-12-31,18762,16416,35178
05,05030,2031-12-31,18949,16608,35557
05,05030,2032-12-31,19110,16797,35907
05,05030,2033-12-31,19268,16974,36242
05,05030,2034-12-31,19440,17140,36580
05,05030,2035-12-31,19599,17304,36903
05,05031,1985-12-31,6857,11518,18375
05,05031,1986-12-31,7079,11581,18660
05,05031,1987-12-31,7327,11560,18887
05,05031,1988-12-31,7610,11577,19187
05,05031,1989-12-31,7858,11566,19424
05,05031,1990-12-31,8114,11562,19676
05,05031,1991-12-31,8341,11542,19883
05,05031,1992-12-31,8577,11518,20095
05,05031,1993-12-31,8815,11511,20326
05,05031,1994-12-31,9036,11483,20519
05,05031,1995-12-31,9273,11461,20734
05,05031,1996-12-31,9509,11457,20966
05,05031,1997-12-31,9735,11470,21205
05,05031,1998-12-31,9970,11473,21443
05,05031,1999-12-31,10217,11478,21695
05,05031,2000-12-31,10454,11451,21905
05,05031,2001-12-31,10680,11445,22125
05,05031,2002-12-31,10900,11427,22327
05,05031,2003-12-31,11118,11403,22521
05,05031,2004-12-31,11333,11390,22723
05,05031,2005-12-31,11556,11377,22933
05,05031,2006-12-31,11768,11365,23133
05,05031,2007-12-31,11985,11345,23330
05,05031,2008-12-31,12204,11331,23535
05,05031,2009-12-31,12433,11339,23772
05,05031,2010-12-31,12653,11333,23986
05,05031,2011-12-31,12864,11292,24156
05,05031,2012-12-31,13029,11303,24332
05,05031,2013-12-31,13225,11323,24548
05,05031,2014-12-31,13454,11299,24753
05,05031,2015-12-31,13679,11272,24951
05,05031,2016-12-31,13902,11292,25194
05,05031,2017-12-31,14170,11348,25518
05,05031,2018-12-31,14508,11454,25962
05,05031,2019-12-31,15071,11481,26552
05,05031,2020-12-31,15599,11472,27071
05,05031,2021-12-31,16154,11342,27496
05,05031,2022-12-31,16614,11307,27921
05,05031,2023-12-31,17051,11306,28357
05,05031,2024-12-31,17377,11314,28691
05,05031,2025-12-31,17676,11347,29023
05,05031,2026-12-31,17956,11386,29342
05,05031,2027-12-31,18212,11447,29659
05,05031,2028-12-31,18455,11527,29982
05,05031,2029-12-31,18656,11629,30285
05,05031,2030-12-31,18865,11754,30619
05,05031,2031-12-31,19033,11884,30917
05,05031,2032-12-31,19211,11995,31206
05,05031,2033-12-31,19395,12131,31526
05,05031,2034-12-31,19551,12240,31791
05,05031,2035-12-31,19704,12373,32077
05,05034,1985-12-31,13848,26557,40405
05,05034,1986-12-31,13996,26577,40573
05,05034,1987-12-31,14185,26464,40649
05,05034,1988-12-31,14458,26367,40825
05,05034,1989-12-31,14643,26250,40893
05,05034,1990-12-31,14877,26113,40990
05,05034,1991-12-31,15104,25970,41074
05,05034,1992-12-31,15318,25829,41147
05,05034,1993-12-31,15526,25678,41204
05,05034,1994-12-31,15692,25524,41216
05,05034,1995-12-31,15890,25377,41267
05,05034,1996-12-31,16117,25242,41359
05,05034,1997-12-31,16239,25188,41427
05,05034,1998-12-31,16495,25065,41560
05,05034,1999-12-31,16681,24953,41634
05,05034,2000-12-31,16897,24834,41731
05,05034,2001-12-31,17090,24690,41780
05,05034,2002-12-31,17274,24540,41814
05,05034,2003-12-31,17421,24406,41827
05,05034,2004-12-31,17639,24262,41901
05,05034,2005-12-31,17793,24083,41876
05,05034,2006-12-31,17977,23936,41913
05,05034,2007-12-31,18129,23823,41952
05,05034,2008-12-31,18285,23680,41965
05,05034,2009-12-31,18465,23609,42074
05,05034,2010-12-31,18628,23524,42152
05,05034,2011-12-31,18788,23385,42173
05,05034,2012-12-31,18960,23297,42257
05,05034,2013-12-31,19136,23148,42284
05,05034,2014-12-31,19317,23076,42393
05,05034,2015-12-31,19498,23007,42505
05,05034,2016-12-31,19714,22969,42683
05,05034,2017-12-31,19895,22922,42817
05,05034,2018-12-31,20250,23019,43269
05,05034,2019-12-31,20851,22862,43713
05,05034,2020-12-31,21456,22743,44199
05,05034,2021-12-31,22399,22486,44885
05,05034,2022-12-31,23160,22417,45577
05,05034,2023-12-31,23875,22414,46289
05,05034,2024-12-31,24341,22441,46782
05,05034,2025-12-31,24744,22487,47231
05,05034,2026-12-31,25137,22569,47706
05,05034,2027-12-31,25494,22700,48194
05,05034,2028-12-31,25835,22863,48698
05,05034,2029-12-31,26133,23049,49182
05,05034,2030-12-31,26412,23282,49694
05,05034,2031-12-31,26666,23546,50212
05,05034,2032-12-31,26925,23795,50720
05,05034,2033-12-31,27153,24035,51188
05,05034,2034-12-31,27387,24282,51669
05,05034,2035-12-31,27621,24554,52175
05,05036,1985-12-31,1322,4885,6207
05,05036,1986-12-31,1345,4871,6216
05,05036,1987-12-31,1374,4834,6208
05,05036,1988-12-31,1397,4807,6204
05,05036,1989-12-31,1422,4757,6179
05,05036,1990-12-31,1460,4707,6167
05,05036,1991-12-31,1490,4643,6133
05,05036,1992-12-31,1507,4603,6110
05,05036,1993-12-31,1533,4553,6086
05,05036,1994-12-31,1549,4523,6072
05,05036,1995-12-31,1591,4449,6040
05,05036,1996-12-31,1609,4417,6026
05,05036,1997-12-31,1629,4374,6003
05,05036,1998-12-31,1662,4346,6008
05,05036,1999-12-31,1689,4255,5944
05,05036,2000-12-31,1711,4262,5973
05,05036,2001-12-31,1704,4218,5922
05,05036,2002-12-31,1750,4173,5923
05,05036,2003-12-31,1773,4130,5903
05,05036,2004-12-31,1804,4070,5874
05,05036,2005-12-31,1830,4035,5865
05,05036,2006-12-31,1868,4000,5868
05,05036,2007-12-31,1887,3945,5832
05,05036,2008-12-31,1926,3887,5813
05,05036,2009-12-31,1944,3849,5793
05,05036,2010-12-31,1971,3824,5795
05,05036,2011-12-31,2002,3799,5801
05,05036,2012-12-31,2019,3765,5784
05,05036,2013-12-31,2046,3727,5773
05,05036,2014-12-31,2080,3705,5785
05,05036,2015-12-31,2106,3690,5796
05,05036,2016-12-31,2107,3674,5781
05,05036,2017-12-31,2175,3570,5745
05,05036,2018-12-31,2168,3588,5756
05,05036,2019-12-31,2252,3538,5790
05,05036,2020-12-31,2331,3510,5841
05,05036,2021-12-31,2462,3470,5932
05,05036,2022-12-31,2563,3460,6023
05,05036,2023-12-31,2658,3459,6117
05,05036,2024-12-31,2707,3459,6166
05,05036,2025-12-31,2755,3474,6229
05,05036,2026-12-31,2799,3486,6285
05,05036,2027-12-31,2830,3507,6337
05,05036,2028-12-31,2876,3523,6399
05,05036,2029-12-31,2901,3555,6456
05,05036,2030-12-31,2942,3596,6538
05,05036,2031-12-31,2962,3633,6595
05,05036,2032-12-31,2997,3676,6673
05,05036,2033-12-31,3033,3711,6744
05,05036,2034-12-31,3046,3751,6797
05,05036,2035-12-31,3072,3790,6862
05,05038,1985-12-31,2109,11545,13654
05,05038,1986-12-31,2104,11512,13616
05,05038,1987-12-31,2142,11435,13577
05,05038,1988-12-31,2181,11353,13534
05,05038,1989-12-31,2222,11258,13480
05,05038,1990-12-31,2209,11165,13374
05,05038,1991-12-31,2234,11067,13301
05,05038,1992-12-31,2242,10960,13202
05,05038,1993-12-31,2258,10870,13128
05,05038,1994-12-31,2270,10757,13027
05,05038,1995-12-31,2267,10656,12923
05,05038,1996-12-31,2278,10567,12845
05,05038,1997-12-31,2303,10507,12810
05,05038,1998-12-31,2329,10413,12742
05,05038,1999-12-31,2325,10315,12640
05,05038,2000-12-31,2355,10230,12585
05,05038,2001-12-31,2374,10140,12514
05,05038,2002-12-31,2375,10044,12419
05,05038,2003-12-31,2377,9946,12323
05,05038,2004-12-31,2416,9860,12276
05,05038,2005-12-31,2434,9759,12193
05,05038,2006-12-31,2440,9662,12102
05,05038,2007-12-31,2463,9577,12040
05,05038,2008-12-31,2474,9494,11968
05,05038,2009-12-31,2485,9427,11912
05,05038,2010-12-31,2502,9351,11853
05,05038,2011-12-31,2522,9266,11788
05,05038,2012-12-31,2524,9170,11694
05,05038,2013-12-31,2543,9118,11661
05,05038,2014-12-31,2569,9017,11586
05,05038,2015-12-31,2595,8943,11538
05,05038,2016-12-31,2610,8876,11486
05,05038,2017-12-31,2565,8831,11396
05,05038,2018-12-31,2628,8809,11437
05,05038,2019-12-31,2634,8828,11462
05,05038,2020-12-31,2658,8878,11536
05,05038,2021-12-31,2937,8778,11715
05,05038,2022-12-31,3145,8751,11896
05,05038,2023-12-31,3331,8750,12081
05,05038,2024-12-31,3389,8755,12144
05,05038,2025-12-31,3449,8778,12227
05,05038,2026-12-31,3497,8819,12316
05,05038,2027-12-31,3555,8854,12409
05,05038,2028-12-31,3610,8921,12531
05,05038,2029-12-31,3650,8992,12642
05,05038,2030-12-31,3675,9085,12760
05,05038,2031-12-31,3711,9186,12897
05,05038,2032-12-31,3748,9281,13029
05,05038,2033-12-31,3797,9381,13178
05,05038,2034-12-31,3810,9483,13293
05,05038,2035-12-31,3844,9578,13422
05,05040,1985-12-31,2461,9731,12192
05,05040,1986-12-31,2617,9803,12420
05,05040,1987-12-31,2771,9838,12609
05,05040,1988-12-31,2950,9880,12830
05,05040,1989-12-31,3111,9911,13022
05,05040,1990-12-31,3272,9937,13209
05,05040,1991-12-31,3415,9950,13365
05,05040,1992-12-31,3570,9975,13545
05,05040,1993-12-31,3731,9982,13713
05,05040,1994-12-31,3893,9982,13875
05,05040,1995-12-31,4056,10003,14059
05,05040,1996-12-31,4217,10027,14244
05,05040,1997-12-31,4367,10072,14439
05,05040,1998-12-31,4534,10070,14604
05,05040,1999-12-31,4687,10123,14810
05,05040,2000-12-31,4848,10156,15004
05,05040,2001-12-31,5012,10168,15180
05,05040,2002-12-31,5167,10197,15364
05,05040,2003-12-31,5320,10201,15521
05,05040,2004-12-31,5476,10199,15675
05,05040,2005-12-31,5622,10231,15853
05,05040,2006-12-31,5783,10263,16046
05,05040,2007-12-31,5929,10244,16173
05,05040,2008-12-31,6079,10305,16384
05,05040,2009-12-31,6232,10341,16573
05,05040,2010-12-31,6367,10366,16733
05,05040,2011-12-31,6532,10376,16908
05,05040,2012-12-31,6672,10400,17072
05,05040,2013-12-31,6833,10431,17264
05,05040,2014-12-31,6945,10438,17383
05,05040,2015-12-31,7080,10454,17534
05,05040,2016-12-31,7232,10491,17723
05,05040,2017-12-31,7422,10569,17991
05,05040,2018-12-31,7634,10687,18321
05,05040,2019-12-31,8003,10734,18737
05,05040,2020-12-31,8335,10769,19104
05,05040,2021-12-31,8757,10647,19404
05,05040,2022-12-31,9090,10614,19704
05,05040,2023-12-31,9398,10613,20011
05,05040,2024-12-31,9584,10626,20210
05,05040,2025-12-31,9742,10648,20390
05,05040,2026-12-31,9889,10697,20586
05,05040,2027-12-31,10033,10756,20789
05,05040,2028-12-31,10167,10830,20997
05,05040,2029-12-31,10291,10924,21215
05,05040,2030-12-31,10407,11033,21440
05,05040,2031-12-31,10488,11155,21643
05,05040,2032-12-31,10589,11272,21861
05,05040,2033-12-31,10683,11396,22079
05,05040,2034-12-31,10782,11511,22293
05,05040,2035-12-31,10860,11628,22488
05,05042,1985-12-31,8199,11293,19492
05,05042,1986-12-31,8428,11315,19743
05,05042,1987-12-31,8711,11274,19985
05,05042,1988-12-31,8978,11233,20211
05,05042,1989-12-31,9275,11173,20448
05,05042,1990-12-31,9540,11117,20657
05,05042,1991-12-31,9791,11050,20841
05,05042,1992-12-31,10044,11001,21045
05,05042,1993-12-31,10298,10945,21243
05,05042,1994-12-31,10533,10868,21401
05,05042,1995-12-31,10791,10818,21609
05,05042,1996-12-31,11040,10747,21787
05,05042,1997-12-31,11274,10745,22019
05,05042,1998-12-31,11539,10706,22245
05,05042,1999-12-31,11799,10633,22432
05,05042,2000-12-31,12049,10556,22605
05,05042,2001-12-31,12290,10485,22775
05,05042,2002-12-31,12512,10449,22961
05,05042,2003-12-31,12746,10373,23119
05,05042,2004-12-31,12976,10320,23296
05,05042,2005-12-31,13187,10270,23457
05,05042,2006-12-31,13434,10221,23655
05,05042,2007-12-31,13638,10155,23793
05,05042,2008-12-31,13881,10108,23989
05,05042,2009-12-31,14108,10075,24183
05,05042,2010-12-31,14345,10036,24381
05,05042,2011-12-31,14552,9970,24522
05,05042,2012-12-31,14777,9921,24698
05,05042,2013-12-31,14989,9889,24878
05,05042,2014-12-31,15221,9854,25075
05,05042,2015-12-31,15464,9788,25252
05,05042,2016-12-31,15721,9741,25462
05,05042,2017-12-31,15999,9809,25808
05,05042,2018-12-31,16351,9813,26164
05,05042,2019-12-31,16985,9613,26598
05,05042,2020-12-31,17580,9422,27002
05,05042,2021-12-31,18107,9314,27421
05,05042,2022-12-31,18559,9285,27844
05,05042,2023-12-31,18995,9284,28279
05,05042,2024-12-31,19358,9284,28642
05,05042,2025-12-31,19696,9320,29016
05,05042,2026-12-31,20001,9359,29360
05,05042,2027-12-31,20288,9400,29688
05,05042,2028-12-31,20551,9464,30015
05,05042,2029-12-31,20795,9555,30350
05,05042,2030-12-31,21003,9644,30647
05,05042,2031-12-31,21221,9746,30967
05,05042,2032-12-31,21408,9858,31266
05,05042,2033-12-31,21603,9958,31561
05,05042,2034-12-31,21785,10058,31843
05,05042,2035-12-31,21963,10166,32129
05,05044,1985-12-31,802,5893,6695
05,05044,1986-12-31,824,5921,6745
05,05044,1987-12-31,836,5920,6756
05,05044,1988-12-31,862,5914,6776
05,05044,1989-12-31,875,5908,6783
05,05044,1990-12-31,886,5909,6795
05,05044,1991-12-31,902,5900,6802
05,05044,1992-12-31,914,5877,6791
05,05044,1993-12-31,925,5876,6801
05,05044,1994-12-31,938,5849,6787
05,05044,1995-12-31,943,5846,6789
05,05044,1996-12-31,949,5807,6756
05,05044,1997-12-31,982,5817,6799
05,05044,1998-12-31,974,5810,6784
05,05044,1999-12-31,1001,5799,6800
05,05044,2000-12-31,999,5798,6797
05,05044,2001-12-31,1018,5795,6813
05,05044,2002-12-31,1029,5789,6818
05,05044,2003-12-31,1038,5768,6806
05,05044,2004-12-31,1046,5758,6804
05,05044,2005-12-31,1081,5749,6830
05,05044,2006-12-31,1086,5726,6812
05,05044,2007-12-31,1093,5747,6840
05,05044,2008-12-31,1110,5755,6865
05,05044,2009-12-31,1121,5718,6839
05,05044,2010-12-31,1120,5692,6812
05,05044,2011-12-31,1142,5713,6855
05,05044,2012-12-31,1158,5722,6880
05,05044,2013-12-31,1174,5720,6894
05,05044,2014-12-31,1187,5718,6905
05,05044,2015-12-31,1198,5778,6976
05,05044,2016-12-31,1215,5746,6961
05,05044,2017-12-31,1235,5735,6970
05,05044,2018-12-31,1258,5752,7010
05,05044,2019-12-31,1294,5791,7085
05,05044,2020-12-31,1330,5839,7169
05,05044,2021-12-31,1507,5773,7280
05,05044,2022-12-31,1638,5755,7393
05,05044,2023-12-31,1753,5755,7508
05,05044,2024-12-31,1789,5758,7547
05,05044,2025-12-31,1811,5783,7594
05,05044,2026-12-31,1840,5806,7646
05,05044,2027-12-31,1876,5833,7709
05,05044,2028-12-31,1904,5868,7772
05,05044,2029-12-31,1925,5918,7843
05,05044,2030-12-31,1938,5986,7924
05,05044,2031-12-31,1954,6036,7990
05,05044,2032-12-31,1969,6124,8093
05,05044,2033-12-31,1996,6168,8164
05,05044,2034-12-31,2009,6241,8250
05,05044,2035-12-31,2033,6314,8347
05,05045,1985-12-31,28526,17532,46058
05,05045,1986-12-31,30606,17770,48376
05,05045,1987-12-31,32764,17960,50724
05,05045,1988-12-31,34930,18119,53049
05,05045,1989-12-31,37119,18283,55402
05,05045,1990-12-31,39294,18425,57719
05,05045,1991-12-31,41447,18570,60017
05,05045,1992-12-31,43602,18696,62298
05,05045,1993-12-31,45790,18835,64625
05,05045,1994-12-31,47908,18964,66872
05,05045,1995-12-31,50066,19083,69149
05,05045,1996-12-31,52260,19220,71480
05,05045,1997-12-31,54334,19413,73747
05,05045,1998-12-31,56514,19594,76108
05,05045,1999-12-31,58674,19722,78396
05,05045,2000-12-31,60823,19870,80693
05,05045,2001-12-31,62953,20009,82962
05,05045,2002-12-31,65038,20125,85163
05,05045,2003-12-31,67113,20240,87353
05,05045,2004-12-31,69159,20364,89523
05,05045,2005-12-31,71208,20469,91677
05,05045,2006-12-31,73254,20597,93851
05,05045,2007-12-31,75274,20716,95990
05,05045,2008-12-31,77294,20830,98124
05,05045,2009-12-31,79321,20961,100282
05,05045,2010-12-31,81372,21097,102469
05,05045,2011-12-31,83440,21263,104703
05,05045,2012-12-31,85424,21409,106833
05,05045,2013-12-31,87402,21508,108910
05,05045,2014-12-31,89401,21687,111088
05,05045,2015-12-31,91400,21843,113243
05,05045,2016-12-31,93523,22032,115555
05,05045,2017-12-31,95815,22249,118064
05,05045,2018-12-31,98454,22549,121003
05,05045,2019-12-31,102946,21701,124647
05,05045,2020-12-31,107271,20473,127744
05,05045,2021-12-31,109514,20237,129751
05,05045,2022-12-31,111579,20175,131754
05,05045,2023-12-31,113638,20173,133811
05,05045,2024-12-31,115713,20195,135908
05,05045,2025-12-31,117676,20246,137922
05,05045,2026-12-31,119520,20323,139843
05,05045,2027-12-31,121232,20433,141665
05,05045,2028-12-31,122809,20571,143380
05,05045,2029-12-31,124257,20750,145007
05,05045,2030-12-31,125539,20970,146509
05,05045,2031-12-31,126747,21193,147940
05,05045,2032-12-31,127913,21414,149327
05,05045,2033-12-31,129050,21642,150692
05,05045,2034-12-31,130150,21886,152036
05,05045,2035-12-31,131195,22087,153282
05,05051,1985-12-31,6434,33334,39768
05,05051,1986-12-31,6534,23088,29622
05,05051,1987-12-31,6636,22986,29622
05,05051,1988-12-31,6823,22892,29715
05,05051,1989-12-31,6908,22775,29683
05,05051,1990-12-31,7027,22649,29676
05,05051,1991-12-31,7127,22510,29637
05,05051,1992-12-31,7226,22373,29599
05,05051,1993-12-31,7337,22227,29564
05,05051,1994-12-31,7423,22085,29508
05,05051,1995-12-31,7529,21936,29465
05,05051,1996-12-31,7636,21798,29434
05,05051,1997-12-31,7731,21733,29464
05,05051,1998-12-31,7833,21639,29472
05,05051,1999-12-31,7943,21523,29466
05,05051,2000-12-31,8051,21398,29449
05,05051,2001-12-31,8149,21266,29415
05,05051,2002-12-31,8243,21115,29358
05,05051,2003-12-31,8344,21021,29365
05,05051,2004-12-31,8421,20871,29292
05,05051,2005-12-31,8518,20711,29229
05,05051,2006-12-31,8601,20588,29189
05,05051,2007-12-31,8686,20442,29128
05,05051,2008-12-31,8778,20292,29070
05,05051,2009-12-31,8878,20197,29075
05,05051,2010-12-31,8965,20087,29052
05,05051,2011-12-31,9063,19996,29059
05,05051,2012-12-31,9166,19883,29049
05,05051,2013-12-31,9206,19743,28949
05,05051,2014-12-31,9274,19639,28913
05,05051,2015-12-31,9345,19572,28917
05,05051,2016-12-31,9479,19502,28981
05,05051,2017-12-31,9580,19465,29045
05,05051,2018-12-31,9747,19548,29295
05,05051,2019-12-31,10110,19832,29942
05,05051,2020-12-31,10450,20060,30510
05,05051,2021-12-31,11151,19833,30984
05,05051,2022-12-31,11690,19772,31462
05,05051,2023-12-31,12183,19770,31953
05,05051,2024-12-31,12422,19797,32219
05,05051,2025-12-31,12634,19835,32469
05,05051,2026-12-31,12826,19909,32735
05,05051,2027-12-31,13013,20019,33032
05,05051,2028-12-31,13179,20168,33347
05,05051,2029-12-31,13333,20322,33655
05,05051,2030-12-31,13478,20534,34012
05,05051,2031-12-31,13601,20765,34366
05,05051,2032-12-31,13730,20980,34710
05,05051,2033-12-31,13847,21210,35057
05,05051,2034-12-31,13960,21422,35382
05,05051,2035-12-31,14082,21654,35736
05,05055,1985-12-31,2367,10498,12865
05,05055,1986-12-31,2383,10354,12737
05,05055,1987-12-31,2460,10156,12616
05,05055,1988-12-31,2486,9965,12451
05,05055,1989-12-31,2522,9770,12292
05,05055,1990-12-31,2546,9551,12097
05,05055,1991-12-31,2567,9339,11906
05,05055,1992-12-31,2604,9141,11745
05,05055,1993-12-31,2629,8941,11570
05,05055,1994-12-31,2672,8734,11406
05,05055,1995-12-31,2671,8498,11169
05,05055,1996-12-31,2703,8301,11004
05,05055,1997-12-31,2748,8138,10886
05,05055,1998-12-31,2773,7934,10707
05,05055,1999-12-31,2835,7749,10584
05,05055,2000-12-31,2865,7544,10409
05,05055,2001-12-31,2902,7345,10247
05,05055,2002-12-31,2931,7152,10083
05,05055,2003-12-31,2960,6958,9918
05,05055,2004-12-31,2991,6761,9752
05,05055,2005-12-31,3018,6571,9589
05,05055,2006-12-31,3047,6375,9422
05,05055,2007-12-31,3061,6200,9261
05,05055,2008-12-31,3095,6018,9113
05,05055,2009-12-31,3120,5821,8941
05,05055,2010-12-31,3152,5637,8789
05,05055,2011-12-31,3193,5469,8662
05,05055,2012-12-31,3222,5282,8504
05,05055,2013-12-31,3258,5106,8364
05,05055,2014-12-31,3298,4940,8238
05,05055,2015-12-31,3319,4779,8098
05,05055,2016-12-31,3327,4602,7929
05,05055,2017-12-31,3337,4434,7771
05,05055,2018-12-31,3412,4277,7689
05,05055,2019-12-31,3473,4104,7577
05,05055,2020-12-31,3545,4000,7545
05,05055,2021-12-31,3708,3954,7662
05,05055,2022-12-31,3838,3942,7780
05,05055,2023-12-31,3961,3941,7902
05,05055,2024-12-31,4033,3942,7975
05,05055,2025-12-31,4104,3947,8051
05,05055,2026-12-31,4169,3968,8137
05,05055,2027-12-31,4229,3995,8224
05,05055,2028-12-31,4278,4012,8290
05,05055,2029-12-31,4334,4052,8386
05,05055,2030-12-31,4380,4090,8470
05,05055,2031-12-31,4427,4141,8568
05,05055,2032-12-31,4464,4180,8644
05,05055,2033-12-31,4506,4225,8731
05,05055,2034-12-31,4533,4283,8816
05,05055,2035-12-31,4584,4322,8906
05,05059,1985-12-31,1652,5884,7536
05,05059,1986-12-31,1655,5844,7499
05,05059,1987-12-31,1630,5769,7399
05,05059,1988-12-31,1648,5681,7329
05,05059,1989-12-31,1678,5567,7245
05,05059,1990-12-31,1701,5503,7204
05,05059,1991-12-31,1671,5410,7081
05,05059,1992-12-31,1680,5334,7014
05,05059,1993-12-31,1675,5254,6929
05,05059,1994-12-31,1669,5149,6818
05,05059,1995-12-31,1696,5076,6772
05,05059,1996-12-31,1657,4971,6628
05,05059,1997-12-31,1658,4931,6589
05,05059,1998-12-31,1689,4841,6530
05,05059,1999-12-31,1685,4777,6462
05,05059,2000-12-31,1699,4696,6395
05,05059,2001-12-31,1698,4622,6320
05,05059,2002-12-31,1696,4551,6247
05,05059,2003-12-31,1709,4469,6178
05,05059,2004-12-31,1703,4371,6074
05,05059,2005-12-31,1667,4297,5964
05,05059,2006-12-31,1690,4221,5911
05,05059,2007-12-31,1714,4151,5865
05,05059,2008-12-31,1708,4048,5756
05,05059,2009-12-31,1718,3983,5701
05,05059,2010-12-31,1725,3927,5652
05,05059,2011-12-31,1735,3861,5596
05,05059,2012-12-31,1703,3800,5503
05,05059,2013-12-31,1719,3742,5461
05,05059,2014-12-31,1707,3680,5387
05,05059,2015-12-31,1684,3598,5282
05,05059,2016-12-31,1663,3549,5212
05,05059,2017-12-31,1688,3501,5189
05,05059,2018-12-31,1716,3423,5139
05,05059,2019-12-31,1738,3347,5085
05,05059,2020-12-31,1771,3303,5074
05,05059,2021-12-31,1891,3262,5153
05,05059,2022-12-31,1980,3252,5232
05,05059,2023-12-31,2063,3251,5314
05,05059,2024-12-31,2106,3255,5361
05,05059,2025-12-31,2130,3263,5393
05,05059,2026-12-31,2169,3279,5448
05,05059,2027-12-31,2206,3288,5494
05,05059,2028-12-31,2228,3312,5540
05,05059,2029-12-31,2252,3344,5596
05,05059,2030-12-31,2286,3382,5668
05,05059,2031-12-31,2299,3416,5715
05,05059,2032-12-31,2321,3440,5761
05,05059,2033-12-31,2348,3486,5834
05,05059,2034-12-31,2365,3517,5882
05,05059,2035-12-31,2394,3563,5957
05,05079,1985-12-31,10019,20879,30898
05,05079,1986-12-31,10398,21270,31668
05,05079,1987-12-31,10760,21581,32341
05,05079,1988-12-31,11169,21874,33043
05,05079,1989-12-31,11554,22148,33702
05,05079,1990-12-31,11943,22412,34355
05,05079,1991-12-31,12323,22682,35005
05,05079,1992-12-31,12696,22922,35618
05,05079,1993-12-31,13085,23170,36255
05,05079,1994-12-31,13461,23400,36861
05,05079,1995-12-31,13820,23659,37479
05,05079,1996-12-31,14237,23898,38135
05,05079,1997-12-31,14589,24230,38819
05,05079,1998-12-31,14953,24498,39451
05,05079,1999-12-31,15338,24761,40099
05,05079,2000-12-31,15696,25003,40699
05,05079,2001-12-31,16062,25246,41308
05,05079,2002-12-31,16418,25475,41893
05,05079,2003-12-31,16755,25708,42463
05,05079,2004-12-31,17104,25930,43034
05,05079,2005-12-31,17486,26118,43604
05,05079,2006-12-31,17784,26341,44125
05,05079,2007-12-31,18145,26576,44721
05,05079,2008-12-31,18480,26812,45292
05,05079,2009-12-31,18825,27085,45910
05,05079,2010-12-31,19176,27333,46509
05,05079,2011-12-31,19482,27625,47107
05,05079,2012-12-31,19894,27869,47763
05,05079,2013-12-31,20205,28069,48274
05,05079,2014-12-31,20526,28343,48869
05,05079,2015-12-31,20913,28637,49550
05,05079,2016-12-31,21301,28980,50281
05,05079,2017-12-31,21686,29363,51049
05,05079,2018-12-31,22174,29795,51969
05,05079,2019-12-31,23078,30164,53242
05,05079,2020-12-31,23921,30426,54347
05,05079,2021-12-31,25119,30082,55201
05,05079,2022-12-31,26064,29989,56053
05,05079,2023-12-31,26942,29986,56928
05,05079,2024-12-31,27468,30015,57483
05,05079,2025-12-31,27938,30087,58025
05,05079,2026-12-31,28376,30214,58590
05,05079,2027-12-31,28771,30374,59145
05,05079,2028-12-31,29152,30586,59738
05,05079,2029-12-31,29482,30852,60334
05,05079,2030-12-31,29801,31162,60963
05,05079,2031-12-31,30093,31505,61598
05,05079,2032-12-31,30369,31858,62227
05,05079,2033-12-31,30639,32178,62817
05,05079,2034-12-31,30911,32515,63426
05,05079,2035-12-31,31145,32844,63989
05,05086,1985-12-31,1426,4380,5806
05,05086,1986-12-31,1430,4401,5831
05,05086,1987-12-31,1455,4405,5860
05,05086,1988-12-31,1455,4402,5857
05,05086,1989-12-31,1464,4394,5858
05,05086,1990-12-31,1464,4396,5860
05,05086,1991-12-31,1483,4394,5877
05,05086,1992-12-31,1472,4388,5860
05,05086,1993-12-31,1501,4385,5886
05,05086,1994-12-31,1480,4371,5851
05,05086,1995-12-31,1489,4349,5838
05,05086,1996-12-31,1503,4352,5855
05,05086,1997-12-31,1492,4358,5850
05,05086,1998-12-31,1502,4352,5854
05,05086,1999-12-31,1520,4357,5877
05,05086,2000-12-31,1495,4362,5857
05,05086,2001-12-31,1532,4357,5889
05,05086,2002-12-31,1553,4358,5911
05,05086,2003-12-31,1560,4359,5919
05,05086,2004-12-31,1587,4362,5949
05,05086,2005-12-31,1570,4345,5915
05,05086,2006-12-31,1579,4336,5915
05,05086,2007-12-31,1556,4333,5889
05,05086,2008-12-31,1541,4318,5859
05,05086,2009-12-31,1535,4317,5852
05,05086,2010-12-31,1544,4306,5850
05,05086,2011-12-31,1549,4347,5896
05,05086,2012-12-31,1573,4331,5904
05,05086,2013-12-31,1563,4331,5894
05,05086,2014-12-31,1563,4362,5925
05,05086,2015-12-31,1569,4377,5946
05,05086,2016-12-31,1577,4361,5938
05,05086,2017-12-31,1594,4358,5952
05,05086,2018-12-31,1623,4377,6000
05,05086,2019-12-31,1654,4400,6054
05,05086,2020-12-31,1689,4427,6116
05,05086,2021-12-31,1834,4377,6211
05,05086,2022-12-31,1944,4363,6307
05,05086,2023-12-31,2042,4363,6405
05,05086,2024-12-31,2076,4363,6439
05,05086,2025-12-31,2109,4375,6484
05,05086,2026-12-31,2145,4395,6540
05,05086,2027-12-31,2177,4411,6588
05,05086,2028-12-31,2202,4445,6647
05,05086,2029-12-31,2236,4490,6726
05,05086,2030-12-31,2255,4529,6784
05,05086,2031-12-31,2278,4570,6848
05,05086,2032-12-31,2303,4630,6933
05,05086,2033-12-31,2317,4684,7001
05,05086,2034-12-31,2334,4732,7066
05,05086,2035-12-31,2356,4788,7144
05,05088,1985-12-31,201099,7473,208572
05,05088,1986-12-31,209721,8112,217833
05,05088,1987-12-31,218968,8760,227728
05,05088,1988-12-31,228227,9393,237620
05,05088,1989-12-31,237484,10019,247503
05,05088,1990-12-31,246627,10618,257245
05,05088,1991-12-31,255714,11214,266928
05,05088,1992-12-31,264805,11789,276594
05,05088,1993-12-31,273974,12396,286370
05,05088,1994-12-31,282938,12980,295918
05,05088,1995-12-31,292095,13563,305658
05,05088,1996-12-31,301294,14140,315434
05,05088,1997-12-31,310026,14760,324786
05,05088,1998-12-31,319240,15363,334603
05,05088,1999-12-31,328331,15950,344281
05,05088,2000-12-31,337364,16520,353884
05,05088,2001-12-31,346206,17080,363286
05,05088,2002-12-31,354897,17640,372537
05,05088,2003-12-31,363493,18207,381700
05,05088,2004-12-31,372022,18755,390777
05,05088,2005-12-31,380511,19287,399798
05,05088,2006-12-31,389106,19834,408940
05,05088,2007-12-31,397604,20374,417978
05,05088,2008-12-31,406112,20928,427040
05,05088,2009-12-31,414658,21478,436136
05,05088,2010-12-31,423327,22022,445349
05,05088,2011-12-31,431881,22597,454478
05,05088,2012-12-31,440290,23153,463443
05,05088,2013-12-31,448529,23648,472177
05,05088,2014-12-31,456811,24225,481036
05,05088,2015-12-31,465219,24795,490014
05,05088,2016-12-31,474232,25389,499621
05,05088,2017-12-31,484001,26030,510031
05,05088,2018-12-31,495483,26781,522264
05,05088,2019-12-31,516826,21701,538527
05,05088,2020-12-31,536427,15727,552154
05,05088,2021-12-31,545285,15546,560831
05,05088,2022-12-31,553990,15498,569488
05,05088,2023-12-31,562880,15496,578376
05,05088,2024-12-31,572950,15512,588462
05,05088,2025-12-31,582643,15556,598199
05,05088,2026-12-31,591744,15609,607353
05,05088,2027-12-31,600243,15706,615949
05,05088,2028-12-31,608115,15811,623926
05,05088,2029-12-31,615249,15933,631182
05,05088,2030-12-31,621691,16103,637794
05,05088,2031-12-31,627684,16290,643974
05,05088,2032-12-31,633496,16468,649964
05,05088,2033-12-31,639117,16637,655754
05,05088,2034-12-31,644579,16798,661377
05,05088,2035-12-31,649831,16977,666808
05,05091,1985-12-31,3843,9836,13679
05,05091,1986-12-31,3832,9790,13622
05,05091,1987-12-31,3830,9695,13525
05,05091,1988-12-31,3808,9590,13398
05,05091,1989-12-31,3798,9478,13276
05,05091,1990-12-31,3793,9379,13172
05,05091,1991-12-31,3803,9264,13067
05,05091,1992-12-31,3786,9149,12935
05,05091,1993-12-31,3783,9043,12826
05,05091,1994-12-31,3773,8941,12714
05,05091,1995-12-31,3766,8824,12590
05,05091,1996-12-31,3767,8725,12492
05,05091,1997-12-31,3763,8630,12393
05,05091,1998-12-31,3760,8544,12304
05,05091,1999-12-31,3762,8451,12213
05,05091,2000-12-31,3744,8347,12091
05,05091,2001-12-31,3728,8240,11968
05,05091,2002-12-31,3728,8126,11854
05,05091,2003-12-31,3737,8021,11758
05,05091,2004-12-31,3707,7925,11632
05,05091,2005-12-31,3702,7812,11514
05,05091,2006-12-31,3670,7716,11386
05,05091,2007-12-31,3688,7627,11315
05,05091,2008-12-31,3680,7536,11216
05,05091,2009-12-31,3674,7434,11108
05,05091,2010-12-31,3662,7331,10993
05,05091,2011-12-31,3651,7251,10902
05,05091,2012-12-31,3640,7175,10815
05,05091,2013-12-31,3621,7090,10711
05,05091,2014-12-31,3619,7013,10632
05,05091,2015-12-31,3612,6937,10549
05,05091,2016-12-31,3631,6853,10484
05,05091,2017-12-31,3569,6808,10377
05,05091,2018-12-31,3601,6722,10323
05,05091,2019-12-31,3638,6636,10274
05,05091,2020-12-31,3697,6587,10284
05,05091,2021-12-31,3932,6512,10444
05,05091,2022-12-31,4113,6492,10605
05,05091,2023-12-31,4278,6492,10770
05,05091,2024-12-31,4354,6496,10850
05,05091,2025-12-31,4440,6520,10960
05,05091,2026-12-31,4504,6539,11043
05,05091,2027-12-31,4572,6573,11145
05,05091,2028-12-31,4634,6624,11258
05,05091,2029-12-31,4680,6670,11350
05,05091,2030-12-31,4734,6741,11475
05,05091,2031-12-31,4789,6819,11608
05,05091,2032-12-31,4821,6891,11712
05,05091,2033-12-31,4872,6964,11836
05,05091,2034-12-31,4908,7033,11941
05,05091,2035-12-31,4957,7116,12073
05,05093,1985-12-31,3285,12666,15951
05,05093,1986-12-31,3316,12695,16011
05,05093,1987-12-31,3361,12658,16019
05,05093,1988-12-31,3391,12622,16013
05,05093,1989-12-31,3411,12575,15986
05,05093,1990-12-31,3441,12521,15962
05,05093,1991-12-31,3467,12459,15926
05,05093,1992-12-31,3505,12396,15901
05,05093,1993-12-31,3537,12345,15882
05,05093,1994-12-31,3563,12276,15839
05,05093,1995-12-31,3598,12226,15824
05,05093,1996-12-31,3623,12173,15796
05,05093,1997-12-31,3650,12154,15804
05,05093,1998-12-31,3697,12110,15807
05,05093,1999-12-31,3727,12065,15792
05,05093,2000-12-31,3752,12021,15773
05,05093,2001-12-31,3784,11957,15741
05,05093,2002-12-31,3817,11904,15721
05,05093,2003-12-31,3845,11847,15692
05,05093,2004-12-31,3884,11781,15665
05,05093,2005-12-31,3898,11731,15629
05,05093,2006-12-31,3933,11691,15624
05,05093,2007-12-31,3955,11630,15585
05,05093,2008-12-31,3972,11591,15563
05,05093,2009-12-31,4005,11550,15555
05,05093,2010-12-31,4050,11516,15566
05,05093,2011-12-31,4069,11457,15526
05,05093,2012-12-31,4089,11402,15491
05,05093,2013-12-31,4162,11392,15554
05,05093,2014-12-31,4161,11282,15443
05,05093,2015-12-31,4173,11254,15427
05,05093,2016-12-31,4195,11250,15445
05,05093,2017-12-31,4226,11268,15494
05,05093,2018-12-31,4274,11333,15607
05,05093,2019-12-31,4396,11340,15736
05,05093,2020-12-31,4522,11374,15896
05,05093,2021-12-31,4898,11245,16143
05,05093,2022-12-31,5181,11211,16392
05,05093,2023-12-31,5439,11209,16648
05,05093,2024-12-31,5541,11226,16767
05,05093,2025-12-31,5642,11251,16893
05,05093,2026-12-31,5726,11298,17024
05,05093,2027-12-31,5813,11360,17173
05,05093,2028-12-31,5882,11429,17311
05,05093,2029-12-31,5961,11533,17494
05,05093,2030-12-31,6011,11644,17655
05,05093,2031-12-31,6067,11775,17842
05,05093,2032-12-31,6135,11895,18030
05,05093,2033-12-31,6182,12024,18206
05,05093,2034-12-31,6230,12143,18373
05,05093,2035-12-31,6291,12283,18574
05,05101,1985-12-31,13650,15942,29592
05,05101,1986-12-31,13711,15850,29561
05,05101,1987-12-31,13756,15676,29432
05,05101,1988-12-31,13854,15502,29356
05,05101,1989-12-31,13937,15335,29272
05,05101,1990-12-31,14022,15143,29165
05,05101,1991-12-31,14093,14944,29037
05,05101,1992-12-31,14159,14752,28911
05,05101,1993-12-31,14252,14574,28826
05,05101,1994-12-31,14300,14377,28677
05,05101,1995-12-31,14373,14199,28572
05,05101,1996-12-31,14447,13988,28435
05,05101,1997-12-31,14490,13878,28368
05,05101,1998-12-31,14564,13713,28277
05,05101,1999-12-31,14625,13535,28160
05,05101,2000-12-31,14669,13349,28018
05,05101,2001-12-31,14741,13172,27913
05,05101,2002-12-31,14759,12979,27738
05,05101,2003-12-31,14842,12806,27648
05,05101,2004-12-31,14839,12633,27472
05,05101,2005-12-31,14894,12452,27346
05,05101,2006-12-31,14889,12276,27165
05,05101,2007-12-31,14959,12102,27061
05,05101,2008-12-31,14994,11933,26927
05,05101,2009-12-31,15050,11779,26829
05,05101,2010-12-31,15094,11628,26722
05,05101,2011-12-31,15117,11437,26554
05,05101,2012-12-31,15142,11279,26421
05,05101,2013-12-31,15176,11121,26297
05,05101,2014-12-31,15224,10961,26185
05,05101,2015-12-31,15286,10787,26073
05,05101,2016-12-31,15336,10660,25996
05,05101,2017-12-31,15392,10583,25975
05,05101,2018-12-31,15604,10514,26118
05,05101,2019-12-31,15915,10245,26160
05,05101,2020-12-31,16283,10030,26313
05,05101,2021-12-31,16806,9915,26721
05,05101,2022-12-31,17250,9884,27134
05,05101,2023-12-31,17674,9883,27557
05,05101,2024-12-31,18007,9898,27905
05,05101,2025-12-31,18321,9924,28245
05,05101,2026-12-31,18602,9961,28563
05,05101,2027-12-31,18875,10015,28890
05,05101,2028-12-31,19119,10087,29206
05,05101,2029-12-31,19356,10161,29517
05,05101,2030-12-31,19557,10269,29826
05,05101,2031-12-31,19733,10388,30121
05,05101,2032-12-31,19928,10496,30424
05,05101,2033-12-31,20100,10609,30709
05,05101,2034-12-31,20279,10723,31002
05,05101,2035-12-31,20426,10807,31233
05,05107,1985-12-31,1089,8226,9315
05,05107,1986-12-31,1122,8183,9305
05,05107,1987-12-31,1170,8094,9264
05,05107,1988-12-31,1224,8010,9234
05,05107,1989-12-31,1269,7928,9197
05,05107,1990-12-31,1316,7822,9138
05,05107,1991-12-31,1347,7737,9084
05,05107,1992-12-31,1391,7644,9035
05,05107,1993-12-31,1434,7542,8976
05,05107,1994-12-31,1484,7446,8930
05,05107,1995-12-31,1529,7361,8890
05,05107,1996-12-31,1573,7254,8827
05,05107,1997-12-31,1603,7200,8803
05,05107,1998-12-31,1657,7102,8759
05,05107,1999-12-31,1731,7032,8763
05,05107,2000-12-31,1772,6941,8713
05,05107,2001-12-31,1826,6834,8660
05,05107,2002-12-31,1879,6741,8620
05,05107,2003-12-31,1915,6655,8570
05,05107,2004-12-31,1956,6596,8552
05,05107,2005-12-31,1993,6482,8475
05,05107,2006-12-31,2039,6368,8407
05,05107,2007-12-31,2077,6302,8379
05,05107,2008-12-31,2116,6212,8328
05,05107,2009-12-31,2154,6114,8268
05,05107,2010-12-31,2227,6029,8256
05,05107,2011-12-31,2263,5949,8212
05,05107,2012-12-31,2308,5885,8193
05,05107,2013-12-31,2353,5823,8176
05,05107,2014-12-31,2377,5758,8135
05,05107,2015-12-31,2420,5668,8088
05,05107,2016-12-31,2449,5626,8075
05,05107,2017-12-31,2494,5559,8053
05,05107,2018-12-31,2552,5487,8039
05,05107,2019-12-31,2663,5402,8065
05,05107,2020-12-31,2765,5355,8120
05,05107,2021-12-31,2952,5294,8246
05,05107,2022-12-31,3095,5278,8373
05,05107,2023-12-31,3226,5278,8504
05,05107,2024-12-31,3288,5288,8576
05,05107,2025-12-31,3345,5296,8641
05,05107,2026-12-31,3395,5315,8710
05,05107,2027-12-31,3440,5348,8788
05,05107,2028-12-31,3490,5384,8874
05,05107,2029-12-31,3528,5421,8949
05,05107,2030-12-31,3570,5484,9054
05,05107,2031-12-31,3598,5542,9140
05,05107,2032-12-31,3635,5590,9225
05,05107,2033-12-31,3659,5666,9325
05,05107,2034-12-31,3693,5718,9411
05,05107,2035-12-31,3725,5789,9514
05,05113,1985-12-31,1135,6138,7273
05,05113,1986-12-31,1181,6219,7400
05,05113,1987-12-31,1233,6246,7479
05,05113,1988-12-31,1261,6284,7545
05,05113,1989-12-31,1288,6326,7614
05,05113,1990-12-31,1301,6344,7645
05,05113,1991-12-31,1346,6334,7680
05,05113,1992-12-31,1387,6381,7768
05,05113,1993-12-31,1408,6379,7787
05,05113,1994-12-31,1467,6413,7880
05,05113,1995-12-31,1465,6427,7892
05,05113,1996-12-31,1509,6444,7953
05,05113,1997-12-31,1557,6491,8048
05,05113,1998-12-31,1565,6508,8073
05,05113,1999-12-31,1611,6537,8148
05,05113,2000-12-31,1621,6575,8196
05,05113,2001-12-31,1689,6603,8292
05,05113,2002-12-31,1728,6626,8354
05,05113,2003-12-31,1747,6641,8388
05,05113,2004-12-31,1757,6666,8423
05,05113,2005-12-31,1794,6682,8476
05,05113,2006-12-31,1836,6705,8541
05,05113,2007-12-31,1886,6725,8611
05,05113,2008-12-31,1900,6779,8679
05,05113,2009-12-31,1917,6755,8672
05,05113,2010-12-31,1979,6787,8766
05,05113,2011-12-31,2004,6807,8811
05,05113,2012-12-31,2040,6855,8895
05,05113,2013-12-31,2054,6898,8952
05,05113,2014-12-31,2094,6940,9034
05,05113,2015-12-31,2144,6958,9102
05,05113,2016-12-31,2163,6994,9157
05,05113,2017-12-31,2163,7049,9212
05,05113,2018-12-31,2235,7119,9354
05,05113,2019-12-31,2306,7196,9502
05,05113,2020-12-31,2370,7264,9634
05,05113,2021-12-31,2601,7182,9783
05,05113,2022-12-31,2774,7160,9934
05,05113,2023-12-31,2930,7159,10089
05,05113,2024-12-31,2983,7160,10143
05,05113,2025-12-31,3033,7178,10211
05,05113,2026-12-31,3085,7214,10299
05,05113,2027-12-31,3123,7245,10368
05,05113,2028-12-31,3174,7288,10462
05,05113,2029-12-31,3213,7376,10589
05,05113,2030-12-31,3240,7442,10682
05,05113,2031-12-31,3272,7514,10786
05,05113,2032-12-31,3303,7604,10907
05,05113,2033-12-31,3327,7674,11001
05,05113,2034-12-31,3362,7756,11118
05,05113,2035-12-31,3391,7840,11231
05,05120,1985-12-31,1730,17254,18984
05,05120,1986-12-31,1867,17559,19426
05,05120,1987-12-31,1976,17774,19750
05,05120,1988-12-31,2090,17984,20074
05,05120,1989-12-31,2192,18190,20382
05,05120,1990-12-31,2307,18400,20707
05,05120,1991-12-31,2410,18534,20944
05,05120,1992-12-31,2516,18728,21244
05,05120,1993-12-31,2624,18897,21521
05,05120,1994-12-31,2748,19077,21825
05,05120,1995-12-31,2837,19254,22091
05,05120,1996-12-31,2957,19416,22373
05,05120,1997-12-31,3075,19673,22748
05,05120,1998-12-31,3185,19865,23050
05,05120,1999-12-31,3302,20053,23355
05,05120,2000-12-31,3422,20235,23657
05,05120,2001-12-31,3520,20415,23935
05,05120,2002-12-31,3632,20580,24212
05,05120,2003-12-31,3745,20723,24468
05,05120,2004-12-31,3849,20899,24748
05,05120,2005-12-31,3947,21052,24999
05,05120,2006-12-31,4055,21220,25275
05,05120,2007-12-31,4147,21375,25522
05,05120,2008-12-31,4270,21535,25805
05,05120,2009-12-31,4372,21709,26081
05,05120,2010-12-31,4487,21876,26363
05,05120,2011-12-31,4597,22081,26678
05,05120,2012-12-31,4698,22254,26952
05,05120,2013-12-31,4810,22383,27193
05,05120,2014-12-31,4927,22576,27503
05,05120,2015-12-31,5022,22789,27811
05,05120,2016-12-31,5116,23018,28134
05,05120,2017-12-31,5276,23275,28551
05,05120,2018-12-31,5355,23641,28996
05,05120,2019-12-31,5563,24153,29716
05,05120,2020-12-31,5758,24598,30356
05,05120,2021-12-31,6513,24320,30833
05,05120,2022-12-31,7064,24245,31309
05,05120,2023-12-31,7556,24242,31798
05,05120,2024-12-31,7706,24270,31976
05,05120,2025-12-31,7833,24330,32163
05,05120,2026-12-31,7962,24423,32385
05,05120,2027-12-31,8065,24565,32630
05,05120,2028-12-31,8181,24733,32914
05,05120,2029-12-31,8274,24931,33205
05,05120,2030-12-31,8357,25187,33544
05,05120,2031-12-31,8432,25465,33897
05,05120,2032-12-31,8522,25737,34259
05,05120,2033-12-31,8595,25997,34592
05,05120,2034-12-31,8656,26273,34929
05,05120,2035-12-31,8725,26539,35264
05,05125,1985-12-31,1003,6129,7132
05,05125,1986-12-31,1017,6181,7198
05,05125,1987-12-31,1039,6199,7238
05,05125,1988-12-31,1068,6218,7286
05,05125,1989-12-31,1083,6236,7319
05,05125,1990-12-31,1099,6254,7353
05,05125,1991-12-31,1117,6261,7378
05,05125,1992-12-31,1133,6261,7394
05,05125,1993-12-31,1162,6273,7435
05,05125,1994-12-31,1180,6287,7467
05,05125,1995-12-31,1195,6281,7476
05,05125,1996-12-31,1217,6274,7491
05,05125,1997-12-31,1237,6311,7548
05,05125,1998-12-31,1263,6312,7575
05,05125,1999-12-31,1266,6333,7599
05,05125,2000-12-31,1305,6339,7644
05,05125,2001-12-31,1327,6355,7682
05,05125,2002-12-31,1352,6370,7722
05,05125,2003-12-31,1352,6378,7730
05,05125,2004-12-31,1371,6383,7754
05,05125,2005-12-31,1370,6388,7758
05,05125,2006-12-31,1392,6394,7786
05,05125,2007-12-31,1408,6408,7816
05,05125,2008-12-31,1432,6440,7872
05,05125,2009-12-31,1453,6439,7892
05,05125,2010-12-31,1474,6441,7915
05,05125,2011-12-31,1493,6463,7956
05,05125,2012-12-31,1510,6484,7994
05,05125,2013-12-31,1534,6513,8047
05,05125,2014-12-31,1552,6548,8100
05,05125,2015-12-31,1573,6595,8168
05,05125,2016-12-31,1598,6587,8185
05,05125,2017-12-31,1619,6601,8220
05,05125,2018-12-31,1657,6640,8297
05,05125,2019-12-31,1710,6710,8420
05,05125,2020-12-31,1761,6775,8536
05,05125,2021-12-31,1970,6698,8668
05,05125,2022-12-31,2124,6678,8802
05,05125,2023-12-31,2263,6677,8940
05,05125,2024-12-31,2310,6682,8992
05,05125,2025-12-31,2338,6708,9046
05,05125,2026-12-31,2376,6730,9106
05,05125,2027-12-31,2412,6766,9178
05,05125,2028-12-31,2447,6812,9259
05,05125,2029-12-31,2472,6860,9332
05,05125,2030-12-31,2503,6937,9440
05,05125,2031-12-31,2527,7014,9541
05,05125,2032-12-31,2539,7089,9628
05,05125,2033-12-31,2567,7168,9735
05,05125,2034-12-31,2592,7234,9826
05,05125,2035-12-31,2623,7311,9934
05,05129,1985-12-31,35636,6812,42448
05,05129,1986-12-31,36440,7169,43609
05,05129,1987-12-31,37316,7454,44770
05,05129,1988-12-31,38185,7811,45996
05,05129,1989-12-31,39064,8130,47194
05,05129,1990-12-31,39947,8435,48382
05,05129,1991-12-31,40802,8720,49522
05,05129,1992-12-31,41649,9026,50675
05,05129,1993-12-31,42522,9349,51871
05,05129,1994-12-31,43354,9629,52983
05,05129,1995-12-31,44208,9918,54126
05,05129,1996-12-31,45078,10210,55288
05,05129,1997-12-31,45857,10539,56396
05,05129,1998-12-31,46737,10828,57565
05,05129,1999-12-31,47574,11120,58694
05,05129,2000-12-31,48402,11409,59811
05,05129,2001-12-31,49212,11689,60901
05,05129,2002-12-31,50001,11970,61971
05,05129,2003-12-31,50782,12254,63036
05,05129,2004-12-31,51555,12531,64086
05,05129,2005-12-31,52306,12789,65095
05,05129,2006-12-31,53101,13085,66186
05,05129,2007-12-31,53873,13365,67238
05,05129,2008-12-31,54661,13627,68288
05,05129,2009-12-31,55416,13905,69321
05,05129,2010-12-31,56213,14201,70414
05,05129,2011-12-31,56998,14477,71475
05,05129,2012-12-31,57766,14741,72507
05,05129,2013-12-31,58505,15012,73517
05,05129,2014-12-31,59251,15278,74529
05,05129,2015-12-31,60034,15588,75622
05,05129,2016-12-31,60867,15899,76766
05,05129,2017-12-31,61793,16207,78000
05,05129,2018-12-31,62987,16651,79638
05,05129,2019-12-31,65271,16387,81658
05,05129,2020-12-31,67400,16023,83423
05,05129,2021-12-31,68895,15839,84734
05,05129,2022-12-31,70252,15790,86042
05,05129,2023-12-31,71597,15788,87385
05,05129,2024-12-31,72927,15800,88727
05,05129,2025-12-31,74172,15843,90015
05,05129,2026-12-31,75340,15899,91239
05,05129,2027-12-31,76417,15997,92414
05,05129,2028-12-31,77418,16104,93522
05,05129,2029-12-31,78319,16238,94557
05,05129,2030-12-31,79131,16407,95538
05,05129,2031-12-31,79914,16595,96509
05,05129,2032-12-31,80652,16770,97422
05,05129,2033-12-31,81365,16948,98313
05,05129,2034-12-31,82065,17128,99193
05,05129,2035-12-31,82740,17298,100038
05,05134,1985-12-31,1661,9243,10904
05,05134,1986-12-31,1696,9202,10898
05,05134,1987-12-31,1712,9130,10842
05,05134,1988-12-31,1735,9050,10785
05,05134,1989-12-31,1760,8973,10733
05,05134,1990-12-31,1779,8890,10669
05,05134,1991-12-31,1770,8806,10576
05,05134,1992-12-31,1857,8699,10556
05,05134,1993-12-31,1908,8618,10526
05,05134,1994-12-31,1898,8524,10422
05,05134,1995-12-31,1898,8416,10314
05,05134,1996-12-31,1937,8329,10266
05,05134,1997-12-31,1967,8273,10240
05,05134,1998-12-31,2000,8199,10199
05,05134,1999-12-31,2048,8122,10170
05,05134,2000-12-31,2010,8036,10046
05,05134,2001-12-31,2039,7950,9989
05,05134,2002-12-31,2069,7853,9922
05,05134,2003-12-31,2091,7792,9883
05,05134,2004-12-31,2135,7694,9829
05,05134,2005-12-31,2139,7619,9758
05,05134,2006-12-31,2182,7527,9709
05,05134,2007-12-31,2200,7455,9655
05,05134,2008-12-31,2230,7373,9603
05,05134,2009-12-31,2257,7303,9560
05,05134,2010-12-31,2255,7216,9471
05,05134,2011-12-31,2288,7149,9437
05,05134,2012-12-31,2317,7081,9398
05,05134,2013-12-31,2343,7027,9370
05,05134,2014-12-31,2361,6960,9321
05,05134,2015-12-31,2383,6890,9273
05,05134,2016-12-31,2426,6824,9250
05,05134,2017-12-31,2412,6784,9196
05,05134,2018-12-31,2466,6737,9203
05,05134,2019-12-31,2562,6640,9202
05,05134,2020-12-31,2651,6592,9243
05,05134,2021-12-31,2869,6517,9386
05,05134,2022-12-31,3034,6497,9531
05,05134,2023-12-31,3183,6497,9680
05,05134,2024-12-31,3241,6499,9740
05,05134,2025-12-31,3293,6521,9814
05,05134,2026-12-31,3351,6532,9883
05,05134,2027-12-31,3393,6581,9974
05,05134,2028-12-31,3443,6624,10067
05,05134,2029-12-31,3485,6683,10168
05,05134,2030-12-31,3520,6756,10276
05,05134,2031-12-31,3554,6831,10385
05,05134,2032-12-31,3587,6899,10486
05,05134,2033-12-31,3618,6974,10592
05,05134,2034-12-31,3645,7047,10692
05,05134,2035-12-31,3680,7122,10802
05,05138,1985-12-31,4564,15879,20443
05,05138,1986-12-31,4616,15785,20401
05,05138,1987-12-31,4613,15618,20231
05,05138,1988-12-31,4630,15446,20076
05,05138,1989-12-31,4648,15270,19918
05,05138,1990-12-31,4685,15091,19776
05,05138,1991-12-31,4681,14907,19588
05,05138,1992-12-31,4698,14709,19407
05,05138,1993-12-31,4710,14523,19233
05,05138,1994-12-31,4735,14321,19056
05,05138,1995-12-31,4756,14141,18897
05,05138,1996-12-31,4780,13956,18736
05,05138,1997-12-31,4797,13810,18607
05,05138,1998-12-31,4818,13647,18465
05,05138,1999-12-31,4820,13486,18306
05,05138,2000-12-31,4828,13290,18118
05,05138,2001-12-31,4839,13126,17965
05,05138,2002-12-31,4886,12929,17815
05,05138,2003-12-31,4910,12733,17643
05,05138,2004-12-31,4904,12548,17452
05,05138,2005-12-31,4918,12390,17308
05,05138,2006-12-31,4950,12233,17183
05,05138,2007-12-31,4929,12049,16978
05,05138,2008-12-31,4917,11867,16784
05,05138,2009-12-31,4945,11703,16648
05,05138,2010-12-31,4968,11553,16521
05,05138,2011-12-31,4986,11378,16364
05,05138,2012-12-31,4991,11214,16205
05,05138,2013-12-31,5001,11067,16068
05,05138,2014-12-31,5007,10902,15909
05,05138,2015-12-31,5020,10724,15744
05,05138,2016-12-31,5061,10609,15670
05,05138,2017-12-31,5039,10527,15566
05,05138,2018-12-31,5076,10447,15523
05,05138,2019-12-31,5165,10325,15490
05,05138,2020-12-31,5274,10278,15552
05,05138,2021-12-31,5631,10162,15793
05,05138,2022-12-31,5906,10131,16037
05,05138,2023-12-31,6158,10129,16287
05,05138,2024-12-31,6276,10152,16428
05,05138,2025-12-31,6379,10159,16538
05,05138,2026-12-31,6489,10206,16695
05,05138,2027-12-31,6579,10253,16832
05,05138,2028-12-31,6658,10324,16982
05,05138,2029-12-31,6745,10415,17160
05,05138,2030-12-31,6811,10522,17333
05,05138,2031-12-31,6877,10633,17510
05,05138,2032-12-31,6941,10750,17691
05,05138,2033-12-31,7000,10888,17888
05,05138,2034-12-31,7055,10975,18030
05,05138,2035-12-31,7115,11098,18213
05,05142,1985-12-31,3094,3535,6629
05,05142,1986-12-31,3079,3497,6576
05,05142,1987-12-31,3078,3436,6514
05,05142,1988-12-31,3066,3383,6449
05,05142,1989-12-31,3058,3332,6390
05,05142,1990-12-31,3050,3269,6319
05,05142,1991-12-31,3040,3187,6227
05,05142,1992-12-31,3017,3154,6171
05,05142,1993-12-31,2992,3094,6086
05,05142,1994-12-31,3000,3037,6037
05,05142,1995-12-31,2986,2982,5968
05,05142,1996-12-31,2965,2939,5904
05,05142,1997-12-31,2969,2864,5833
05,05142,1998-12-31,2954,2832,5786
05,05142,1999-12-31,2941,2764,5705
05,05142,2000-12-31,2922,2719,5641
05,05142,2001-12-31,2924,2665,5589
05,05142,2002-12-31,2909,2605,5514
05,05142,2003-12-31,2896,2554,5450
05,05142,2004-12-31,2893,2494,5387
05,05142,2005-12-31,2885,2439,5324
05,05142,2006-12-31,2868,2369,5237
05,05142,2007-12-31,2856,2335,5191
05,05142,2008-12-31,2844,2274,5118
05,05142,2009-12-31,2838,2234,5072
05,05142,2010-12-31,2832,2183,5015
05,05142,2011-12-31,2807,2128,4935
05,05142,2012-12-31,2802,2099,4901
05,05142,2013-12-31,2792,2060,4852
05,05142,2014-12-31,2762,2014,4776
05,05142,2015-12-31,2781,1982,4763
05,05142,2016-12-31,2779,1957,4736
05,05142,2017-12-31,2696,1843,4539
05,05142,2018-12-31,2739,1843,4582
05,05142,2019-12-31,2756,1781,4537
05,05142,2020-12-31,2794,1738,4532
05,05142,2021-12-31,2884,1718,4602
05,05142,2022-12-31,2960,1713,4673
05,05142,2023-12-31,3033,1713,4746
05,05142,2024-12-31,3096,1715,4811
05,05142,2025-12-31,3144,1713,4857
05,05142,2026-12-31,3193,1716,4909
05,05142,2027-12-31,3244,1728,4972
05,05142,2028-12-31,3277,1733,5010
05,05142,2029-12-31,3319,1760,5079
05,05142,2030-12-31,3362,1776,5138
05,05142,2031-12-31,3391,1794,5185
05,05142,2032-12-31,3413,1809,5222
05,05142,2033-12-31,3446,1841,5287
05,05142,2034-12-31,3481,1857,5338
05,05142,2035-12-31,3516,1874,5390
05,05145,1985-12-31,2994,5251,8245
05,05145,1986-12-31,2979,5181,8160
05,05145,1987-12-31,2959,5095,8054
05,05145,1988-12-31,2929,5014,7943
05,05145,1989-12-31,2897,4928,7825
05,05145,1990-12-31,2885,4834,7719
05,05145,1991-12-31,2850,4742,7592
05,05145,1992-12-31,2830,4646,7476
05,05145,1993-12-31,2773,4579,7352
05,05145,1994-12-31,2780,4459,7239
05,05145,1995-12-31,2747,4363,7110
05,05145,1996-12-31,2732,4272,7004
05,05145,1997-12-31,2711,4191,6902
05,05145,1998-12-31,2667,4099,6766
05,05145,1999-12-31,2649,4036,6685
05,05145,2000-12-31,2631,3955,6586
05,05145,2001-12-31,2609,3889,6498
05,05145,2002-12-31,2584,3784,6368
05,05145,2003-12-31,2558,3693,6251
05,05145,2004-12-31,2515,3601,6116
05,05145,2005-12-31,2513,3527,6040
05,05145,2006-12-31,2465,3438,5903
05,05145,2007-12-31,2442,3345,5787
05,05145,2008-12-31,2429,3257,5686
05,05145,2009-12-31,2410,3183,5593
05,05145,2010-12-31,2387,3113,5500
05,05145,2011-12-31,2364,3046,5410
05,05145,2012-12-31,2321,2983,5304
05,05145,2013-12-31,2298,2911,5209
05,05145,2014-12-31,2268,2859,5127
05,05145,2015-12-31,2268,2744,5012
05,05145,2016-12-31,2266,2686,4952
05,05145,2017-12-31,2160,2629,4789
05,05145,2018-12-31,2190,2553,4743
05,05145,2019-12-31,2185,2485,4670
05,05145,2020-12-31,2204,2444,4648
05,05145,2021-12-31,2304,2416,4720
05,05145,2022-12-31,2385,2408,4793
05,05145,2023-12-31,2460,2408,4868
05,05145,2024-12-31,2508,2412,4920
05,05145,2025-12-31,2548,2417,4965
05,05145,2026-12-31,2585,2419,5004
05,05145,2027-12-31,2620,2442,5062
05,05145,2028-12-31,2654,2460,5114
05,05145,2029-12-31,2686,2475,5161
05,05145,2030-12-31,2721,2501,5222
05,05145,2031-12-31,2735,2529,5264
05,05145,2032-12-31,2771,2558,5329
05,05145,2033-12-31,2796,2585,5381
05,05145,2034-12-31,2817,2606,5423
05,05145,2035-12-31,2850,2633,5483
05,05147,1985-12-31,3536,9987,13523
05,05147,1986-12-31,4400,10196,14596
05,05147,1987-12-31,5324,10357,15681
05,05147,1988-12-31,6221,10523,16744
05,05147,1989-12-31,7134,10696,17830
05,05147,1990-12-31,8034,10825,18859
05,05147,1991-12-31,8937,10965,19902
05,05147,1992-12-31,9833,11111,20944
05,05147,1993-12-31,10741,11255,21996
05,05147,1994-12-31,11639,11390,23029
05,05147,1995-12-31,12563,11519,24082
05,05147,1996-12-31,13465,11664,25129
05,05147,1997-12-31,14347,11846,26193
05,05147,1998-12-31,15249,11998,27247
05,05147,1999-12-31,16166,12130,28296
05,05147,2000-12-31,17077,12286,29363
05,05147,2001-12-31,17975,12425,30400
05,05147,2002-12-31,18858,12558,31416
05,05147,2003-12-31,19726,12691,32417
05,05147,2004-12-31,20598,12815,33413
05,05147,2005-12-31,21487,12952,34439
05,05147,2006-12-31,22346,13084,35430
05,05147,2007-12-31,23206,13219,36425
05,05147,2008-12-31,24078,13360,37438
05,05147,2009-12-31,24932,13498,38430
05,05147,2010-12-31,25777,13650,39427
05,05147,2011-12-31,26658,13815,40473
05,05147,2012-12-31,27528,13922,41450
05,05147,2013-12-31,28383,14058,42441
05,05147,2014-12-31,29226,14143,43369
05,05147,2015-12-31,30107,14297,44404
05,05147,2016-12-31,31010,14479,45489
05,05147,2017-12-31,31928,14701,46629
05,05147,2018-12-31,33009,14923,47932
05,05147,2019-12-31,35217,14442,49659
05,05147,2020-12-31,37144,13999,51143
05,05147,2021-12-31,38109,13838,51947
05,05147,2022-12-31,38954,13795,52749
05,05147,2023-12-31,39778,13794,53572
05,05147,2024-12-31,40533,13806,54339
05,05147,2025-12-31,41221,13840,55061
05,05147,2026-12-31,41858,13893,55751
05,05147,2027-12-31,42471,13977,56448
05,05147,2028-12-31,43021,14073,57094
05,05147,2029-12-31,43523,14185,57708
05,05147,2030-12-31,43983,14327,58310
05,05147,2031-12-31,44414,14488,58902
05,05147,2032-12-31,44815,14644,59459
05,05147,2033-12-31,45222,14802,60024
05,05147,2034-12-31,45601,14960,60561
05,05147,2035-12-31,45970,15111,61081
05,05148,1985-12-31,12452,18759,31211
05,05148,1986-12-31,13091,19072,32163
05,05148,1987-12-31,13746,19301,33047
05,05148,1988-12-31,14439,19515,33954
05,05148,1989-12-31,15128,19718,34846
05,05148,1990-12-31,15804,19918,35722
05,05148,1991-12-31,16479,20091,36570
05,05148,1992-12-31,17148,20264,37412
05,05148,1993-12-31,17829,20451,38280
05,05148,1994-12-31,18486,20606,39092
05,05148,1995-12-31,19149,20794,39943
05,05148,1996-12-31,19830,20957,40787
05,05148,1997-12-31,20471,21205,41676
05,05148,1998-12-31,21160,21401,42561
05,05148,1999-12-31,21842,21594,43436
05,05148,2000-12-31,22506,21752,44258
05,05148,2001-12-31,23165,21930,45095
05,05148,2002-12-31,23798,22090,45888
05,05148,2003-12-31,24438,22255,46693
05,05148,2004-12-31,25072,22417,47489
05,05148,2005-12-31,25694,22551,48245
05,05148,2006-12-31,26327,22711,49038
05,05148,2007-12-31,26951,22874,49825
05,05148,2008-12-31,27579,23033,50612
05,05148,2009-12-31,28201,23208,51409
05,05148,2010-12-31,28833,23382,52215
05,05148,2011-12-31,29456,23607,53063
05,05148,2012-12-31,30091,23803,53894
05,05148,2013-12-31,30708,23949,54657
05,05148,2014-12-31,31319,24145,55464
05,05148,2015-12-31,31946,24400,56346
05,05148,2016-12-31,32607,24601,57208
05,05148,2017-12-31,33316,24804,58120
05,05148,2018-12-31,34187,25229,59416
05,05148,2019-12-31,35769,25353,61122
05,05148,2020-12-31,37196,25385,62581
05,05148,2021-12-31,38466,25098,63564
05,05148,2022-12-31,39525,25021,64546
05,05148,2023-12-31,40535,25018,65553
05,05148,2024-12-31,41321,25053,66374
05,05148,2025-12-31,42019,25102,67121
05,05148,2026-12-31,42684,25219,67903
05,05148,2027-12-31,43296,25344,68640
05,05148,2028-12-31,43866,25516,69382
05,05148,2029-12-31,44376,25741,70117
05,05148,2030-12-31,44849,26000,70849
05,05148,2031-12-31,45264,26283,71547
05,05148,2032-12-31,45692,26577,72269
05,05148,2033-12-31,46101,26849,72950
05,05148,2034-12-31,46496,27132,73628
05,05148,2035-12-31,46862,27406,74268
05,05150,1985-12-31,2726,1135,3861
05,05150,1986-12-31,2752,1121,3873
05,05150,1987-12-31,2752,1126,3878
05,05150,1988-12-31,2760,1135,3895
05,05150,1989-12-31,2761,1122,3883
05,05150,1990-12-31,2765,1116,3881
05,05150,1991-12-31,2791,1113,3904
05,05150,1992-12-31,2787,1080,3867
05,05150,1993-12-31,2791,1078,3869
05,05150,1994-12-31,2803,1067,3870
05,05150,1995-12-31,2803,1070,3873
05,05150,1996-12-31,2810,1056,3866
05,05150,1997-12-31,2797,1063,3860
05,05150,1998-12-31,2813,1060,3873
05,05150,1999-12-31,2821,1049,3870
05,05150,2000-12-31,2826,1080,3906
05,05150,2001-12-31,2839,1034,3873
05,05150,2002-12-31,2835,1007,3842
05,05150,2003-12-31,2844,999,3843
05,05150,2004-12-31,2835,1003,3838
05,05150,2005-12-31,2821,1034,3855
05,05150,2006-12-31,2872,1038,3910
05,05150,2007-12-31,2863,1025,3888
05,05150,2008-12-31,2861,1021,3882
05,05150,2009-12-31,2875,1017,3892
05,05150,2010-12-31,2872,1016,3888
05,05150,2011-12-31,2880,1025,3905
05,05150,2012-12-31,2892,1014,3906
05,05150,2013-12-31,2908,1006,3914
05,05150,2014-12-31,2920,1010,3930
05,05150,2015-12-31,2930,1002,3932
05,05150,2016-12-31,2894,1006,3900
05,05150,2017-12-31,2882,1006,3888
05,05150,2018-12-31,2929,1025,3954
05,05150,2019-12-31,2971,983,3954
05,05150,2020-12-31,3026,946,3972
05,05150,2021-12-31,3099,935,4034
05,05150,2022-12-31,3164,932,4096
05,05150,2023-12-31,3228,932,4160
05,05150,2024-12-31,3294,927,4221
05,05150,2025-12-31,3342,926,4268
05,05150,2026-12-31,3401,926,4327
05,05150,2027-12-31,3452,936,4388
05,05150,2028-12-31,3495,947,4442
05,05150,2029-12-31,3534,959,4493
05,05150,2030-12-31,3572,970,4542
05,05150,2031-12-31,3601,979,4580
05,05150,2032-12-31,3642,981,4623
05,05150,2033-12-31,3665,994,4659
05,05150,2034-12-31,3696,1004,4700
05,05150,2035-12-31,3734,1021,4755
05,05154,1985-12-31,23796,16593,40389
05,05154,1986-12-31,25379,16559,41938
05,05154,1987-12-31,27007,16474,43481
05,05154,1988-12-31,28645,16376,45021
05,05154,1989-12-31,30311,16288,46599
05,05154,1990-12-31,31966,16171,48137
05,05154,1991-12-31,33595,16056,49651
05,05154,1992-12-31,35241,15940,51181
05,05154,1993-12-31,36874,15829,52703
05,05154,1994-12-31,38509,15687,54196
05,05154,1995-12-31,40137,15566,55703
05,05154,1996-12-31,41777,15452,57229
05,05154,1997-12-31,43364,15389,58753
05,05154,1998-12-31,45018,15291,60309
05,05154,1999-12-31,46655,15183,61838
05,05154,2000-12-31,48292,15080,63372
05,05154,2001-12-31,49888,14963,64851
05,05154,2002-12-31,51472,14852,66324
05,05154,2003-12-31,53035,14735,67770
05,05154,2004-12-31,54588,14620,69208
05,05154,2005-12-31,56124,14506,70630
05,05154,2006-12-31,57663,14400,72063
05,05154,2007-12-31,59212,14303,73515
05,05154,2008-12-31,60740,14179,74919
05,05154,2009-12-31,62261,14091,76352
05,05154,2010-12-31,63817,14008,77825
05,05154,2011-12-31,65351,13923,79274
05,05154,2012-12-31,66891,13828,80719
05,05154,2013-12-31,68374,13707,82081
05,05154,2014-12-31,69888,13584,83472
05,05154,2015-12-31,71409,13517,84926
05,05154,2016-12-31,73035,13457,86492
05,05154,2017-12-31,74764,13424,88188
05,05154,2018-12-31,76772,13441,90213
05,05154,2019-12-31,80886,12158,93044
05,05154,2020-12-31,84654,10773,95427
05,05154,2021-12-31,86278,10649,96927
05,05154,2022-12-31,87807,10616,98423
05,05154,2023-12-31,89344,10615,99959
05,05154,2024-12-31,90953,10624,101577
05,05154,2025-12-31,92490,10660,103150
05,05154,2026-12-31,93941,10697,104638
05,05154,2027-12-31,95285,10761,106046
05,05154,2028-12-31,96535,10824,107359
05,05154,2029-12-31,97667,10922,108589
05,05154,2030-12-31,98673,11038,109711
05,05154,2031-12-31,99647,11146,110793
05,05154,2032-12-31,100537,11260,111797
05,05154,2033-12-31,101421,11389,112810
05,05154,2034-12-31,102293,11502,113795
05,05154,2035-12-31,103134,11617,114751
05,05172,1985-12-31,14978,8442,23420
05,05172,1986-12-31,15939,8541,24480
05,05172,1987-12-31,16920,8606,25526
05,05172,1988-12-31,17918,8676,26594
05,05172,1989-12-31,18957,8722,27679
05,05172,1990-12-31,19951,8769,28720
05,05172,1991-12-31,20953,8824,29777
05,05172,1992-12-31,21938,8881,30819
05,05172,1993-12-31,22939,8916,31855
05,05172,1994-12-31,23905,8967,32872
05,05172,1995-12-31,24892,9020,33912
05,05172,1996-12-31,25911,9055,34966
05,05172,1997-12-31,26850,9144,35994
05,05172,1998-12-31,27851,9192,37043
05,05172,1999-12-31,28855,9256,38111
05,05172,2000-12-31,29839,9308,39147
05,05172,2001-12-31,30804,9364,40168
05,05172,2002-12-31,31755,9403,41158
05,05172,2003-12-31,32694,9446,42140
05,05172,2004-12-31,33645,9493,43138
05,05172,2005-12-31,34583,9543,44126
05,05172,2006-12-31,35513,9593,45106
05,05172,2007-12-31,36432,9630,46062
05,05172,2008-12-31,37360,9688,47048
05,05172,2009-12-31,38278,9739,48017
05,05172,2010-12-31,39202,9811,49013
05,05172,2011-12-31,40141,9834,49975
05,05172,2012-12-31,41061,9888,50949
05,05172,2013-12-31,41968,9966,51934
05,05172,2014-12-31,42868,10009,52877
05,05172,2015-12-31,43789,10076,53865
05,05172,2016-12-31,44771,10137,54908
05,05172,2017-12-31,45832,10212,56044
05,05172,2018-12-31,47046,10329,57375
05,05172,2019-12-31,48871,9813,58684
05,05172,2020-12-31,50581,9255,59836
05,05172,2021-12-31,51626,9149,60775
05,05172,2022-12-31,52594,9120,61714
05,05172,2023-12-31,53559,9119,62678
05,05172,2024-12-31,54539,9137,63676
05,05172,2025-12-31,55460,9159,64619
05,05172,2026-12-31,56333,9185,65518
05,05172,2027-12-31,57137,9232,66369
05,05172,2028-12-31,57866,9298,67164
05,05172,2029-12-31,58544,9384,67928
05,05172,2030-12-31,59143,9460,68603
05,05172,2031-12-31,59714,9575,69289
05,05172,2032-12-31,60274,9691,69965
05,05172,2033-12-31,60806,9775,70581
05,05172,2034-12-31,61306,9882,71188
05,05172,2035-12-31,61802,9994,71796
05,05190,1985-12-31,7181,1986,9167
05,05190,1986-12-31,7208,1970,9178
05,05190,1987-12-31,7277,1932,9209
05,05190,1988-12-31,7349,1908,9257
05,05190,1989-12-31,7389,1889,9278
05,05190,1990-12-31,7429,1888,9317
05,05190,1991-12-31,7475,1867,9342
05,05190,1992-12-31,7528,1828,9356
05,05190,1993-12-31,7571,1813,9384
05,05190,1994-12-31,7604,1791,9395
05,05190,1995-12-31,7638,1745,9383
05,05190,1996-12-31,7680,1738,9418
05,05190,1997-12-31,7715,1737,9452
05,05190,1998-12-31,7748,1706,9454
05,05190,1999-12-31,7789,1702,9491
05,05190,2000-12-31,7837,1679,9516
05,05190,2001-12-31,7861,1652,9513
05,05190,2002-12-31,7897,1632,9529
05,05190,2003-12-31,7922,1602,9524
05,05190,2004-12-31,7939,1578,9517
05,05190,2005-12-31,7973,1545,9518
05,05190,2006-12-31,8004,1537,9541
05,05190,2007-12-31,8035,1513,9548
05,05190,2008-12-31,8060,1524,9584
05,05190,2009-12-31,8085,1506,9591
05,05190,2010-12-31,8120,1472,9592
05,05190,2011-12-31,8162,1475,9637
05,05190,2012-12-31,8183,1486,9669
05,05190,2013-12-31,8222,1448,9670
05,05190,2014-12-31,8200,1418,9618
05,05190,2015-12-31,8197,1390,9587
05,05190,2016-12-31,8244,1373,9617
05,05190,2017-12-31,8384,1363,9747
05,05190,2018-12-31,8415,1360,9775
05,05190,2019-12-31,8571,1273,9844
05,05190,2020-12-31,8755,1181,9936
05,05190,2021-12-31,8923,1167,10090
05,05190,2022-12-31,9082,1164,10246
05,05190,2023-12-31,9242,1164,10406
05,05190,2024-12-31,9412,1166,10578
05,05190,2025-12-31,9561,1166,10727
05,05190,2026-12-31,9713,1165,10878
05,05190,2027-12-31,9858,1175,11033
05,05190,2028-12-31,9986,1183,11169
05,05190,2029-12-31,10109,1196,11305
05,05190,2030-12-31,10204,1206,11410
05,05190,2031-12-31,10308,1216,11524
05,05190,2032-12-31,10401,1225,11626
05,05190,2033-12-31,10493,1245,11738
05,05190,2034-12-31,10585,1266,11851
05,05190,2035-12-31,10659,1285,11944
05,05197,1985-12-31,3762,28262,32024
05,05197,1986-12-31,3829,21485,25314
05,05197,1987-12-31,3908,21084,24992
05,05197,1988-12-31,3984,20687,24671
05,05197,1989-12-31,4065,20272,24337
05,05197,1990-12-31,4159,19849,24008
05,05197,1991-12-31,4234,19460,23694
05,05197,1992-12-31,4313,19033,23346
05,05197,1993-12-31,4361,18605,22966
05,05197,1994-12-31,4474,18170,22644
05,05197,1995-12-31,4554,17743,22297
05,05197,1996-12-31,4637,17345,21982
05,05197,1997-12-31,4702,16989,21691
05,05197,1998-12-31,4786,16600,21386
05,05197,1999-12-31,4868,16207,21075
05,05197,2000-12-31,4944,15801,20745
05,05197,2001-12-31,5029,15399,20428
05,05197,2002-12-31,5092,15003,20095
05,05197,2003-12-31,5164,14592,19756
05,05197,2004-12-31,5238,14191,19429
05,05197,2005-12-31,5313,13781,19094
05,05197,2006-12-31,5375,13398,18773
05,05197,2007-12-31,5452,13002,18454
05,05197,2008-12-31,5530,12614,18144
05,05197,2009-12-31,5607,12253,17860
05,05197,2010-12-31,5682,11906,17588
05,05197,2011-12-31,5772,11508,17280
05,05197,2012-12-31,5831,11159,16990
05,05197,2013-12-31,5920,10801,16721
05,05197,2014-12-31,5983,10451,16434
05,05197,2015-12-31,6061,10085,16146
05,05197,2016-12-31,6130,9743,15873
05,05197,2017-12-31,6220,9447,15667
05,05197,2018-12-31,6293,9151,15444
05,05197,2019-12-31,6502,8540,15042
05,05197,2020-12-31,6694,8139,14833
05,05197,2021-12-31,7018,8045,15063
05,05197,2022-12-31,7275,8021,15296
05,05197,2023-12-31,7514,8020,15534
05,05197,2024-12-31,7660,8027,15687
05,05197,2025-12-31,7793,8045,15838
05,05197,2026-12-31,7909,8081,15990
05,05197,2027-12-31,8020,8129,16149
05,05197,2028-12-31,8130,8177,16307
05,05197,2029-12-31,8227,8243,16470
05,05197,2030-12-31,8314,8335,16649
05,05197,2031-12-31,8386,8427,16813
05,05197,2032-12-31,8471,8511,16982
05,05197,2033-12-31,8541,8604,17145
05,05197,2034-12-31,8605,8687,17292
05,05197,2035-12-31,8685,8780,17465
05,05206,1985-12-31,1148,5505,6653
05,05206,1986-12-31,1177,5447,6624
05,05206,1987-12-31,1198,5371,6569
05,05206,1988-12-31,1216,5286,6502
05,05206,1989-12-31,1244,5200,6444
05,05206,1990-12-31,1259,5106,6365
05,05206,1991-12-31,1281,4997,6278
05,05206,1992-12-31,1319,4920,6239
05,05206,1993-12-31,1336,4833,6169
05,05206,1994-12-31,1359,4744,6103
05,05206,1995-12-31,1394,4616,6010
05,05206,1996-12-31,1392,4545,5937
05,05206,1997-12-31,1427,4482,5909
05,05206,1998-12-31,1451,4411,5862
05,05206,1999-12-31,1481,4322,5803
05,05206,2000-12-31,1508,4243,5751
05,05206,2001-12-31,1520,4177,5697
05,05206,2002-12-31,1548,4076,5624
05,05206,2003-12-31,1563,3990,5553
05,05206,2004-12-31,1585,3906,5491
05,05206,2005-12-31,1613,3835,5448
05,05206,2006-12-31,1611,3754,5365
05,05206,2007-12-31,1649,3667,5316
05,05206,2008-12-31,1674,3575,5249
05,05206,2009-12-31,1697,3515,5212
05,05206,2010-12-31,1734,3438,5172
05,05206,2011-12-31,1753,3369,5122
05,05206,2012-12-31,1772,3301,5073
05,05206,2013-12-31,1752,3232,4984
05,05206,2014-12-31,1769,3150,4919
05,05206,2015-12-31,1795,3082,4877
05,05206,2016-12-31,1826,3024,4850
05,05206,2017-12-31,1860,2973,4833
05,05206,2018-12-31,1908,2889,4797
05,05206,2019-12-31,1975,2785,4760
05,05206,2020-12-31,2038,2720,4758
05,05206,2021-12-31,2143,2689,4832
05,05206,2022-12-31,2226,2680,4906
05,05206,2023-12-31,2303,2680,4983
05,05206,2024-12-31,2343,2684,5027
05,05206,2025-12-31,2385,2685,5070
05,05206,2026-12-31,2424,2702,5126
05,05206,2027-12-31,2460,2707,5167
05,05206,2028-12-31,2486,2739,5225
05,05206,2029-12-31,2513,2760,5273
05,05206,2030-12-31,2551,2782,5333
05,05206,2031-12-31,2564,2813,5377
05,05206,2032-12-31,2593,2845,5438
05,05206,2033-12-31,2622,2871,5493
05,05206,2034-12-31,2639,2897,5536
05,05206,2035-12-31,2663,2932,5595
05,05209,1985-12-31,6683,15421,22104
05,05209,1986-12-31,6670,15454,22124
05,05209,1987-12-31,6732,15424,22156
05,05209,1988-12-31,6787,15382,22169
05,05209,1989-12-31,6777,15334,22111
05,05209,1990-12-31,6840,15269,22109
05,05209,1991-12-31,6864,15209,22073
05,05209,1992-12-31,6887,15147,22034
05,05209,1993-12-31,6912,15091,22003
05,05209,1994-12-31,6957,15018,21975
05,05209,1995-12-31,6978,14951,21929
05,05209,1996-12-31,7004,14892,21896
05,05209,1997-12-31,7004,14880,21884
05,05209,1998-12-31,7032,14843,21875
05,05209,1999-12-31,7054,14787,21841
05,05209,2000-12-31,7074,14722,21796
05,05209,2001-12-31,7079,14672,21751
05,05209,2002-12-31,7095,14621,21716
05,05209,2003-12-31,7118,14550,21668
05,05209,2004-12-31,7126,14480,21606
05,05209,2005-12-31,7130,14417,21547
05,05209,2006-12-31,7155,14367,21522
05,05209,2007-12-31,7167,14322,21489
05,05209,2008-12-31,7185,14263,21448
05,05209,2009-12-31,7176,14210,21386
05,05209,2010-12-31,7195,14186,21381
05,05209,2011-12-31,7206,14109,21315
05,05209,2012-12-31,7226,14034,21260
05,05209,2013-12-31,7245,14025,21270
05,05209,2014-12-31,7233,13951,21184
05,05209,2015-12-31,7214,13915,21129
05,05209,2016-12-31,7251,13902,21153
05,05209,2017-12-31,7347,13928,21275
05,05209,2018-12-31,7349,14028,21377
05,05209,2019-12-31,7492,14012,21504
05,05209,2020-12-31,7662,14026,21688
05,05209,2021-12-31,8157,13867,22024
05,05209,2022-12-31,8539,13825,22364
05,05209,2023-12-31,8890,13823,22713
05,05209,2024-12-31,9069,13839,22908
05,05209,2025-12-31,9215,13869,23084
05,05209,2026-12-31,9359,13916,23275
05,05209,2027-12-31,9500,13982,23482
05,05209,2028-12-31,9620,14102,23722
05,05209,2029-12-31,9735,14197,23932
05,05209,2030-12-31,9823,14342,24165
05,05209,2031-12-31,9935,14517,24452
05,05209,2032-12-31,10014,14668,24682
05,05209,2033-12-31,10115,14830,24945
05,05209,2034-12-31,10198,14983,25181
05,05209,2035-12-31,10282,15144,25426
05,05212,1985-12-31,26532,14632,41164
05,05212,1986-12-31,27599,14713,42312
05,05212,1987-12-31,28716,14761,43477
05,05212,1988-12-31,29836,14793,44629
05,05212,1989-12-31,30971,14817,45788
05,05212,1990-12-31,32107,14843,46950
05,05212,1991-12-31,33207,14862,48069
05,05212,1992-12-31,34305,14862,49167
05,05212,1993-12-31,35432,14889,50321
05,05212,1994-12-31,36511,14892,51403
05,05212,1995-12-31,37637,14883,52520
05,05212,1996-12-31,38744,14906,53650
05,05212,1997-12-31,39810,14978,54788
05,05212,1998-12-31,40928,14994,55922
05,05212,1999-12-31,42034,15008,57042
05,05212,2000-12-31,43122,15018,58140
05,05212,2001-12-31,44188,15040,59228
05,05212,2002-12-31,45250,15033,60283
05,05212,2003-12-31,46292,15034,61326
05,05212,2004-12-31,47322,15048,62370
05,05212,2005-12-31,48343,15035,63378
05,05212,2006-12-31,49391,15050,64441
05,05212,2007-12-31,50427,15060,65487
05,05212,2008-12-31,51458,15063,66521
05,05212,2009-12-31,52478,15084,67562
05,05212,2010-12-31,53520,15126,68646
05,05212,2011-12-31,54577,15139,69716
05,05212,2012-12-31,55588,15154,70742
05,05212,2013-12-31,56603,15169,71772
05,05212,2014-12-31,57622,15179,72801
05,05212,2015-12-31,58584,15212,73796
05,05212,2016-12-31,59696,15261,74957
05,05212,2017-12-31,60896,15314,76210
05,05212,2018-12-31,62343,15541,77884
05,05212,2019-12-31,64739,15261,80000
05,05212,2020-12-31,66981,14839,81820
05,05212,2021-12-31,68438,14668,83106
05,05212,2022-12-31,69766,14623,84389
05,05212,2023-12-31,71085,14621,85706
05,05212,2024-12-31,72384,14636,87020
05,05212,2025-12-31,73599,14679,88278
05,05212,2026-12-31,74746,14746,89492
05,05212,2027-12-31,75832,14813,90645
05,05212,2028-12-31,76812,14922,91734
05,05212,2029-12-31,77714,15047,92761
05,05212,2030-12-31,78523,15200,93723
05,05212,2031-12-31,79286,15358,94644
05,05212,2032-12-31,80025,15523,95548
05,05212,2033-12-31,80741,15696,96437
05,05212,2034-12-31,81423,15859,97282
05,05212,2035-12-31,82106,16015,98121
05,05234,1985-12-31,6792,14419,21211
05,05234,1986-12-31,6824,14485,21309
05,05234,1987-12-31,6939,14483,21422
05,05234,1988-12-31,7056,14483,21539
05,05234,1989-12-31,7119,14459,21578
05,05234,1990-12-31,7205,14436,21641
05,05234,1991-12-31,7274,14406,21680
05,05234,1992-12-31,7344,14373,21717
05,05234,1993-12-31,7416,14351,21767
05,05234,1994-12-31,7494,14306,21800
05,05234,1995-12-31,7583,14272,21855
05,05234,1996-12-31,7617,14247,21864
05,05234,1997-12-31,7684,14262,21946
05,05234,1998-12-31,7753,14248,22001
05,05234,1999-12-31,7830,14237,22067
05,05234,2000-12-31,7901,14218,22119
05,05234,2001-12-31,7970,14188,22158
05,05234,2002-12-31,8032,14134,22166
05,05234,2003-12-31,8097,14117,22214
05,05234,2004-12-31,8166,14096,22262
05,05234,2005-12-31,8203,14068,22271
05,05234,2006-12-31,8263,14036,22299
05,05234,2007-12-31,8337,14013,22350
05,05234,2008-12-31,8385,13954,22339
05,05234,2009-12-31,8452,13939,22391
05,05234,2010-12-31,8505,13930,22435
05,05234,2011-12-31,8583,13911,22494
05,05234,2012-12-31,8645,13882,22527
05,05234,2013-12-31,8673,13869,22542
05,05234,2014-12-31,8699,13871,22570
05,05234,2015-12-31,8742,13851,22593
05,05234,2016-12-31,8808,13865,22673
05,05234,2017-12-31,8924,13912,22836
05,05234,2018-12-31,9042,14002,23044
05,05234,2019-12-31,9194,14061,23255
05,05234,2020-12-31,9380,14129,23509
05,05234,2021-12-31,9905,13969,23874
05,05234,2022-12-31,10316,13926,24242
05,05234,2023-12-31,10696,13925,24621
05,05234,2024-12-31,10908,13947,24855
05,05234,2025-12-31,11091,13989,25080
05,05234,2026-12-31,11251,14033,25284
05,05234,2027-12-31,11421,14113,25534
05,05234,2028-12-31,11569,14211,25780
05,05234,2029-12-31,11706,14322,26028
05,05234,2030-12-31,11829,14467,26296
05,05234,2031-12-31,11952,14622,26574
05,05234,2032-12-31,12051,14787,26838
05,05234,2033-12-31,12160,14941,27101
05,05234,2034-12-31,12252,15094,27346
05,05234,2035-12-31,12366,15233,27599
05,05237,1985-12-31,5227,6467,11694
05,05237,1986-12-31,5440,6521,11961
05,05237,1987-12-31,5662,6512,12174
05,05237,1988-12-31,5884,6521,12405
05,05237,1989-12-31,6096,6536,12632
05,05237,1990-12-31,6308,6555,12863
05,05237,1991-12-31,6519,6548,13067
05,05237,1992-12-31,6734,6564,13298
05,05237,1993-12-31,6946,6567,13513
05,05237,1994-12-31,7152,6566,13718
05,05237,1995-12-31,7376,6551,13927
05,05237,1996-12-31,7598,6564,14162
05,05237,1997-12-31,7802,6573,14375
05,05237,1998-12-31,8013,6613,14626
05,05237,1999-12-31,8217,6612,14829
05,05237,2000-12-31,8438,6633,15071
05,05237,2001-12-31,8649,6614,15263
05,05237,2002-12-31,8851,6619,15470
05,05237,2003-12-31,9043,6617,15660
05,05237,2004-12-31,9247,6616,15863
05,05237,2005-12-31,9439,6623,16062
05,05237,2006-12-31,9629,6625,16254
05,05237,2007-12-31,9821,6636,16457
05,05237,2008-12-31,10012,6669,16681
05,05237,2009-12-31,10224,6652,16876
05,05237,2010-12-31,10418,6662,17080
05,05237,2011-12-31,10623,6669,17292
05,05237,2012-12-31,10786,6693,17479
05,05237,2013-12-31,10956,6700,17656
05,05237,2014-12-31,11150,6766,17916
05,05237,2015-12-31,11329,6755,18084
05,05237,2016-12-31,11565,6767,18332
05,05237,2017-12-31,11757,6776,18533
05,05237,2018-12-31,12081,6821,18902
05,05237,2019-12-31,12550,6782,19332
05,05237,2020-12-31,12989,6720,19709
05,05237,2021-12-31,13374,6644,20018
05,05237,2022-12-31,13704,6624,20328
05,05237,2023-12-31,14022,6623,20645
05,05237,2024-12-31,14290,6632,20922
05,05237,2025-12-31,14535,6646,21181
05,05237,2026-12-31,14761,6673,21434
05,05237,2027-12-31,14971,6706,21677
05,05237,2028-12-31,15176,6756,21932
05,05237,2029-12-31,15355,6813,22168
05,05237,2030-12-31,15515,6887,22402
05,05237,2031-12-31,15653,6955,22608
05,05237,2032-12-31,15798,7033,22831
05,05237,2033-12-31,15943,7108,23051
05,05237,2034-12-31,16087,7181,23268
05,05237,2035-12-31,16205,7258,23463
05,05240,1985-12-31,1809,14628,16437
05,05240,1986-12-31,1822,14550,16372
05,05240,1987-12-31,1833,14412,16245
05,05240,1988-12-31,1854,14262,16116
05,05240,1989-12-31,1868,14115,15983
05,05240,1990-12-31,1888,13954,15842
05,05240,1991-12-31,1904,13779,15683
05,05240,1992-12-31,1868,13619,15487
05,05240,1993-12-31,1918,13458,15376
05,05240,1994-12-31,1940,13281,15221
05,05240,1995-12-31,1946,13128,15074
05,05240,1996-12-31,1954,12957,14911
05,05240,1997-12-31,1954,12852,14806
05,05240,1998-12-31,1966,12717,14683
05,05240,1999-12-31,1985,12506,14491
05,05240,2000-12-31,2000,12390,14390
05,05240,2001-12-31,2017,12228,14245
05,05240,2002-12-31,2033,12076,14109
05,05240,2003-12-31,2046,11910,13956
05,05240,2004-12-31,2068,11691,13759
05,05240,2005-12-31,2055,11593,13648
05,05240,2006-12-31,2085,11426,13511
05,05240,2007-12-31,2101,11284,13385
05,05240,2008-12-31,2120,11121,13241
05,05240,2009-12-31,2127,10987,13114
05,05240,2010-12-31,2146,10844,12990
05,05240,2011-12-31,2164,10681,12845
05,05240,2012-12-31,2157,10559,12716
05,05240,2013-12-31,2188,10429,12617
05,05240,2014-12-31,2165,10296,12461
05,05240,2015-12-31,2143,10165,12308
05,05240,2016-12-31,2155,10072,12227
05,05240,2017-12-31,2192,9985,12177
05,05240,2018-12-31,2229,9929,12158
05,05240,2019-12-31,2270,9838,12108
05,05240,2020-12-31,2319,9815,12134
05,05240,2021-12-31,2618,9704,12322
05,05240,2022-12-31,2838,9674,12512
05,05240,2023-12-31,3035,9673,12708
05,05240,2024-12-31,3087,9679,12766
05,05240,2025-12-31,3151,9705,12856
05,05240,2026-12-31,3195,9748,12943
05,05240,2027-12-31,3244,9796,13040
05,05240,2028-12-31,3285,9869,13154
05,05240,2029-12-31,3323,9946,13269
05,05240,2030-12-31,3353,10046,13399
05,05240,2031-12-31,3387,10161,13548
05,05240,2032-12-31,3425,10280,13705
05,05240,2033-12-31,3458,10376,13834
05,05240,2034-12-31,3473,10479,13952
05,05240,2035-12-31,3505,10596,14101
05,05250,1985-12-31,12041,7510,19551
05,05250,1986-12-31,12659,7909,20568
05,05250,1987-12-31,13284,8300,21584
05,05250,1988-12-31,13960,8669,22629
05,05250,1989-12-31,14621,9034,23655
05,05250,1990-12-31,15264,9401,24665
05,05250,1991-12-31,15925,9758,25683
05,05250,1992-12-31,16564,10100,26664
05,05250,1993-12-31,17211,10446,27657
05,05250,1994-12-31,17852,10789,28641
05,05250,1995-12-31,18510,11144,29654
05,05250,1996-12-31,19149,11471,30620
05,05250,1997-12-31,19770,11857,31627
05,05250,1998-12-31,20423,12223,32646
05,05250,1999-12-31,21061,12559,33620
05,05250,2000-12-31,21690,12920,34610
05,05250,2001-12-31,22320,13251,35571
05,05250,2002-12-31,22948,13582,36530
05,05250,2003-12-31,23530,13913,37443
05,05250,2004-12-31,24142,14229,38371
05,05250,2005-12-31,24747,14525,39272
05,05250,2006-12-31,25343,14891,40234
05,05250,2007-12-31,25941,15221,41162
05,05250,2008-12-31,26518,15543,42061
05,05250,2009-12-31,27124,15846,42970
05,05250,2010-12-31,27704,16199,43903
05,05250,2011-12-31,28345,16536,44881
05,05250,2012-12-31,28929,16854,45783
05,05250,2013-12-31,29541,17137,46678
05,05250,2014-12-31,30100,17461,47561
05,05250,2015-12-31,30688,17805,48493
05,05250,2016-12-31,31321,18167,49488
05,05250,2017-12-31,31994,18550,50544
05,05250,2018-12-31,32823,19039,51862
05,05250,2019-12-31,33949,18976,52925
05,05250,2020-12-31,34991,18855,53846
05,05250,2021-12-31,36039,18642,54681
05,05250,2022-12-31,36941,18584,55525
05,05250,2023-12-31,37810,18582,56392
05,05250,2024-12-31,38531,18605,57136
05,05250,2025-12-31,39186,18655,57841
05,05250,2026-12-31,39792,18728,58520
05,05250,2027-12-31,40371,18824,59195
05,05250,2028-12-31,40888,18949,59837
05,05250,2029-12-31,41370,19123,60493
05,05250,2030-12-31,41801,19305,61106
05,05250,2031-12-31,42195,19514,61709
05,05250,2032-12-31,42588,19724,62312
05,05250,2033-12-31,42954,19927,62881
05,05250,2034-12-31,43324,20140,63464
05,05250,2035-12-31,43678,20344,64022
05,05264,1985-12-31,1937,3652,5589
05,05264,1986-12-31,2046,3732,5778
05,05264,1987-12-31,2163,3802,5965
05,05264,1988-12-31,2286,3851,6137
05,05264,1989-12-31,2379,3890,6269
05,05264,1990-12-31,2499,3958,6457
05,05264,1991-12-31,2609,4008,6617
05,05264,1992-12-31,2717,4069,6786
05,05264,1993-12-31,2843,4135,6978
05,05264,1994-12-31,2953,4187,7140
05,05264,1995-12-31,3063,4225,7288
05,05264,1996-12-31,3178,4276,7454
05,05264,1997-12-31,3285,4338,7623
05,05264,1998-12-31,3405,4396,7801
05,05264,1999-12-31,3526,4447,7973
05,05264,2000-12-31,3646,4503,8149
05,05264,2001-12-31,3762,4569,8331
05,05264,2002-12-31,3875,4619,8494
05,05264,2003-12-31,3974,4677,8651
05,05264,2004-12-31,4090,4734,8824
05,05264,2005-12-31,4199,4784,8983
05,05264,2006-12-31,4310,4839,9149
05,05264,2007-12-31,4404,4890,9294
05,05264,2008-12-31,4505,4918,9423
05,05264,2009-12-31,4634,4967,9601
05,05264,2010-12-31,4750,5023,9773
05,05264,2011-12-31,4816,5076,9892
05,05264,2012-12-31,4946,5149,10095
05,05264,2013-12-31,5065,5211,10276
05,05264,2014-12-31,5180,5285,10465
05,05264,2015-12-31,5283,5311,10594
05,05264,2016-12-31,5396,5434,10830
05,05264,2017-12-31,5513,5473,10986
05,05264,2018-12-31,5643,5516,11159
05,05264,2019-12-31,5907,5558,11465
05,05264,2020-12-31,6146,5582,11728
05,05264,2021-12-31,6393,5519,11912
05,05264,2022-12-31,6594,5502,12096
05,05264,2023-12-31,6784,5501,12285
05,05264,2024-12-31,6916,5505,12421
05,05264,2025-12-31,7033,5519,12552
05,05264,2026-12-31,7144,5542,12686
05,05264,2027-12-31,7238,5574,12812
05,05264,2028-12-31,7339,5601,12940
05,05264,2029-12-31,7437,5658,13095
05,05264,2030-12-31,7507,5708,13215
05,05264,2031-12-31,7584,5777,13361
05,05264,2032-12-31,7636,5852,13488
05,05264,2033-12-31,7703,5900,13603
05,05264,2034-12-31,7782,5965,13747
05,05264,2035-12-31,7840,6035,13875
05,05266,1985-12-31,83997,6564,90561
05,05266,1986-12-31,87832,6797,94629
05,05266,1987-12-31,91948,7007,98955
05,05266,1988-12-31,96073,7222,103295
05,05266,1989-12-31,100187,7436,107623
05,05266,1990-12-31,104246,7633,111879
05,05266,1991-12-31,108317,7835,116152
05,05266,1992-12-31,112377,8029,120406
05,05266,1993-12-31,116472,8223,124695
05,05266,1994-12-31,120478,8422,128900
05,05266,1995-12-31,124553,8596,133149
05,05266,1996-12-31,128664,8794,137458
05,05266,1997-12-31,132556,9010,141566
05,05266,1998-12-31,136660,9208,145868
05,05266,1999-12-31,140719,9402,150121
05,05266,2000-12-31,144729,9601,154330
05,05266,2001-12-31,148665,9785,158450
05,05266,2002-12-31,152544,9987,162531
05,05266,2003-12-31,156392,10131,166523
05,05266,2004-12-31,160208,10305,170513
05,05266,2005-12-31,164004,10497,174501
05,05266,2006-12-31,167889,10675,178564
05,05266,2007-12-31,171734,10893,182627
05,05266,2008-12-31,175569,11056,186625
05,05266,2009-12-31,179415,11247,190662
05,05266,2010-12-31,183319,11414,194733
05,05266,2011-12-31,187192,11580,198772
05,05266,2012-12-31,190979,11771,202750
05,05266,2013-12-31,194683,11975,206658
05,05266,2014-12-31,198432,12160,210592
05,05266,2015-12-31,202215,12324,214539
05,05266,2016-12-31,206271,12534,218805
05,05266,2017-12-31,210641,12815,223456
05,05266,2018-12-31,215766,13082,228848
05,05266,2019-12-31,225374,10740,236114
05,05266,2020-12-31,234143,8054,242197
05,05266,2021-12-31,238042,7961,246003
05,05266,2022-12-31,241863,7937,249800
05,05266,2023-12-31,245763,7936,253699
05,05266,2024-12-31,250152,7951,258103
05,05266,2025-12-31,254386,7953,262339
05,05266,2026-12-31,258362,7999,266361
05,05266,2027-12-31,262069,8047,270116
05,05266,2028-12-31,265485,8090,273575
05,05266,2029-12-31,268617,8164,276781
05,05266,2030-12-31,271438,8244,279682
05,05266,2031-12-31,274069,8335,282404
05,05266,2032-12-31,276606,8420,285026
05,05266,2033-12-31,279065,8516,287581
05,05266,2034-12-31,281458,8597,290055
05,05266,2035-12-31,283748,8691,292439
05,05282,1985-12-31,8208,16340,24548
05,05282,1986-12-31,8219,16428,24647
05,05282,1987-12-31,8230,16445,24675
05,05282,1988-12-31,8251,16445,24696
05,05282,1989-12-31,8242,16452,24694
05,05282,1990-12-31,8233,16436,24669
05,05282,1991-12-31,8263,16416,24679
05,05282,1992-12-31,8276,16384,24660
05,05282,1993-12-31,8290,16371,24661
05,05282,1994-12-31,8294,16359,24653
05,05282,1995-12-31,8258,16321,24579
05,05282,1996-12-31,8237,16317,24554
05,05282,1997-12-31,8233,16343,24576
05,05282,1998-12-31,8247,16329,24576
05,05282,1999-12-31,8235,16359,24594
05,05282,2000-12-31,8218,16299,24517
05,05282,2001-12-31,8219,16257,24476
05,05282,2002-12-31,8204,16233,24437
05,05282,2003-12-31,8173,16242,24415
05,05282,2004-12-31,8155,16210,24365
05,05282,2005-12-31,8127,16177,24304
05,05282,2006-12-31,8129,16162,24291
05,05282,2007-12-31,8115,16125,24240
05,05282,2008-12-31,8092,16093,24185
05,05282,2009-12-31,8081,16082,24163
05,05282,2010-12-31,8078,16079,24157
05,05282,2011-12-31,8065,16124,24189
05,05282,2012-12-31,8051,16127,24178
05,05282,2013-12-31,8043,16135,24178
05,05282,2014-12-31,8004,16109,24113
05,05282,2015-12-31,7943,16116,24059
05,05282,2016-12-31,7985,16158,24143
05,05282,2017-12-31,8026,16226,24252
05,05282,2018-12-31,8031,16377,24408
05,05282,2019-12-31,8131,16422,24553
05,05282,2020-12-31,8279,16475,24754
05,05282,2021-12-31,8849,16289,25138
05,05282,2022-12-31,9287,16239,25526
05,05282,2023-12-31,9687,16237,25924
05,05282,2024-12-31,9882,16259,26141
05,05282,2025-12-31,10048,16291,26339
05,05282,2026-12-31,10204,16351,26555
05,05282,2027-12-31,10353,16450,26803
05,05282,2028-12-31,10480,16558,27038
05,05282,2029-12-31,10608,16695,27303
05,05282,2030-12-31,10715,16875,27590
05,05282,2031-12-31,10824,17048,27872
05,05282,2032-12-31,10921,17232,28153
05,05282,2033-12-31,11018,17420,28438
05,05282,2034-12-31,11121,17611,28732
05,05282,2035-12-31,11211,17787,28998
05,05284,1985-12-31,6710,19916,26626
05,05284,1986-12-31,6781,19779,26560
05,05284,1987-12-31,6853,19544,26397
05,05284,1988-12-31,6960,19293,26253
05,05284,1989-12-31,7036,19038,26074
05,05284,1990-12-31,7081,18774,25855
05,05284,1991-12-31,7142,18505,25647
05,05284,1992-12-31,7206,18233,25439
05,05284,1993-12-31,7273,17960,25233
05,05284,1994-12-31,7320,17700,25020
05,05284,1995-12-31,7383,17402,24785
05,05284,1996-12-31,7448,17147,24595
05,05284,1997-12-31,7499,16946,24445
05,05284,1998-12-31,7553,16700,24253
05,05284,1999-12-31,7620,16460,24080
05,05284,2000-12-31,7686,16210,23896
05,05284,2001-12-31,7736,15962,23698
05,05284,2002-12-31,7796,15702,23498
05,05284,2003-12-31,7839,15440,23279
05,05284,2004-12-31,7886,15180,23066
05,05284,2005-12-31,7930,14920,22850
05,05284,2006-12-31,7986,14677,22663
05,05284,2007-12-31,8030,14433,22463
05,05284,2008-12-31,8092,14199,22291
05,05284,2009-12-31,8128,13962,22090
05,05284,2010-12-31,8189,13739,21928
05,05284,2011-12-31,8240,13516,21756
05,05284,2012-12-31,8286,13280,21566
05,05284,2013-12-31,8333,13057,21390
05,05284,2014-12-31,8335,12812,21147
05,05284,2015-12-31,8355,12589,20944
05,05284,2016-12-31,8427,12386,20813
05,05284,2017-12-31,8584,12236,20820
05,05284,2018-12-31,8639,12100,20739
05,05284,2019-12-31,8817,11840,20657
05,05284,2020-12-31,9020,11680,20700
05,05284,2021-12-31,9482,11539,21021
05,05284,2022-12-31,9843,11503,21346
05,05284,2023-12-31,10177,11502,21679
05,05284,2024-12-31,10374,11514,21888
05,05284,2025-12-31,10561,11545,22106
05,05284,2026-12-31,10721,11592,22313
05,05284,2027-12-31,10864,11653,22517
05,05284,2028-12-31,11008,11731,22739
05,05284,2029-12-31,11136,11834,22970
05,05284,2030-12-31,11255,11952,23207
05,05284,2031-12-31,11358,12085,23443
05,05284,2032-12-31,11463,12208,23671
05,05284,2033-12-31,11570,12345,23915
05,05284,2034-12-31,11660,12464,24124
05,05284,2035-12-31,11762,12597,24359
05,05306,1985-12-31,859,3134,3993
05,05306,1986-12-31,887,3132,4019
05,05306,1987-12-31,943,3168,4111
05,05306,1988-12-31,975,3189,4164
05,05306,1989-12-31,998,3189,4187
05,05306,1990-12-31,1055,3210,4265
05,05306,1991-12-31,1077,3192,4269
05,05306,1992-12-31,1118,3201,4319
05,05306,1993-12-31,1143,3216,4359
05,05306,1994-12-31,1187,3226,4413
05,05306,1995-12-31,1210,3234,4444
05,05306,1996-12-31,1263,3248,4511
05,05306,1997-12-31,1295,3244,4539
05,05306,1998-12-31,1337,3280,4617
05,05306,1999-12-31,1367,3291,4658
05,05306,2000-12-31,1395,3290,4685
05,05306,2001-12-31,1437,3286,4723
05,05306,2002-12-31,1485,3320,4805
05,05306,2003-12-31,1524,3315,4839
05,05306,2004-12-31,1563,3328,4891
05,05306,2005-12-31,1590,3302,4892
05,05306,2006-12-31,1624,3328,4952
05,05306,2007-12-31,1654,3322,4976
05,05306,2008-12-31,1689,3342,5031
05,05306,2009-12-31,1730,3359,5089
05,05306,2010-12-31,1765,3375,5140
05,05306,2011-12-31,1807,3412,5219
05,05306,2012-12-31,1853,3420,5273
05,05306,2013-12-31,1878,3427,5305
05,05306,2014-12-31,1895,3431,5326
05,05306,2015-12-31,1915,3434,5349
05,05306,2016-12-31,1957,3439,5396
05,05306,2017-12-31,2005,3455,5460
05,05306,2018-12-31,2061,3483,5544
05,05306,2019-12-31,2141,3511,5652
05,05306,2020-12-31,2216,3534,5750
05,05306,2021-12-31,2345,3494,5839
05,05306,2022-12-31,2446,3483,5929
05,05306,2023-12-31,2539,3483,6022
05,05306,2024-12-31,2588,3490,6078
05,05306,2025-12-31,2620,3494,6114
05,05306,2026-12-31,2672,3502,6174
05,05306,2027-12-31,2703,3522,6225
05,05306,2028-12-31,2746,3559,6305
05,05306,2029-12-31,2781,3578,6359
05,05306,2030-12-31,2816,3621,6437
05,05306,2031-12-31,2835,3673,6508
05,05306,2032-12-31,2862,3703,6565
05,05306,2033-12-31,2886,3734,6620
05,05306,2034-12-31,2915,3777,6692
05,05306,2035-12-31,2928,3810,6738
05,05308,1985-12-31,11483,13561,25044
05,05308,1986-12-31,12020,13942,25962
05,05308,1987-12-31,12529,14254,26783
05,05308,1988-12-31,13082,14559,27641
05,05308,1989-12-31,13630,14872,28502
05,05308,1990-12-31,14164,15151,29315
05,05308,1991-12-31,14701,15432,30133
05,05308,1992-12-31,15237,15699,30936
05,05308,1993-12-31,15766,15984,31750
05,05308,1994-12-31,16286,16238,32524
05,05308,1995-12-31,16818,16492,33310
05,05308,1996-12-31,17361,16792,34153
05,05308,1997-12-31,17848,17123,34971
05,05308,1998-12-31,18374,17416,35790
05,05308,1999-12-31,18909,17692,36601
05,05308,2000-12-31,19439,17970,37409
05,05308,2001-12-31,19942,18231,38173
05,05308,2002-12-31,20449,18484,38933
05,05308,2003-12-31,20945,18741,39686
05,05308,2004-12-31,21440,18994,40434
05,05308,2005-12-31,21941,19229,41170
05,05308,2006-12-31,22443,19481,41924
05,05308,2007-12-31,22935,19719,42654
05,05308,2008-12-31,23427,19979,43406
05,05308,2009-12-31,23931,20234,44165
05,05308,2010-12-31,24431,20503,44934
05,05308,2011-12-31,24910,20805,45715
05,05308,2012-12-31,25414,21067,46481
05,05308,2013-12-31,25916,21317,47233
05,05308,2014-12-31,26384,21593,47977
05,05308,2015-12-31,26855,21904,48759
05,05308,2016-12-31,27405,22208,49613
05,05308,2017-12-31,27931,22525,50456
05,05308,2018-12-31,28652,23010,51662
05,05308,2019-12-31,29845,23317,53162
05,05308,2020-12-31,30958,23481,54439
05,05308,2021-12-31,32079,23215,55294
05,05308,2022-12-31,33004,23144,56148
05,05308,2023-12-31,33883,23141,57024
05,05308,2024-12-31,34545,23169,57714
05,05308,2025-12-31,35131,23227,58358
05,05308,2026-12-31,35671,23298,58969
05,05308,2027-12-31,36190,23436,59626
05,05308,2028-12-31,36659,23605,60264
05,05308,2029-12-31,37098,23799,60897
05,05308,2030-12-31,37483,24043,61526
05,05308,2031-12-31,37842,24305,62147
05,05308,2032-12-31,38201,24563,62764
05,05308,2033-12-31,38543,24837,63380
05,05308,2034-12-31,38865,25093,63958
05,05308,2035-12-31,39178,25348,64526
05,05310,1985-12-31,3501,6091,9592
05,05310,1986-12-31,3545,6075,9620
05,05310,1987-12-31,3605,6049,9654
05,05310,1988-12-31,3631,6007,9638
05,05310,1989-12-31,3680,5954,9634
05,05310,1990-12-31,3737,5902,9639
05,05310,1991-12-31,3790,5853,9643
05,05310,1992-12-31,3802,5810,9612
05,05310,1993-12-31,3875,5751,9626
05,05310,1994-12-31,3912,5709,9621
05,05310,1995-12-31,3973,5643,9616
05,05310,1996-12-31,4036,5595,9631
05,05310,1997-12-31,4089,5561,9650
05,05310,1998-12-31,4158,5510,9668
05,05310,1999-12-31,4188,5478,9666
05,05310,2000-12-31,4225,5432,9657
05,05310,2001-12-31,4277,5390,9667
05,05310,2002-12-31,4328,5356,9684
05,05310,2003-12-31,4371,5307,9678
05,05310,2004-12-31,4395,5253,9648
05,05310,2005-12-31,4445,5197,9642
05,05310,2006-12-31,4471,5155,9626
05,05310,2007-12-31,4531,5109,9640
05,05310,2008-12-31,4565,5058,9623
05,05310,2009-12-31,4645,5018,9663
05,05310,2010-12-31,4656,4993,9649
05,05310,2011-12-31,4681,4935,9616
05,05310,2012-12-31,4709,4922,9631
05,05310,2013-12-31,4740,4866,9606
05,05310,2014-12-31,4795,4901,9696
05,05310,2015-12-31,4867,4826,9693
05,05310,2016-12-31,4876,4786,9662
05,05310,2017-12-31,4935,4741,9676
05,05310,2018-12-31,5017,4736,9753
05,05310,2019-12-31,5167,4661,9828
05,05310,2020-12-31,5318,4603,9921
05,05310,2021-12-31,5530,4545,10075
05,05310,2022-12-31,5701,4529,10230
05,05310,2023-12-31,5862,4528,10390
05,05310,2024-12-31,5988,4528,10516
05,05310,2025-12-31,6071,4544,10615
05,05310,2026-12-31,6169,4562,10731
05,05310,2027-12-31,6266,4586,10852
05,05310,2028-12-31,6343,4620,10963
05,05310,2029-12-31,6419,4653,11072
05,05310,2030-12-31,6489,4690,11179
05,05310,2031-12-31,6552,4752,11304
05,05310,2032-12-31,6600,4810,11410
05,05310,2033-12-31,6676,4846,11522
05,05310,2034-12-31,6723,4911,11634
05,05310,2035-12-31,6776,4962,11738
05,05313,1985-12-31,5101,15074,20175
05,05313,1986-12-31,5118,14819,19937
05,05313,1987-12-31,5156,14490,19646
05,05313,1988-12-31,5175,14159,19334
05,05313,1989-12-31,5196,13818,19014
05,05313,1990-12-31,5201,13466,18667
05,05313,1991-12-31,5218,13127,18345
05,05313,1992-12-31,5236,12764,18000
05,05313,1993-12-31,5255,12416,17671
05,05313,1994-12-31,5269,12079,17348
05,05313,1995-12-31,5287,11728,17015
05,05313,1996-12-31,5307,11388,16695
05,05313,1997-12-31,5320,11086,16406
05,05313,1998-12-31,5336,10773,16109
05,05313,1999-12-31,5341,10429,15770
05,05313,2000-12-31,5355,10115,15470
05,05313,2001-12-31,5371,9775,15146
05,05313,2002-12-31,5371,9441,14812
05,05313,2003-12-31,5381,9112,14493
05,05313,2004-12-31,5385,8780,14165
05,05313,2005-12-31,5401,8481,13882
05,05313,2006-12-31,5414,8161,13575
05,05313,2007-12-31,5414,7846,13260
05,05313,2008-12-31,5424,7533,12957
05,05313,2009-12-31,5433,7217,12650
05,05313,2010-12-31,5447,6909,12356
05,05313,2011-12-31,5450,6615,12065
05,05313,2012-12-31,5459,6311,11770
05,05313,2013-12-31,5475,6022,11497
05,05313,2014-12-31,5494,5731,11225
05,05313,2015-12-31,5495,5452,10947
05,05313,2016-12-31,5507,5147,10654
05,05313,2017-12-31,5522,4875,10397
05,05313,2018-12-31,5541,4576,10117
05,05313,2019-12-31,5447,4423,9870
05,05313,2020-12-31,5399,4365,9764
05,05313,2021-12-31,5604,4311,9915
05,05313,2022-12-31,5772,4297,10069
05,05313,2023-12-31,5929,4297,10226
05,05313,2024-12-31,6045,4303,10348
05,05313,2025-12-31,6142,4304,10446
05,05313,2026-12-31,6243,4328,10571
05,05313,2027-12-31,6327,4356,10683
05,05313,2028-12-31,6411,4381,10792
05,05313,2029-12-31,6484,4418,10902
05,05313,2030-12-31,6565,4463,11028
05,05313,2031-12-31,6618,4516,11134
05,05313,2032-12-31,6680,4568,11248
05,05313,2033-12-31,6736,4614,11350
05,05313,2034-12-31,6799,4672,11471
05,05313,2035-12-31,6850,4707,11557
05,05315,1985-12-31,1547,5169,6716
05,05315,1986-12-31,1578,5172,6750
05,05315,1987-12-31,1595,5154,6749
05,05315,1988-12-31,1620,5131,6751
05,05315,1989-12-31,1630,5099,6729
05,05315,1990-12-31,1656,5066,6722
05,05315,1991-12-31,1666,5044,6710
05,05315,1992-12-31,1686,5003,6689
05,05315,1993-12-31,1738,4965,6703
05,05315,1994-12-31,1728,4911,6639
05,05315,1995-12-31,1754,4877,6631
05,05315,1996-12-31,1775,4849,6624
05,05315,1997-12-31,1808,4840,6648
05,05315,1998-12-31,1829,4813,6642
05,05315,1999-12-31,1850,4778,6628
05,05315,2000-12-31,1869,4753,6622
05,05315,2001-12-31,1882,4737,6619
05,05315,2002-12-31,1878,4715,6593
05,05315,2003-12-31,1902,4691,6593
05,05315,2004-12-31,1926,4654,6580
05,05315,2005-12-31,1951,4617,6568
05,05315,2006-12-31,1976,4581,6557
05,05315,2007-12-31,1989,4576,6565
05,05315,2008-12-31,2015,4511,6526
05,05315,2009-12-31,2035,4501,6536
05,05315,2010-12-31,2056,4493,6549
05,05315,2011-12-31,2091,4432,6523
05,05315,2012-12-31,2118,4403,6521
05,05315,2013-12-31,2144,4382,6526
05,05315,2014-12-31,2117,4363,6480
05,05315,2015-12-31,2135,4359,6494
05,05315,2016-12-31,2143,4321,6464
05,05315,2017-12-31,2176,4320,6496
05,05315,2018-12-31,2223,4337,6560
05,05315,2019-12-31,2295,4312,6607
05,05315,2020-12-31,2362,4303,6665
05,05315,2021-12-31,2514,4254,6768
05,05315,2022-12-31,2632,4241,6873
05,05315,2023-12-31,2739,4241,6980
05,05315,2024-12-31,2784,4250,7034
05,05315,2025-12-31,2840,4262,7102
05,05315,2026-12-31,2881,4278,7159
05,05315,2027-12-31,2919,4295,7214
05,05315,2028-12-31,2962,4322,7284
05,05315,2029-12-31,2997,4368,7365
05,05315,2030-12-31,3027,4406,7433
05,05315,2031-12-31,3056,4453,7509
05,05315,2032-12-31,3077,4501,7578
05,05315,2033-12-31,3112,4562,7674
05,05315,2034-12-31,3140,4593,7733
05,05315,2035-12-31,3166,4649,7815
05,05318,1985-12-31,6013,19538,25551
05,05318,1986-12-31,6390,20193,26583
05,05318,1987-12-31,6803,20767,27570
05,05318,1988-12-31,7193,21317,28510
05,05318,1989-12-31,7575,21874,29449
05,05318,1990-12-31,7957,22386,30343
05,05318,1991-12-31,8329,22919,31248
05,05318,1992-12-31,8708,23428,32136
05,05318,1993-12-31,9101,23948,33049
05,05318,1994-12-31,9479,24440,33919
05,05318,1995-12-31,9860,24937,34797
05,05318,1996-12-31,10245,25442,35687
05,05318,1997-12-31,10602,26043,36645
05,05318,1998-12-31,10992,26568,37560
05,05318,1999-12-31,11363,27079,38442
05,05318,2000-12-31,11741,27577,39318
05,05318,2001-12-31,12089,28058,40147
05,05318,2002-12-31,12508,28541,41049
05,05318,2003-12-31,12810,28995,41805
05,05318,2004-12-31,13162,29479,42641
05,05318,2005-12-31,13527,29892,43419
05,05318,2006-12-31,13880,30367,44247
05,05318,2007-12-31,14246,30852,45098
05,05318,2008-12-31,14608,31332,45940
05,05318,2009-12-31,14945,31834,46779
05,05318,2010-12-31,15325,32344,47669
05,05318,2011-12-31,15678,32846,48524
05,05318,2012-12-31,16017,33339,49356
05,05318,2013-12-31,16342,33780,50122
05,05318,2014-12-31,16695,34297,50992
05,05318,2015-12-31,17095,34815,51910
05,05318,2016-12-31,17438,35355,52793
05,05318,2017-12-31,17795,36040,53835
05,05318,2018-12-31,18342,36779,55121
05,05318,2019-12-31,19066,37708,56774
05,05318,2020-12-31,19745,38414,58159
05,05318,2021-12-31,21093,37980,59073
05,05318,2022-12-31,22122,37863,59985
05,05318,2023-12-31,23063,37858,60921
05,05318,2024-12-31,23503,37902,61405
05,05318,2025-12-31,23907,37998,61905
05,05318,2026-12-31,24280,38142,62422
05,05318,2027-12-31,24629,38350,62979
05,05318,2028-12-31,24953,38617,63570
05,05318,2029-12-31,25251,38927,64178
05,05318,2030-12-31,25517,39324,64841
05,05318,2031-12-31,25764,39760,65524
05,05318,2032-12-31,25997,40190,66187
05,05318,2033-12-31,26220,40611,66831
05,05318,2034-12-31,26456,41037,67493
05,05318,2035-12-31,26664,41457,68121
05,05321,1985-12-31,2444,1869,4313
05,05321,1986-12-31,2563,1893,4456
05,05321,1987-12-31,2629,1935,4564
05,05321,1988-12-31,2733,1973,4706
05,05321,1989-12-31,2816,2001,4817
05,05321,1990-12-31,2894,2052,4946
05,05321,1991-12-31,2991,2072,5063
05,05321,1992-12-31,3074,2104,5178
05,05321,1993-12-31,3163,2132,5295
05,05321,1994-12-31,3257,2169,5426
05,05321,1995-12-31,3359,2169,5528
05,05321,1996-12-31,3448,2222,5670
05,05321,1997-12-31,3533,2268,5801
05,05321,1998-12-31,3642,2304,5946
05,05321,1999-12-31,3768,2334,6102
05,05321,2000-12-31,3789,2357,6146
05,05321,2001-12-31,3916,2399,6315
05,05321,2002-12-31,3979,2408,6387
05,05321,2003-12-31,4076,2449,6525
05,05321,2004-12-31,4179,2467,6646
05,05321,2005-12-31,4263,2496,6759
05,05321,2006-12-31,4341,2511,6852
05,05321,2007-12-31,4419,2546,6965
05,05321,2008-12-31,4517,2579,7096
05,05321,2009-12-31,4609,2610,7219
05,05321,2010-12-31,4703,2671,7374
05,05321,2011-12-31,4785,2648,7433
05,05321,2012-12-31,4833,2697,7530
05,05321,2013-12-31,4924,2748,7672
05,05321,2014-12-31,5012,2795,7807
05,05321,2015-12-31,5101,2825,7926
05,05321,2016-12-31,5205,2863,8068
05,05321,2017-12-31,5306,2897,8203
05,05321,2018-12-31,5420,2943,8363
05,05321,2019-12-31,5608,2940,8548
05,05321,2020-12-31,5782,2927,8709
05,05321,2021-12-31,5950,2894,8844
05,05321,2022-12-31,6096,2885,8981
05,05321,2023-12-31,6236,2885,9121
05,05321,2024-12-31,6361,2891,9252
05,05321,2025-12-31,6465,2890,9355
05,05321,2026-12-31,6562,2906,9468
05,05321,2027-12-31,6659,2923,9582
05,05321,2028-12-31,6759,2942,9701
05,05321,2029-12-31,6825,2965,9790
05,05321,2030-12-31,6892,3003,9895
05,05321,2031-12-31,6960,3029,9989
05,05321,2032-12-31,7035,3054,10089
05,05321,2033-12-31,7094,3099,10193
05,05321,2034-12-31,7154,3130,10284
05,05321,2035-12-31,7206,3157,10363
05,05347,1985-12-31,2167,6170,8337
05,05347,1986-12-31,2158,6103,8261
05,05347,1987-12-31,2164,6016,8180
05,05347,1988-12-31,2183,5916,8099
05,05347,1989-12-31,2162,5822,7984
05,05347,1990-12-31,2189,5723,7912
05,05347,1991-12-31,2168,5610,7778
05,05347,1992-12-31,2179,5506,7685
05,05347,1993-12-31,2194,5421,7615
05,05347,1994-12-31,2205,5313,7518
05,05347,1995-12-31,2187,5176,7363
05,05347,1996-12-31,2201,5081,7282
05,05347,1997-12-31,2231,5001,7232
05,05347,1998-12-31,2263,4877,7140
05,05347,1999-12-31,2248,4797,7045
05,05347,2000-12-31,2248,4702,6950
05,05347,2001-12-31,2255,4611,6866
05,05347,2002-12-31,2245,4523,6768
05,05347,2003-12-31,2249,4427,6676
05,05347,2004-12-31,2250,4336,6586
05,05347,2005-12-31,2276,4271,6547
05,05347,2006-12-31,2261,4150,6411
05,05347,2007-12-31,2284,4039,6323
05,05347,2008-12-31,2277,3939,6216
05,05347,2009-12-31,2304,3869,6173
05,05347,2010-12-31,2315,3786,6101
05,05347,2011-12-31,2290,3701,5991
05,05347,2012-12-31,2281,3619,5900
05,05347,2013-12-31,2264,3543,5807
05,05347,2014-12-31,2259,3451,5710
05,05347,2015-12-31,2263,3347,5610
05,05347,2016-12-31,2273,3289,5562
05,05347,2017-12-31,2285,3241,5526
05,05347,2018-12-31,2318,3133,5451
05,05347,2019-12-31,2362,3038,5400
05,05347,2020-12-31,2415,2980,5395
05,05347,2021-12-31,2533,2946,5479
05,05347,2022-12-31,2626,2937,5563
05,05347,2023-12-31,2714,2936,5650
05,05347,2024-12-31,2760,2942,5702
05,05347,2025-12-31,2811,2947,5758
05,05347,2026-12-31,2856,2958,5814
05,05347,2027-12-31,2897,2976,5873
05,05347,2028-12-31,2932,2997,5929
05,05347,2029-12-31,2972,3009,5981
05,05347,2030-12-31,3000,3048,6048
05,05347,2031-12-31,3030,3087,6117
05,05347,2032-12-31,3056,3112,6168
05,05347,2033-12-31,3089,3142,6231
05,05347,2034-12-31,3115,3179,6294
05,05347,2035-12-31,3143,3213,6356
05,05353,1985-12-31,2126,3171,5297
05,05353,1986-12-31,2172,3139,5311
05,05353,1987-12-31,2203,3120,5323
05,05353,1988-12-31,2232,3080,5312
05,05353,1989-12-31,2286,3046,5332
05,05353,1990-12-31,2339,2988,5327
05,05353,1991-12-31,2381,2944,5325
05,05353,1992-12-31,2410,2930,5340
05,05353,1993-12-31,2451,2872,5323
05,05353,1994-12-31,2489,2834,5323
05,05353,1995-12-31,2528,2810,5338
05,05353,1996-12-31,2564,2768,5332
05,05353,1997-12-31,2604,2745,5349
05,05353,1998-12-31,2641,2705,5346
05,05353,1999-12-31,2671,2683,5354
05,05353,2000-12-31,2721,2631,5352
05,05353,2001-12-31,2764,2613,5377
05,05353,2002-12-31,2795,2552,5347
05,05353,2003-12-31,2849,2513,5362
05,05353,2004-12-31,2888,2440,5328
05,05353,2005-12-31,2878,2437,5315
05,05353,2006-12-31,2918,2410,5328
05,05353,2007-12-31,2953,2363,5316
05,05353,2008-12-31,3004,2323,5327
05,05353,2009-12-31,3035,2301,5336
05,05353,2010-12-31,3072,2287,5359
05,05353,2011-12-31,3107,2229,5336
05,05353,2012-12-31,3144,2214,5358
05,05353,2013-12-31,3180,2193,5373
05,05353,2014-12-31,3212,2162,5374
05,05353,2015-12-31,3244,2143,5387
05,05353,2016-12-31,3294,2124,5418
05,05353,2017-12-31,3346,2047,5393
05,05353,2018-12-31,3416,2053,5469
05,05353,2019-12-31,3527,2003,5530
05,05353,2020-12-31,3635,1956,5591
05,05353,2021-12-31,3745,1933,5678
05,05353,2022-12-31,3837,1928,5765
05,05353,2023-12-31,3928,1927,5855
05,05353,2024-12-31,4004,1924,5928
05,05353,2025-12-31,4081,1928,6009
05,05353,2026-12-31,4133,1932,6065
05,05353,2027-12-31,4195,1946,6141
05,05353,2028-12-31,4256,1958,6214
05,05353,2029-12-31,4306,1976,6282
05,05353,2030-12-31,4350,1997,6347
05,05353,2031-12-31,4384,2017,6401
05,05353,2032-12-31,4437,2043,6480
05,05353,2033-12-31,4472,2065,6537
05,05353,2034-12-31,4502,2084,6586
05,05353,2035-12-31,4537,2108,6645
05,05360,1985-12-31,133877,1949,135826
05,05360,1986-12-31,137130,2823,139953
05,05360,1987-12-31,140805,3674,144479
05,05360,1988-12-31,144475,4541,149016
05,05360,1989-12-31,148130,5404,153534
05,05360,1990-12-31,151732,6240,157972
05,05360,1991-12-31,155286,7110,162396
05,05360,1992-12-31,158849,7945,166794
05,05360,1993-12-31,162434,8772,171206
05,05360,1994-12-31,165917,9607,175524
05,05360,1995-12-31,169499,10431,179930
05,05360,1996-12-31,173116,11260,184376
05,05360,1997-12-31,176436,12115,188551
05,05360,1998-12-31,180042,12923,192965
05,05360,1999-12-31,183564,13744,197308
05,05360,2000-12-31,187019,14553,201572
05,05360,2001-12-31,190417,15349,205766
05,05360,2002-12-31,193725,16143,209868
05,05360,2003-12-31,196990,16931,213921
05,05360,2004-12-31,200224,17711,217935
05,05360,2005-12-31,203435,18486,221921
05,05360,2006-12-31,206726,19252,225978
05,05360,2007-12-31,209979,20041,230020
05,05360,2008-12-31,213227,20784,234011
05,05360,2009-12-31,216481,21557,238038
05,05360,2010-12-31,219822,22328,242150
05,05360,2011-12-31,223102,23117,246219
05,05360,2012-12-31,226294,23890,250184
05,05360,2013-12-31,229421,24601,254022
05,05360,2014-12-31,232568,25410,257978
05,05360,2015-12-31,235764,26193,261957
05,05360,2016-12-31,239283,26974,266257
05,05360,2017-12-31,243168,27870,271038
05,05360,2018-12-31,247918,28826,276744
05,05360,2019-12-31,257026,26768,283794
05,05360,2020-12-31,265527,24467,289994
05,05360,2021-12-31,270366,24185,294551
05,05360,2022-12-31,274987,24111,299098
05,05360,2023-12-31,279658,24108,303766
05,05360,2024-12-31,284673,24133,308806
05,05360,2025-12-31,289467,24200,313667
05,05360,2026-12-31,294017,24297,318314
05,05360,2027-12-31,298232,24427,322659
05,05360,2028-12-31,302143,24598,326741
05,05360,2029-12-31,305688,24802,330490
05,05360,2030-12-31,308886,25055,333941
05,05360,2031-12-31,311861,25331,337192
05,05360,2032-12-31,314759,25600,340359
05,05360,2033-12-31,317542,25877,343419
05,05360,2034-12-31,320280,26157,346437
05,05360,2035-12-31,322890,26425,349315
05,05361,1985-12-31,4280,20434,24714
05,05361,1986-12-31,4401,20533,24934
05,05361,1987-12-31,4500,20533,25033
05,05361,1988-12-31,4565,20538,25103
05,05361,1989-12-31,4657,20520,25177
05,05361,1990-12-31,4744,20484,25228
05,05361,1991-12-31,4821,20429,25250
05,05361,1992-12-31,4912,20397,25309
05,05361,1993-12-31,5008,20360,25368
05,05361,1994-12-31,5094,20320,25414
05,05361,1995-12-31,5176,20280,25456
05,05361,1996-12-31,5270,20247,25517
05,05361,1997-12-31,5359,20283,25642
05,05361,1998-12-31,5440,20262,25702
05,05361,1999-12-31,5536,20238,25774
05,05361,2000-12-31,5581,20219,25800
05,05361,2001-12-31,5655,20181,25836
05,05361,2002-12-31,5756,20149,25905
05,05361,2003-12-31,5841,20095,25936
05,05361,2004-12-31,5926,20031,25957
05,05361,2005-12-31,6045,19982,26027
05,05361,2006-12-31,6085,19958,26043
05,05361,2007-12-31,6141,19932,26073
05,05361,2008-12-31,6216,19898,26114
05,05361,2009-12-31,6302,19864,26166
05,05361,2010-12-31,6401,19854,26255
05,05361,2011-12-31,6486,19851,26337
05,05361,2012-12-31,6577,19828,26405
05,05361,2013-12-31,6654,19769,26423
05,05361,2014-12-31,6708,19725,26433
05,05361,2015-12-31,6777,19752,26529
05,05361,2016-12-31,6857,19768,26625
05,05361,2017-12-31,6944,19842,26786
05,05361,2018-12-31,7074,20000,27074
05,05361,2019-12-31,7264,20155,27419
05,05361,2020-12-31,7459,20330,27789
05,05361,2021-12-31,8120,20100,28220
05,05361,2022-12-31,8618,20038,28656
05,05361,2023-12-31,9067,20036,29103
05,05361,2024-12-31,9246,20078,29324
05,05361,2025-12-31,9405,20127,29532
05,05361,2026-12-31,9547,20202,29749
05,05361,2027-12-31,9688,20315,30003
05,05361,2028-12-31,9808,20442,30250
05,05361,2029-12-31,9925,20630,30555
05,05361,2030-12-31,10025,20834,30859
05,05361,2031-12-31,10115,21054,31169
05,05361,2032-12-31,10218,21285,31503
05,05361,2033-12-31,10311,21509,31820
05,05361,2034-12-31,10404,21731,32135
05,05361,2035-12-31,10470,21962,32432
05,05364,1985-12-31,5638,7037,12675
05,05364,1986-12-31,5672,7056,12728
05,05364,1987-12-31,5822,7053,12875
05,05364,1988-12-31,5842,7039,12881
05,05364,1989-12-31,5933,7053,12986
05,05364,1990-12-31,5990,7023,13013
05,05364,1991-12-31,6042,7016,13058
05,05364,1992-12-31,6101,7002,13103
05,05364,1993-12-31,6183,6991,13174
05,05364,1994-12-31,6245,6964,13209
05,05364,1995-12-31,6295,6973,13268
05,05364,1996-12-31,6369,6939,13308
05,05364,1997-12-31,6424,6945,13369
05,05364,1998-12-31,6484,6947,13431
05,05364,1999-12-31,6555,6942,13497
05,05364,2000-12-31,6621,6933,13554
05,05364,2001-12-31,6678,6900,13578
05,05364,2002-12-31,6734,6900,13634
05,05364,2003-12-31,6782,6877,13659
05,05364,2004-12-31,6822,6877,13699
05,05364,2005-12-31,6870,6856,13726
05,05364,2006-12-31,6935,6848,13783
05,05364,2007-12-31,6991,6835,13826
05,05364,2008-12-31,7048,6840,13888
05,05364,2009-12-31,7111,6811,13922
05,05364,2010-12-31,7168,6801,13969
05,05364,2011-12-31,7239,6816,14055
05,05364,2012-12-31,7298,6808,14106
05,05364,2013-12-31,7345,6823,14168
05,05364,2014-12-31,7386,6801,14187
05,05364,2015-12-31,7416,6871,14287
05,05364,2016-12-31,7506,6851,14357
05,05364,2017-12-31,7623,6836,14459
05,05364,2018-12-31,7659,6859,14518
05,05364,2019-12-31,7851,6811,14662
05,05364,2020-12-31,8053,6777,14830
05,05364,2021-12-31,8360,6700,15060
05,05364,2022-12-31,8613,6680,15293
05,05364,2023-12-31,8852,6679,15531
05,05364,2024-12-31,9014,6680,15694
05,05364,2025-12-31,9177,6701,15878
05,05364,2026-12-31,9322,6725,16047
05,05364,2027-12-31,9466,6742,16208
05,05364,2028-12-31,9577,6804,16381
05,05364,2029-12-31,9692,6869,16561
05,05364,2030-12-31,9800,6937,16737
05,05364,2031-12-31,9880,7020,16900
05,05364,2032-12-31,9978,7088,17066
05,05364,2033-12-31,10060,7168,17228
05,05364,2034-12-31,10138,7248,17386
05,05364,2035-12-31,10236,7317,17553
05,05368,1985-12-31,6474,9253,15727
05,05368,1986-12-31,6509,9197,15706
05,05368,1987-12-31,6580,9100,15680
05,05368,1988-12-31,6643,8993,15636
05,05368,1989-12-31,6672,8890,15562
05,05368,1990-12-31,6705,8790,15495
05,05368,1991-12-31,6746,8671,15417
05,05368,1992-12-31,6778,8570,15348
05,05368,1993-12-31,6829,8424,15253
05,05368,1994-12-31,6852,8336,15188
05,05368,1995-12-31,6885,8217,15102
05,05368,1996-12-31,6942,8090,15032
05,05368,1997-12-31,6972,8018,14990
05,05368,1998-12-31,7001,7909,14910
05,05368,1999-12-31,7043,7812,14855
05,05368,2000-12-31,7066,7703,14769
05,05368,2001-12-31,7098,7592,14690
05,05368,2002-12-31,7132,7476,14608
05,05368,2003-12-31,7166,7372,14538
05,05368,2004-12-31,7142,7266,14408
05,05368,2005-12-31,7199,7164,14363
05,05368,2006-12-31,7207,7071,14278
05,05368,2007-12-31,7273,6973,14246
05,05368,2008-12-31,7281,6884,14165
05,05368,2009-12-31,7311,6756,14067
05,05368,2010-12-31,7352,6666,14018
05,05368,2011-12-31,7396,6580,13976
05,05368,2012-12-31,7426,6510,13936
05,05368,2013-12-31,7452,6407,13859
05,05368,2014-12-31,7448,6335,13783
05,05368,2015-12-31,7449,6234,13683
05,05368,2016-12-31,7507,6190,13697
05,05368,2017-12-31,7618,6115,13733
05,05368,2018-12-31,7619,6021,13640
05,05368,2019-12-31,7766,5871,13637
05,05368,2020-12-31,7937,5769,13706
05,05368,2021-12-31,8216,5703,13919
05,05368,2022-12-31,8448,5685,14133
05,05368,2023-12-31,8670,5684,14354
05,05368,2024-12-31,8839,5690,14529
05,05368,2025-12-31,8997,5700,14697
05,05368,2026-12-31,9129,5727,14856
05,05368,2027-12-31,9258,5753,15011
05,05368,2028-12-31,9371,5796,15167
05,05368,2029-12-31,9492,5842,15334
05,05368,2030-12-31,9590,5903,15493
05,05368,2031-12-31,9679,5967,15646
05,05368,2032-12-31,9768,6033,15801
05,05368,2033-12-31,9859,6095,15954
05,05368,2034-12-31,9946,6155,16101
05,05368,2035-12-31,10023,6225,16248
05,05376,1985-12-31,19030,9783,28813
05,05376,1986-12-31,20082,9849,29931
05,05376,1987-12-31,21208,9854,31062
05,05376,1988-12-31,22318,9865,32183
05,05376,1989-12-31,23449,9875,33324
05,05376,1990-12-31,24547,9884,34431
05,05376,1991-12-31,25660,9880,35540
05,05376,1992-12-31,26763,9872,36635
05,05376,1993-12-31,27873,9885,37758
05,05376,1994-12-31,28968,9858,38826
05,05376,1995-12-31,30069,9857,39926
05,05376,1996-12-31,31185,9859,41044
05,05376,1997-12-31,32249,9884,42133
05,05376,1998-12-31,33356,9889,43245
05,05376,1999-12-31,34474,9910,44384
05,05376,2000-12-31,35562,9892,45454
05,05376,2001-12-31,36637,9882,46519
05,05376,2002-12-31,37695,9881,47576
05,05376,2003-12-31,38743,9857,48600
05,05376,2004-12-31,39791,9857,49648
05,05376,2005-12-31,40835,9862,50697
05,05376,2006-12-31,41866,9848,51714
05,05376,2007-12-31,42913,9866,52779
05,05376,2008-12-31,43953,9878,53831
05,05376,2009-12-31,44980,9889,54869
05,05376,2010-12-31,46026,9888,55914
05,05376,2011-12-31,47079,9881,56960
05,05376,2012-12-31,48079,9856,57935
05,05376,2013-12-31,49125,9867,58992
05,05376,2014-12-31,50133,9885,60018
05,05376,2015-12-31,51162,9888,61050
05,05376,2016-12-31,52264,9921,62185
05,05376,2017-12-31,53432,9962,63394
05,05376,2018-12-31,54820,10069,64889
05,05376,2019-12-31,57342,9404,66746
05,05376,2020-12-31,59630,8695,68325
05,05376,2021-12-31,60804,8595,69399
05,05376,2022-12-31,61901,8569,70470
05,05376,2023-12-31,63002,8568,71570
05,05376,2024-12-31,64147,8581,72728
05,05376,2025-12-31,65233,8607,73840
05,05376,2026-12-31,66247,8629,74876
05,05376,2027-12-31,67195,8677,75872
05,05376,2028-12-31,68075,8742,76817
05,05376,2029-12-31,68877,8804,77681
05,05376,2030-12-31,69589,8893,78482
05,05376,2031-12-31,70262,8983,79245
05,05376,2032-12-31,70917,9096,80013
05,05376,2033-12-31,71549,9190,80739
05,05376,2034-12-31,72163,9281,81444
05,05376,2035-12-31,72752,9362,82114
05,05380,1985-12-31,15456,15519,30975
05,05380,1986-12-31,16789,15425,32214
05,05380,1987-12-31,18177,15292,33469
05,05380,1988-12-31,19574,15135,34709
05,05380,1989-12-31,21013,14977,35990
05,05380,1990-12-31,22418,14808,37226
05,05380,1991-12-31,23823,14639,38462
05,05380,1992-12-31,25229,14441,39670
05,05380,1993-12-31,26615,14277,40892
05,05380,1994-12-31,28009,14084,42093
05,05380,1995-12-31,29407,13902,43309
05,05380,1996-12-31,30816,13745,44561
05,05380,1997-12-31,32173,13611,45784
05,05380,1998-12-31,33582,13462,47044
05,05380,1999-12-31,34988,13303,48291
05,05380,2000-12-31,36360,13141,49501
05,05380,2001-12-31,37735,12977,50712
05,05380,2002-12-31,39080,12795,51875
05,05380,2003-12-31,40430,12630,53060
05,05380,2004-12-31,41777,12474,54251
05,05380,2005-12-31,43086,12298,55384
05,05380,2006-12-31,44444,12159,56603
05,05380,2007-12-31,45788,12010,57798
05,05380,2008-12-31,47114,11848,58962
05,05380,2009-12-31,48446,11710,60156
05,05380,2010-12-31,49789,11563,61352
05,05380,2011-12-31,51145,11399,62544
05,05380,2012-12-31,52450,11233,63683
05,05380,2013-12-31,53772,11098,64870
05,05380,2014-12-31,55084,10951,66035
05,05380,2015-12-31,56405,10803,67208
05,05380,2016-12-31,57778,10705,68483
05,05380,2017-12-31,59248,10588,69836
05,05380,2018-12-31,60997,10548,71545
05,05380,2019-12-31,63364,10332,73696
05,05380,2020-12-31,65582,9935,75517
05,05380,2021-12-31,66883,9821,76704
05,05380,2022-12-31,68098,9790,77888
05,05380,2023-12-31,69314,9789,79103
05,05380,2024-12-31,70561,9800,80361
05,05380,2025-12-31,71758,9829,81587
05,05380,2026-12-31,72880,9870,82750
05,05380,2027-12-31,73916,9927,83843
05,05380,2028-12-31,74890,9995,84885
05,05380,2029-12-31,75772,10079,85851
05,05380,2030-12-31,76567,10173,86740
05,05380,2031-12-31,77311,10280,87591
05,05380,2032-12-31,78012,10415,88427
05,05380,2033-12-31,78718,10511,89229
05,05380,2034-12-31,79395,10607,90002
05,05380,2035-12-31,80031,10731,90762
05,05390,1985-12-31,0,0,0
05,05390,1986-12-31,0,0,0
05,05390,1987-12-31,0,0,0
05,05390,1988-12-31,0,0,0
05,05390,1989-12-31,0,0,0
05,05390,1990-12-31,0,0,0
05,05390,1991-12-31,0,0,0
05,05390,1992-12-31,0,0,0
05,05390,1993-12-31,0,0,0
05,05390,1994-12-31,0,0,0
05,05390,1995-12-31,0,0,0
05,05390,1996-12-31,0,0,0
05,05390,1997-12-31,5806,5401,11207
05,05390,1998-12-31,5881,5187,11068
05,05390,1999-12-31,5942,4972,10914
05,05390,2000-12-31,6001,4757,10758
05,05390,2001-12-31,6061,4525,10586
05,05390,2002-12-31,6110,4322,10432
05,05390,2003-12-31,6171,4104,10275
05,05390,2004-12-31,6234,3891,10125
05,05390,2005-12-31,6278,3684,9962
05,05390,2006-12-31,6345,3500,9845
05,05390,2007-12-31,6392,3263,9655
05,05390,2008-12-31,6451,3042,9493
05,05390,2009-12-31,6513,2852,9365
05,05390,2010-12-31,6562,2628,9190
05,05390,2011-12-31,6626,2433,9059
05,05390,2012-12-31,6688,2242,8930
05,05390,2013-12-31,6757,2023,8780
05,05390,2014-12-31,6781,1848,8629
05,05390,2015-12-31,6820,1648,8468
05,05390,2016-12-31,6886,1457,8343
05,05390,2017-12-31,7010,1246,8256
05,05390,2018-12-31,7060,1054,8114
05,05390,2019-12-31,7343,955,8298
05,05390,2020-12-31,7611,849,8460
05,05390,2021-12-31,7754,839,8593
05,05390,2022-12-31,7889,837,8726
05,05390,2023-12-31,8025,837,8862
05,05390,2024-12-31,8177,833,9010
05,05390,2025-12-31,8312,836,9148
05,05390,2026-12-31,8433,837,9270
05,05390,2027-12-31,8562,847,9409
05,05390,2028-12-31,8666,855,9521
05,05390,2029-12-31,8774,862,9636
05,05390,2030-12-31,8863,864,9727
05,05390,2031-12-31,8951,876,9827
05,05390,2032-12-31,9035,881,9916
05,05390,2033-12-31,9117,893,10010
05,05390,2034-12-31,9194,903,10097
05,05390,2035-12-31,9279,912,10191
05,05400,1985-12-31,4430,10004,14434
05,05400,1986-12-31,4673,10012,14685
05,05400,1987-12-31,4935,9986,14921
05,05400,1988-12-31,5185,9949,15134
05,05400,1989-12-31,5420,9908,15328
05,05400,1990-12-31,5696,9849,15545
05,05400,1991-12-31,5933,9805,15738
05,05400,1992-12-31,6203,9746,15949
05,05400,1993-12-31,6452,9693,16145
05,05400,1994-12-31,6705,9641,16346
05,05400,1995-12-31,6952,9581,16533
05,05400,1996-12-31,7255,9544,16799
05,05400,1997-12-31,7502,9524,17026
05,05400,1998-12-31,7764,9473,17237
05,05400,1999-12-31,8013,9424,17437
05,05400,2000-12-31,8271,9380,17651
05,05400,2001-12-31,8525,9331,17856
05,05400,2002-12-31,8768,9291,18059
05,05400,2003-12-31,9000,9233,18233
05,05400,2004-12-31,9240,9180,18420
05,05400,2005-12-31,9471,9139,18610
05,05400,2006-12-31,9716,9089,18805
05,05400,2007-12-31,9972,9040,19012
05,05400,2008-12-31,10201,9015,19216
05,05400,2009-12-31,10468,8971,19439
05,05400,2010-12-31,10662,8955,19617
05,05400,2011-12-31,10947,8863,19810
05,05400,2012-12-31,11161,8851,20012
05,05400,2013-12-31,11382,8859,20241
05,05400,2014-12-31,11595,8810,20405
05,05400,2015-12-31,11823,8749,20572
05,05400,2016-12-31,12052,8732,20784
05,05400,2017-12-31,12326,8749,21075
05,05400,2018-12-31,12724,8751,21475
05,05400,2019-12-31,13326,8637,21963
05,05400,2020-12-31,13870,8521,22391
05,05400,2021-12-31,14318,8424,22742
05,05400,2022-12-31,14697,8397,23094
05,05400,2023-12-31,15059,8396,23455
05,05400,2024-12-31,15349,8408,23757
05,05400,2025-12-31,15610,8420,24030
05,05400,2026-12-31,15855,8460,24315
05,05400,2027-12-31,16084,8504,24588
05,05400,2028-12-31,16285,8555,24840
05,05400,2029-12-31,16482,8644,25126
05,05400,2030-12-31,16661,8732,25393
05,05400,2031-12-31,16821,8834,25655
05,05400,2032-12-31,16973,8916,25889
05,05400,2033-12-31,17128,9011,26139
05,05400,2034-12-31,17266,9103,26369
05,05400,2035-12-31,17413,9200,26613
05,05411,1985-12-31,2034,9481,11515
05,05411,1986-12-31,2016,9459,11475
05,05411,1987-12-31,2040,9425,11465
05,05411,1988-12-31,2069,9366,11435
05,05411,1989-12-31,2085,9298,11383
05,05411,1990-12-31,2065,9239,11304
05,05411,1991-12-31,2069,9171,11240
05,05411,1992-12-31,2082,9096,11178
05,05411,1993-12-31,2085,9043,11128
05,05411,1994-12-31,2112,8959,11071
05,05411,1995-12-31,2114,8903,11017
05,05411,1996-12-31,2122,8834,10956
05,05411,1997-12-31,2140,8807,10947
05,05411,1998-12-31,2125,8743,10868
05,05411,1999-12-31,2155,8694,10849
05,05411,2000-12-31,2156,8615,10771
05,05411,2001-12-31,2154,8563,10717
05,05411,2002-12-31,2168,8496,10664
05,05411,2003-12-31,2186,8434,10620
05,05411,2004-12-31,2180,8370,10550
05,05411,2005-12-31,2205,8304,10509
05,05411,2006-12-31,2203,8248,10451
05,05411,2007-12-31,2222,8194,10416
05,05411,2008-12-31,2231,8180,10411
05,05411,2009-12-31,2227,8071,10298
05,05411,2010-12-31,2223,8024,10247
05,05411,2011-12-31,2240,7986,10226
05,05411,2012-12-31,2230,7936,10166
05,05411,2013-12-31,2242,7886,10128
05,05411,2014-12-31,2266,7840,10106
05,05411,2015-12-31,2298,7795,10093
05,05411,2016-12-31,2297,7797,10094
05,05411,2017-12-31,2253,7754,10007
05,05411,2018-12-31,2296,7732,10028
05,05411,2019-12-31,2316,7724,10040
05,05411,2020-12-31,2348,7742,10090
05,05411,2021-12-31,2593,7654,10247
05,05411,2022-12-31,2774,7631,10405
05,05411,2023-12-31,2937,7630,10567
05,05411,2024-12-31,2996,7641,10637
05,05411,2025-12-31,3034,7653,10687
05,05411,2026-12-31,3082,7694,10776
05,05411,2027-12-31,3138,7731,10869
05,05411,2028-12-31,3182,7779,10961
05,05411,2029-12-31,3218,7847,11065
05,05411,2030-12-31,3250,7931,11181
05,05411,2031-12-31,3286,8011,11297
05,05411,2032-12-31,3309,8091,11400
05,05411,2033-12-31,3338,8185,11523
05,05411,2034-12-31,3370,8260,11630
05,05411,2035-12-31,3388,8352,11740
05,05425,1985-12-31,2743,6909,9652
05,05425,1986-12-31,2765,6880,9645
05,05425,1987-12-31,2770,6815,9585
05,05425,1988-12-31,2782,6776,9558
05,05425,1989-12-31,2786,6678,9464
05,05425,1990-12-31,2817,6636,9453
05,05425,1991-12-31,2818,6577,9395
05,05425,1992-12-31,2829,6519,9348
05,05425,1993-12-31,2840,6445,9285
05,05425,1994-12-31,2852,6390,9242
05,05425,1995-12-31,2850,6316,9166
05,05425,1996-12-31,2858,6269,9127
05,05425,1997-12-31,2871,6221,9092
05,05425,1998-12-31,2888,6155,9043
05,05425,1999-12-31,2889,6092,8981
05,05425,2000-12-31,2916,6028,8944
05,05425,2001-12-31,2926,5970,8896
05,05425,2002-12-31,2933,5909,8842
05,05425,2003-12-31,2945,5859,8804
05,05425,2004-12-31,2947,5806,8753
05,05425,2005-12-31,2947,5741,8688
05,05425,2006-12-31,2948,5684,8632
05,05425,2007-12-31,2960,5637,8597
05,05425,2008-12-31,2971,5581,8552
05,05425,2009-12-31,2981,5499,8480
05,05425,2010-12-31,2999,5452,8451
05,05425,2011-12-31,3008,5403,8411
05,05425,2012-12-31,3023,5373,8396
05,05425,2013-12-31,3030,5342,8372
05,05425,2014-12-31,3049,5277,8326
05,05425,2015-12-31,3075,5242,8317
05,05425,2016-12-31,3071,5206,8277
05,05425,2017-12-31,3043,5145,8188
05,05425,2018-12-31,3093,5128,8221
05,05425,2019-12-31,3147,5071,8218
05,05425,2020-12-31,3211,5037,8248
05,05425,2021-12-31,3396,4980,8376
05,05425,2022-12-31,3540,4965,8505
05,05425,2023-12-31,3674,4964,8638
05,05425,2024-12-31,3751,4960,8711
05,05425,2025-12-31,3805,4976,8781
05,05425,2026-12-31,3866,4997,8863
05,05425,2027-12-31,3924,5026,8950
05,05425,2028-12-31,3977,5063,9040
05,05425,2029-12-31,4020,5099,9119
05,05425,2030-12-31,4056,5158,9214
05,05425,2031-12-31,4101,5210,9311
05,05425,2032-12-31,4130,5276,9406
05,05425,2033-12-31,4169,5320,9489
05,05425,2034-12-31,4220,5382,9602
05,05425,2035-12-31,4243,5431,9674
05,05440,1985-12-31,11892,21672,33564
05,05440,1986-12-31,12865,21754,34619
05,05440,1987-12-31,13847,21718,35565
05,05440,1988-12-31,14845,21674,36519
05,05440,1989-12-31,15859,21639,37498
05,05440,1990-12-31,16859,21579,38438
05,05440,1991-12-31,17853,21519,39372
05,05440,1992-12-31,18850,21446,40296
05,05440,1993-12-31,19851,21378,41229
05,05440,1994-12-31,20829,21302,42131
05,05440,1995-12-31,21820,21238,43058
05,05440,1996-12-31,22824,21173,43997
05,05440,1997-12-31,23798,21189,44987
05,05440,1998-12-31,24783,21153,45936
05,05440,1999-12-31,25807,21096,46903
05,05440,2000-12-31,26790,21039,47829
05,05440,2001-12-31,27758,20971,48729
05,05440,2002-12-31,28720,20910,49630
05,05440,2003-12-31,29678,20840,50518
05,05440,2004-12-31,30616,20775,51391
05,05440,2005-12-31,31559,20683,52242
05,05440,2006-12-31,32512,20614,53126
05,05440,2007-12-31,33491,20557,54048
05,05440,2008-12-31,34414,20503,54917
05,05440,2009-12-31,35337,20441,55778
05,05440,2010-12-31,36280,20405,56685
05,05440,2011-12-31,37243,20399,57642
05,05440,2012-12-31,38179,20349,58528
05,05440,2013-12-31,39096,20282,59378
05,05440,2014-12-31,40031,20237,60268
05,05440,2015-12-31,40958,20243,61201
05,05440,2016-12-31,41938,20256,62194
05,05440,2017-12-31,42970,20264,63234
05,05440,2018-12-31,44230,20415,64645
05,05440,2019-12-31,46348,20051,66399
05,05440,2020-12-31,48258,19635,67893
05,05440,2021-12-31,49551,19409,68960
05,05440,2022-12-31,50675,19349,70024
05,05440,2023-12-31,51770,19347,71117
05,05440,2024-12-31,52730,19374,72104
05,05440,2025-12-31,53622,19417,73039
05,05440,2026-12-31,54460,19501,73961
05,05440,2027-12-31,55246,19603,74849
05,05440,2028-12-31,55960,19734,75694
05,05440,2029-12-31,56624,19898,76522
05,05440,2030-12-31,57211,20101,77312
05,05440,2031-12-31,57767,20324,78091
05,05440,2032-12-31,58308,20541,78849
05,05440,2033-12-31,58816,20767,79583
05,05440,2034-12-31,59320,20977,80297
05,05440,2035-12-31,59807,21197,81004
05,05467,1985-12-31,1423,8442,9865
05,05467,1986-12-31,1434,8362,9796
05,05467,1987-12-31,1447,8253,9700
05,05467,1988-12-31,1431,8147,9578
05,05467,1989-12-31,1483,8018,9501
05,05467,1990-12-31,1472,7907,9379
05,05467,1991-12-31,1470,7782,9252
05,05467,1992-12-31,1510,7644,9154
05,05467,1993-12-31,1535,7528,9063
05,05467,1994-12-31,1538,7397,8935
05,05467,1995-12-31,1561,7286,8847
05,05467,1996-12-31,1585,7159,8744
05,05467,1997-12-31,1593,7056,8649
05,05467,1998-12-31,1607,6956,8563
05,05467,1999-12-31,1629,6837,8466
05,05467,2000-12-31,1623,6659,8282
05,05467,2001-12-31,1639,6543,8182
05,05467,2002-12-31,1659,6431,8090
05,05467,2003-12-31,1665,6326,7991
05,05467,2004-12-31,1676,6265,7941
05,05467,2005-12-31,1711,6134,7845
05,05467,2006-12-31,1708,6001,7709
05,05467,2007-12-31,1715,5884,7599
05,05467,2008-12-31,1758,5799,7557
05,05467,2009-12-31,1785,5670,7455
05,05467,2010-12-31,1779,5562,7341
05,05467,2011-12-31,1776,5470,7246
05,05467,2012-12-31,1772,5378,7150
05,05467,2013-12-31,1785,5281,7066
05,05467,2014-12-31,1791,5190,6981
05,05467,2015-12-31,1801,5096,6897
05,05467,2016-12-31,1812,4974,6786
05,05467,2017-12-31,1836,4943,6779
05,05467,2018-12-31,1866,4814,6680
05,05467,2019-12-31,1911,4724,6635
05,05467,2020-12-31,1960,4681,6641
05,05467,2021-12-31,2127,4617,6744
05,05467,2022-12-31,2254,4594,6848
05,05467,2023-12-31,2365,4590,6955
05,05467,2024-12-31,2408,4585,6993
05,05467,2025-12-31,2449,4605,7054
05,05467,2026-12-31,2495,4618,7113
05,05467,2027-12-31,2525,4648,7173
05,05467,2028-12-31,2563,4684,7247
05,05467,2029-12-31,2591,4722,7313
05,05467,2030-12-31,2613,4774,7387
05,05467,2031-12-31,2639,4827,7466
05,05467,2032-12-31,2669,4873,7542
05,05467,2033-12-31,2691,4925,7616
05,05467,2034-12-31,2715,4973,7688
05,05467,2035-12-31,2729,5027,7756
05,05475,1985-12-31,596,992,1588
05,05475,1986-12-31,649,1022,1671
05,05475,1987-12-31,674,1095,1769
05,05475,1988-12-31,704,1182,1886
05,05475,1989-12-31,750,1227,1977
05,05475,1990-12-31,783,1324,2107
05,05475,1991-12-31,820,1385,2205
05,05475,1992-12-31,849,1455,2304
05,05475,1993-12-31,901,1546,2447
05,05475,1994-12-31,921,1581,2502
05,05475,1995-12-31,965,1650,2615
05,05475,1996-12-31,1000,1740,2740
05,05475,1997-12-31,1053,1802,2855
05,05475,1998-12-31,1046,1875,2921
05,05475,1999-12-31,1093,1930,3023
05,05475,2000-12-31,1128,1995,3123
05,05475,2001-12-31,1137,2065,3202
05,05475,2002-12-31,1211,2139,3350
05,05475,2003-12-31,1228,2192,3420
05,05475,2004-12-31,1259,2255,3514
05,05475,2005-12-31,1299,2312,3611
05,05475,2006-12-31,1329,2363,3692
05,05475,2007-12-31,1357,2429,3786
05,05475,2008-12-31,1403,2493,3896
05,05475,2009-12-31,1442,2562,4004
05,05475,2010-12-31,1477,2609,4086
05,05475,2011-12-31,1495,2685,4180
05,05475,2012-12-31,1538,2755,4293
05,05475,2013-12-31,1571,2820,4391
05,05475,2014-12-31,1596,2884,4480
05,05475,2015-12-31,1630,2959,4589
05,05475,2016-12-31,1664,3032,4696
05,05475,2017-12-31,1709,3099,4808
05,05475,2018-12-31,1760,3151,4911
05,05475,2019-12-31,1813,3275,5088
05,05475,2020-12-31,1860,3374,5234
05,05475,2021-12-31,1980,3336,5316
05,05475,2022-12-31,2072,3326,5398
05,05475,2023-12-31,2158,3325,5483
05,05475,2024-12-31,2195,3336,5531
05,05475,2025-12-31,2236,3346,5582
05,05475,2026-12-31,2269,3359,5628
05,05475,2027-12-31,2311,3374,5685
05,05475,2028-12-31,2335,3399,5734
05,05475,2029-12-31,2359,3420,5779
05,05475,2030-12-31,2385,3453,5838
05,05475,2031-12-31,2405,3489,5894
05,05475,2032-12-31,2427,3518,5945
05,05475,2033-12-31,2449,3550,5999
05,05475,2034-12-31,2469,3601,6070
05,05475,2035-12-31,2495,3637,6132
05,05480,1985-12-31,1957,7479,9436
05,05480,1986-12-31,2042,7564,9606
05,05480,1987-12-31,2168,7619,9787
05,05480,1988-12-31,2263,7660,9923
05,05480,1989-12-31,2366,7704,10070
05,05480,1990-12-31,2457,7746,10203
05,05480,1991-12-31,2547,7778,10325
05,05480,1992-12-31,2641,7808,10449
05,05480,1993-12-31,2716,7851,10567
05,05480,1994-12-31,2832,7891,10723
05,05480,1995-12-31,2931,7915,10846
05,05480,1996-12-31,3035,7942,10977
05,05480,1997-12-31,3128,8010,11138
05,05480,1998-12-31,3218,8055,11273
05,05480,1999-12-31,3317,8089,11406
05,05480,2000-12-31,3410,8130,11540
05,05480,2001-12-31,3506,8161,11667
05,05480,2002-12-31,3599,8196,11795
05,05480,2003-12-31,3705,8222,11927
05,05480,2004-12-31,3804,8258,12062
05,05480,2005-12-31,3886,8289,12175
05,05480,2006-12-31,3974,8331,12305
05,05480,2007-12-31,4062,8353,12415
05,05480,2008-12-31,4144,8404,12548
05,05480,2009-12-31,4235,8445,12680
05,05480,2010-12-31,4347,8478,12825
05,05480,2011-12-31,4438,8502,12940
05,05480,2012-12-31,4527,8563,13090
05,05480,2013-12-31,4625,8606,13231
05,05480,2014-12-31,4749,8636,13385
05,05480,2015-12-31,4821,8691,13512
05,05480,2016-12-31,4900,8725,13625
05,05480,2017-12-31,4992,8786,13778
05,05480,2018-12-31,5091,8900,13991
05,05480,2019-12-31,5317,8879,14196
05,05480,2020-12-31,5525,8864,14389
05,05480,2021-12-31,5848,8764,14612
05,05480,2022-12-31,6101,8737,14838
05,05480,2023-12-31,6333,8736,15069
05,05480,2024-12-31,6460,8741,15201
05,05480,2025-12-31,6571,8767,15338
05,05480,2026-12-31,6669,8806,15475
05,05480,2027-12-31,6765,8846,15611
05,05480,2028-12-31,6853,8908,15761
05,05480,2029-12-31,6932,8987,15919
05,05480,2030-12-31,7007,9077,16084
05,05480,2031-12-31,7079,9169,16248
05,05480,2032-12-31,7144,9274,16418
05,05480,2033-12-31,7208,9369,16577
05,05480,2034-12-31,7262,9469,16731
05,05480,2035-12-31,7313,9557,16870
05,05483,1985-12-31,2920,14033,16953
05,05483,1986-12-31,2950,13889,16839
05,05483,1987-12-31,2961,13673,16634
05,05483,1988-12-31,2959,13448,16407
05,05483,1989-12-31,2956,13226,16182
05,05483,1990-12-31,2954,12980,15934
05,05483,1991-12-31,2993,12749,15742
05,05483,1992-12-31,2983,12500,15483
05,05483,1993-12-31,2972,12283,15255
05,05483,1994-12-31,2994,12038,15032
05,05483,1995-12-31,2990,11804,14794
05,05483,1996-12-31,3006,11570,14576
05,05483,1997-12-31,3016,11385,14401
05,05483,1998-12-31,3025,11161,14186
05,05483,1999-12-31,3023,10931,13954
05,05483,2000-12-31,3030,10704,13734
05,05483,2001-12-31,3041,10492,13533
05,05483,2002-12-31,3060,10262,13322
05,05483,2003-12-31,3046,10036,13082
05,05483,2004-12-31,3046,9815,12861
05,05483,2005-12-31,3052,9580,12632
05,05483,2006-12-31,3057,9386,12443
05,05483,2007-12-31,3062,9172,12234
05,05483,2008-12-31,3072,8961,12033
05,05483,2009-12-31,3081,8771,11852
05,05483,2010-12-31,3074,8537,11611
05,05483,2011-12-31,3076,8347,11423
05,05483,2012-12-31,3094,8133,11227
05,05483,2013-12-31,3088,7950,11038
05,05483,2014-12-31,3083,7737,10820
05,05483,2015-12-31,3100,7550,10650
05,05483,2016-12-31,3127,7374,10501
05,05483,2017-12-31,3057,7197,10254
05,05483,2018-12-31,3116,7037,10153
05,05483,2019-12-31,3149,6848,9997
05,05483,2020-12-31,3195,6752,9947
05,05483,2021-12-31,3427,6674,10101
05,05483,2022-12-31,3604,6653,10257
05,05483,2023-12-31,3764,6653,10417
05,05483,2024-12-31,3837,6663,10500
05,05483,2025-12-31,3897,6681,10578
05,05483,2026-12-31,3960,6706,10666
05,05483,2027-12-31,4020,6742,10762
05,05483,2028-12-31,4070,6790,10860
05,05483,2029-12-31,4116,6848,10964
05,05483,2030-12-31,4163,6908,11071
05,05483,2031-12-31,4212,6992,11204
05,05483,2032-12-31,4238,7067,11305
05,05483,2033-12-31,4285,7139,11424
05,05483,2034-12-31,4302,7212,11514
05,05483,2035-12-31,4363,7287,11650
05,05490,1985-12-31,4989,22565,27554
05,05490,1986-12-31,5173,22963,28136
05,05490,1987-12-31,5412,23261,28673
05,05490,1988-12-31,5588,23562,29150
05,05490,1989-12-31,5778,23843,29621
05,05490,1990-12-31,5972,24104,30076
05,05490,1991-12-31,6149,24379,30528
05,05490,1992-12-31,6352,24609,30961
05,05490,1993-12-31,6515,24864,31379
05,05490,1994-12-31,6706,25081,31787
05,05490,1995-12-31,6893,25326,32219
05,05490,1996-12-31,7068,25559,32627
05,05490,1997-12-31,7242,25905,33147
05,05490,1998-12-31,7427,26157,33584
05,05490,1999-12-31,7620,26416,34036
05,05490,2000-12-31,7810,26673,34483
05,05490,2001-12-31,7980,26920,34900
05,05490,2002-12-31,8159,27151,35310
05,05490,2003-12-31,8336,27369,35705
05,05490,2004-12-31,8510,27585,36095
05,05490,2005-12-31,8682,27784,36466
05,05490,2006-12-31,8845,27990,36835
05,05490,2007-12-31,9009,28218,37227
05,05490,2008-12-31,9178,28440,37618
05,05490,2009-12-31,9353,28666,38019
05,05490,2010-12-31,9527,28930,38457
05,05490,2011-12-31,9711,29174,38885
05,05490,2012-12-31,9876,29429,39305
05,05490,2013-12-31,9983,29634,39617
05,05490,2014-12-31,10159,29910,40069
05,05490,2015-12-31,10319,30189,40508
05,05490,2016-12-31,10528,30488,41016
05,05490,2017-12-31,10687,30839,41526
05,05490,2018-12-31,10955,31326,42281
05,05490,2019-12-31,11420,31837,43257
05,05490,2020-12-31,11861,32257,44118
05,05490,2021-12-31,12919,31892,44811
05,05490,2022-12-31,13709,31794,45503
05,05490,2023-12-31,14423,31790,46213
05,05490,2024-12-31,14705,31827,46532
05,05490,2025-12-31,14964,31908,46872
05,05490,2026-12-31,15190,32012,47202
05,05490,2027-12-31,15405,32196,47601
05,05490,2028-12-31,15599,32418,48017
05,05490,2029-12-31,15788,32694,48482
05,05490,2030-12-31,15949,33025,48974
05,05490,2031-12-31,16103,33387,49490
05,05490,2032-12-31,16259,33749,50008
05,05490,2033-12-31,16399,34097,50496
05,05490,2034-12-31,16538,34443,50981
05,05490,2035-12-31,16665,34797,51462
05,05495,1985-12-31,4405,6951,11356
05,05495,1986-12-31,4716,7149,11865
05,05495,1987-12-31,5000,7339,12339
05,05495,1988-12-31,5254,7516,12770
05,05495,1989-12-31,5519,7715,13234
05,05495,1990-12-31,5786,7900,13686
05,05495,1991-12-31,6053,8051,14104
05,05495,1992-12-31,6310,8211,14521
05,05495,1993-12-31,6584,8397,14981
05,05495,1994-12-31,6839,8565,15404
05,05495,1995-12-31,7129,8728,15857
05,05495,1996-12-31,7403,8894,16297
05,05495,1997-12-31,7686,9062,16748
05,05495,1998-12-31,7933,9246,17179
05,05495,1999-12-31,8229,9402,17631
05,05495,2000-12-31,8507,9589,18096
05,05495,2001-12-31,8767,9755,18522
05,05495,2002-12-31,9020,9911,18931
05,05495,2003-12-31,9289,10061,19350
05,05495,2004-12-31,9544,10218,19762
05,05495,2005-12-31,9801,10378,20179
05,05495,2006-12-31,10039,10539,20578
05,05495,2007-12-31,10308,10680,20988
05,05495,2008-12-31,10549,10847,21396
05,05495,2009-12-31,10808,11013,21821
05,05495,2010-12-31,11067,11198,22265
05,05495,2011-12-31,11323,11346,22669
05,05495,2012-12-31,11553,11517,23070
05,05495,2013-12-31,11743,11669,23412
05,05495,2014-12-31,12006,11816,23822
05,05495,2015-12-31,12275,11983,24258
05,05495,2016-12-31,12533,12164,24697
05,05495,2017-12-31,12787,12378,25165
05,05495,2018-12-31,13174,12616,25790
05,05495,2019-12-31,13811,12841,26652
05,05495,2020-12-31,14388,12966,27354
05,05495,2021-12-31,14965,12819,27784
05,05495,2022-12-31,15433,12780,28213
05,05495,2023-12-31,15875,12778,28653
05,05495,2024-12-31,16176,12787,28963
05,05495,2025-12-31,16458,12823,29281
05,05495,2026-12-31,16718,12880,29598
05,05495,2027-12-31,16959,12939,29898
05,05495,2028-12-31,17176,13033,30209
05,05495,2029-12-31,17377,13139,30516
05,05495,2030-12-31,17568,13273,30841
05,05495,2031-12-31,17720,13424,31144
05,05495,2032-12-31,17886,13562,31448
05,05495,2033-12-31,18046,13710,31756
05,05495,2034-12-31,18188,13851,32039
05,05495,2035-12-31,18343,13977,32320
05,05501,1985-12-31,183,3092,3275
05,05501,1986-12-31,235,3075,3310
05,05501,1987-12-31,258,3107,3365
05,05501,1988-12-31,212,3082,3294
05,05501,1989-12-31,220,3074,3294
05,05501,1990-12-31,198,3065,3263
05,05501,1991-12-31,213,3033,3246
05,05501,1992-12-31,212,3046,3258
05,05501,1993-12-31,213,3023,3236
05,05501,1994-12-31,213,3015,3228
05,05501,1995-12-31,256,3017,3273
05,05501,1996-12-31,246,3002,3248
05,05501,1997-12-31,234,3002,3236
05,05501,1998-12-31,234,3021,3255
05,05501,1999-12-31,225,3008,3233
05,05501,2000-12-31,225,2966,3191
05,05501,2001-12-31,230,2984,3214
05,05501,2002-12-31,226,2975,3201
05,05501,2003-12-31,255,2964,3219
05,05501,2004-12-31,256,2958,3214
05,05501,2005-12-31,262,2962,3224
05,05501,2006-12-31,246,2924,3170
05,05501,2007-12-31,250,2896,3146
05,05501,2008-12-31,248,2899,3147
05,05501,2009-12-31,240,2892,3132
05,05501,2010-12-31,235,2895,3130
05,05501,2011-12-31,226,2884,3110
05,05501,2012-12-31,217,2880,3097
05,05501,2013-12-31,219,2882,3101
05,05501,2014-12-31,216,2876,3092
05,05501,2015-12-31,214,2879,3093
05,05501,2016-12-31,210,2882,3092
05,05501,2017-12-31,209,2891,3100
05,05501,2018-12-31,217,2910,3127
05,05501,2019-12-31,223,2927,3150
05,05501,2020-12-31,230,2945,3175
05,05501,2021-12-31,312,2912,3224
05,05501,2022-12-31,371,2903,3274
05,05501,2023-12-31,423,2902,3325
05,05501,2024-12-31,427,2896,3323
05,05501,2025-12-31,433,2913,3346
05,05501,2026-12-31,444,2929,3373
05,05501,2027-12-31,454,2946,3400
05,05501,2028-12-31,456,2963,3419
05,05501,2029-12-31,458,2983,3441
05,05501,2030-12-31,465,3017,3482
05,05501,2031-12-31,468,3041,3509
05,05501,2032-12-31,473,3078,3551
05,05501,2033-12-31,475,3116,3591
05,05501,2034-12-31,479,3145,3624
05,05501,2035-12-31,482,3188,3670
05,05541,1985-12-31,4399,10452,14851
05,05541,1986-12-31,4599,10496,15095
05,05541,1987-12-31,4815,10495,15310
05,05541,1988-12-31,5019,10489,15508
05,05541,1989-12-31,5227,10471,15698
05,05541,1990-12-31,5425,10447,15872
05,05541,1991-12-31,5635,10429,16064
05,05541,1992-12-31,5828,10403,16231
05,05541,1993-12-31,6045,10362,16407
05,05541,1994-12-31,6236,10332,16568
05,05541,1995-12-31,6456,10308,16764
05,05541,1996-12-31,6643,10264,16907
05,05541,1997-12-31,6841,10278,17119
05,05541,1998-12-31,7050,10263,17313
05,05541,1999-12-31,7256,10244,17500
05,05541,2000-12-31,7459,10203,17662
05,05541,2001-12-31,7663,10180,17843
05,05541,2002-12-31,7855,10160,18015
05,05541,2003-12-31,8065,10122,18187
05,05541,2004-12-31,8236,10092,18328
05,05541,2005-12-31,8428,10070,18498
05,05541,2006-12-31,8622,10063,18685
05,05541,2007-12-31,8809,10041,18850
05,05541,2008-12-31,9014,10028,19042
05,05541,2009-12-31,9203,10027,19230
05,05541,2010-12-31,9391,9986,19377
05,05541,2011-12-31,9615,9946,19561
05,05541,2012-12-31,9809,9942,19751
05,05541,2013-12-31,9908,9934,19842
05,05541,2014-12-31,10070,9932,20002
05,05541,2015-12-31,10246,9873,20119
05,05541,2016-12-31,10443,9908,20351
05,05541,2017-12-31,10673,10021,20694
05,05541,2018-12-31,11022,10027,21049
05,05541,2019-12-31,11453,9974,21427
05,05541,2020-12-31,11857,9912,21769
05,05541,2021-12-31,12307,9800,22107
05,05541,2022-12-31,12678,9770,22448
05,05541,2023-12-31,13029,9769,22798
05,05541,2024-12-31,13287,9769,23056
05,05541,2025-12-31,13502,9806,23308
05,05541,2026-12-31,13717,9842,23559
05,05541,2027-12-31,13922,9895,23817
05,05541,2028-12-31,14099,9962,24061
05,05541,2029-12-31,14258,10043,24301
05,05541,2030-12-31,14416,10152,24568
05,05541,2031-12-31,14555,10278,24833
05,05541,2032-12-31,14678,10372,25050
05,05541,2033-12-31,14806,10479,25285
05,05541,2034-12-31,14939,10586,25525
05,05541,2035-12-31,15066,10705,25771
05,05543,1985-12-31,787,6776,7563
05,05543,1986-12-31,839,6754,7593
05,05543,1987-12-31,872,6732,7604
05,05543,1988-12-31,929,6709,7638
05,05543,1989-12-31,971,6682,7653
05,05543,1990-12-31,1028,6641,7669
05,05543,1991-12-31,1066,6606,7672
05,05543,1992-12-31,1092,6561,7653
05,05543,1993-12-31,1169,6519,7688
05,05543,1994-12-31,1217,6487,7704
05,05543,1995-12-31,1264,6435,7699
05,05543,1996-12-31,1262,6399,7661
05,05543,1997-12-31,1322,6386,7708
05,05543,1998-12-31,1393,6357,7750
05,05543,1999-12-31,1436,6318,7754
05,05543,2000-12-31,1467,6295,7762
05,05543,2001-12-31,1513,6259,7772
05,05543,2002-12-31,1549,6219,7768
05,05543,2003-12-31,1625,6199,7824
05,05543,2004-12-31,1654,6159,7813
05,05543,2005-12-31,1708,6114,7822
05,05543,2006-12-31,1750,6081,7831
05,05543,2007-12-31,1784,6067,7851
05,05543,2008-12-31,1831,6010,7841
05,05543,2009-12-31,1868,5973,7841
05,05543,2010-12-31,1900,5933,7833
05,05543,2011-12-31,1961,5943,7904
05,05543,2012-12-31,2007,5934,7941
05,05543,2013-12-31,2063,5877,7940
05,05543,2014-12-31,2107,5830,7937
05,05543,2015-12-31,2150,5826,7976
05,05543,2016-12-31,2186,5805,7991
05,05543,2017-12-31,2240,5783,8023
05,05543,2018-12-31,2296,5801,8097
05,05543,2019-12-31,2402,5784,8186
05,05543,2020-12-31,2498,5787,8285
05,05543,2021-12-31,2692,5722,8414
05,05543,2022-12-31,2839,5704,8543
05,05543,2023-12-31,2974,5703,8677
05,05543,2024-12-31,3032,5715,8747
05,05543,2025-12-31,3074,5717,8791
05,05543,2026-12-31,3130,5750,8880
05,05543,2027-12-31,3177,5777,8954
05,05543,2028-12-31,3208,5819,9027
05,05543,2029-12-31,3253,5861,9114
05,05543,2030-12-31,3291,5922,9213
05,05543,2031-12-31,3317,5984,9301
05,05543,2032-12-31,3351,6041,9392
05,05543,2033-12-31,3378,6109,9487
05,05543,2034-12-31,3403,6181,9584
05,05543,2035-12-31,3431,6243,9674
05,05576,1985-12-31,3548,6144,9692
05,05576,1986-12-31,3614,6118,9732
05,05576,1987-12-31,3594,6073,9667
05,05576,1988-12-31,3630,6017,9647
05,05576,1989-12-31,3659,5937,9596
05,05576,1990-12-31,3693,5871,9564
05,05576,1991-12-31,3734,5809,9543
05,05576,1992-12-31,3753,5729,9482
05,05576,1993-12-31,3769,5655,9424
05,05576,1994-12-31,3801,5581,9382
05,05576,1995-12-31,3834,5501,9335
05,05576,1996-12-31,3871,5444,9315
05,05576,1997-12-31,3893,5371,9264
05,05576,1998-12-31,3916,5305,9221
05,05576,1999-12-31,3947,5269,9216
05,05576,2000-12-31,3974,5214,9188
05,05576,2001-12-31,4007,5155,9162
05,05576,2002-12-31,4037,5090,9127
05,05576,2003-12-31,4056,5021,9077
05,05576,2004-12-31,4091,4930,9021
05,05576,2005-12-31,4112,4857,8969
05,05576,2006-12-31,4126,4829,8955
05,05576,2007-12-31,4150,4767,8917
05,05576,2008-12-31,4183,4703,8886
05,05576,2009-12-31,4204,4640,8844
05,05576,2010-12-31,4213,4591,8804
05,05576,2011-12-31,4239,4557,8796
05,05576,2012-12-31,4272,4477,8749
05,05576,2013-12-31,4305,4418,8723
05,05576,2014-12-31,4332,4392,8724
05,05576,2015-12-31,4379,4362,8741
05,05576,2016-12-31,4419,4320,8739
05,05576,2017-12-31,4382,4236,8618
05,05576,2018-12-31,4450,4214,8664
05,05576,2019-12-31,4550,4131,8681
05,05576,2020-12-31,4664,4071,8735
05,05576,2021-12-31,4846,4024,8870
05,05576,2022-12-31,4995,4012,9007
05,05576,2023-12-31,5137,4011,9148
05,05576,2024-12-31,5244,4012,9256
05,05576,2025-12-31,5327,4020,9347
05,05576,2026-12-31,5410,4041,9451
05,05576,2027-12-31,5492,4055,9547
05,05576,2028-12-31,5565,4092,9657
05,05576,2029-12-31,5615,4131,9746
05,05576,2030-12-31,5682,4167,9849
05,05576,2031-12-31,5748,4211,9959
05,05576,2032-12-31,5789,4253,10042
05,05576,2033-12-31,5841,4310,10151
05,05576,2034-12-31,5898,4348,10246
05,05576,2035-12-31,5941,4385,10326
05,05579,1985-12-31,20458,7104,27562
05,05579,1986-12-31,20769,7100,27869
05,05579,1987-12-31,21239,7118,28357
05,05579,1988-12-31,21597,7104,28701
05,05579,1989-12-31,22040,7085,29125
05,05579,1990-12-31,22420,7076,29496
05,05579,1991-12-31,22822,7069,29891
05,05579,1992-12-31,23205,7026,30231
05,05579,1993-12-31,23587,7004,30591
05,05579,1994-12-31,23949,6981,30930
05,05579,1995-12-31,24347,6959,31306
05,05579,1996-12-31,24722,6913,31635
05,05579,1997-12-31,25080,6925,32005
05,05579,1998-12-31,25473,6916,32389
05,05579,1999-12-31,25868,6898,32766
05,05579,2000-12-31,26243,6890,33133
05,05579,2001-12-31,26606,6858,33464
05,05579,2002-12-31,26955,6833,33788
05,05579,2003-12-31,27285,6821,34106
05,05579,2004-12-31,27625,6794,34419
05,05579,2005-12-31,27955,6773,34728
05,05579,2006-12-31,28293,6756,35049
05,05579,2007-12-31,28625,6733,35358
05,05579,2008-12-31,28938,6736,35674
05,05579,2009-12-31,29290,6712,36002
05,05579,2010-12-31,29604,6682,36286
05,05579,2011-12-31,29942,6678,36620
05,05579,2012-12-31,30292,6685,36977
05,05579,2013-12-31,30627,6682,37309
05,05579,2014-12-31,30912,6676,37588
05,05579,2015-12-31,31252,6665,37917
05,05579,2016-12-31,31625,6677,38302
05,05579,2017-12-31,32043,6678,38721
05,05579,2018-12-31,32623,6691,39314
05,05579,2019-12-31,33869,6179,40048
05,05579,2020-12-31,35038,5675,40713
05,05579,2021-12-31,35735,5610,41345
05,05579,2022-12-31,36391,5592,41983
05,05579,2023-12-31,37046,5592,42638
05,05579,2024-12-31,37713,5598,43311
05,05579,2025-12-31,38351,5615,43966
05,05579,2026-12-31,38947,5631,44578
05,05579,2027-12-31,39501,5674,45175
05,05579,2028-12-31,40013,5711,45724
05,05579,2029-12-31,40507,5761,46268
05,05579,2030-12-31,40930,5813,46743
05,05579,2031-12-31,41300,5882,47182
05,05579,2032-12-31,41697,5933,47630
05,05579,2033-12-31,42069,6004,48073
05,05579,2034-12-31,42419,6064,48483
05,05579,2035-12-31,42769,6123,48892
05,05585,1985-12-31,3653,13136,16789
05,05585,1986-12-31,3678,13101,16779
05,05585,1987-12-31,3703,12982,16685
05,05585,1988-12-31,3743,12893,16636
05,05585,1989-12-31,3751,12807,16558
05,05585,1990-12-31,3776,12690,16466
05,05585,1991-12-31,3794,12585,16379
05,05585,1992-12-31,3820,12463,16283
05,05585,1993-12-31,3829,12346,16175
05,05585,1994-12-31,3862,12219,16081
05,05585,1995-12-31,3880,12114,15994
05,05585,1996-12-31,3916,12000,15916
05,05585,1997-12-31,3941,11915,15856
05,05585,1998-12-31,3967,11816,15783
05,05585,1999-12-31,3977,11733,15710
05,05585,2000-12-31,4008,11626,15634
05,05585,2001-12-31,4036,11538,15574
05,05585,2002-12-31,4052,11406,15458
05,05585,2003-12-31,4071,11282,15353
05,05585,2004-12-31,4081,11174,15255
05,05585,2005-12-31,4104,11067,15171
05,05585,2006-12-31,4128,10967,15095
05,05585,2007-12-31,4152,10863,15015
05,05585,2008-12-31,4158,10729,14887
05,05585,2009-12-31,4183,10681,14864
05,05585,2010-12-31,4210,10570,14780
05,05585,2011-12-31,4221,10475,14696
05,05585,2012-12-31,4251,10389,14640
05,05585,2013-12-31,4293,10312,14605
05,05585,2014-12-31,4278,10223,14501
05,05585,2015-12-31,4362,10112,14474
05,05585,2016-12-31,4352,10018,14370
05,05585,2017-12-31,4351,10038,14389
05,05585,2018-12-31,4381,9999,14380
05,05585,2019-12-31,4550,9834,14384
05,05585,2020-12-31,4708,9732,14440
05,05585,2021-12-31,5049,9615,14664
05,05585,2022-12-31,5314,9576,14890
05,05585,2023-12-31,5557,9566,15123
05,05585,2024-12-31,5670,9572,15242
05,05585,2025-12-31,5758,9588,15346
05,05585,2026-12-31,5857,9618,15475
05,05585,2027-12-31,5935,9675,15610
05,05585,2028-12-31,6010,9742,15752
05,05585,2029-12-31,6076,9826,15902
05,05585,2030-12-31,6149,9930,16079
05,05585,2031-12-31,6207,10037,16244
05,05585,2032-12-31,6268,10153,16421
05,05585,2033-12-31,6321,10256,16577
05,05585,2034-12-31,6367,10366,16733
05,05585,2035-12-31,6432,10473,16905
05,05591,1985-12-31,1513,6533,8046
05,05591,1986-12-31,1575,6827,8402
05,05591,1987-12-31,1602,7109,8711
05,05591,1988-12-31,1658,7391,9049
05,05591,1989-12-31,1695,7662,9357
05,05591,1990-12-31,1743,7935,9678
05,05591,1991-12-31,1788,8212,10000
05,05591,1992-12-31,1805,8472,10277
05,05591,1993-12-31,1857,8729,10586
05,05591,1994-12-31,1906,8987,10893
05,05591,1995-12-31,1957,9232,11189
05,05591,1996-12-31,1998,9487,11485
05,05591,1997-12-31,2021,9770,11791
05,05591,1998-12-31,2074,10040,12114
05,05591,1999-12-31,2122,10280,12402
05,05591,2000-12-31,2178,10538,12716
05,05591,2001-12-31,2220,10787,13007
05,05591,2002-12-31,2270,11032,13302
05,05591,2003-12-31,2309,11273,13582
05,05591,2004-12-31,2346,11508,13854
05,05591,2005-12-31,2382,11754,14136
05,05591,2006-12-31,2432,12007,14439
05,05591,2007-12-31,2463,12244,14707
05,05591,2008-12-31,2506,12492,14998
05,05591,2009-12-31,2542,12730,15272
05,05591,2010-12-31,2587,12986,15573
05,05591,2011-12-31,2626,13247,15873
05,05591,2012-12-31,2671,13463,16134
05,05591,2013-12-31,2722,13695,16417
05,05591,2014-12-31,2762,13922,16684
05,05591,2015-12-31,2814,14191,17005
05,05591,2016-12-31,2835,14459,17294
05,05591,2017-12-31,2912,14757,17669
05,05591,2018-12-31,2926,15129,18055
05,05591,2019-12-31,3039,15511,18550
05,05591,2020-12-31,3146,15824,18970
05,05591,2021-12-31,3623,15645,19268
05,05591,2022-12-31,3969,15597,19566
05,05591,2023-12-31,4276,15595,19871
05,05591,2024-12-31,4357,15613,19970
05,05591,2025-12-31,4426,15651,20077
05,05591,2026-12-31,4499,15713,20212
05,05591,2027-12-31,4564,15802,20366
05,05591,2028-12-31,4621,15909,20530
05,05591,2029-12-31,4683,16055,20738
05,05591,2030-12-31,4735,16209,20944
05,05591,2031-12-31,4775,16387,21162
05,05591,2032-12-31,4815,16568,21383
05,05591,2033-12-31,4867,16744,21611
05,05591,2034-12-31,4902,16925,21827
05,05591,2035-12-31,4947,17092,22039
05,05604,1985-12-31,3959,15479,19438
05,05604,1986-12-31,4200,15568,19768
05,05604,1987-12-31,4414,15653,20067
05,05604,1988-12-31,4646,15696,20342
05,05604,1989-12-31,4904,15738,20642
05,05604,1990-12-31,5131,15769,20900
05,05604,1991-12-31,5338,15792,21130
05,05604,1992-12-31,5575,15821,21396
05,05604,1993-12-31,5828,15834,21662
05,05604,1994-12-31,6082,15844,21926
05,05604,1995-12-31,6321,15870,22191
05,05604,1996-12-31,6566,15883,22449
05,05604,1997-12-31,6796,15966,22762
05,05604,1998-12-31,7037,15989,23026
05,05604,1999-12-31,7272,16037,23309
05,05604,2000-12-31,7524,16067,23591
05,05604,2001-12-31,7750,16063,23813
05,05604,2002-12-31,7968,16098,24066
05,05604,2003-12-31,8203,16102,24305
05,05604,2004-12-31,8433,16122,24555
05,05604,2005-12-31,8650,16135,24785
05,05604,2006-12-31,8870,16163,25033
05,05604,2007-12-31,9095,16184,25279
05,05604,2008-12-31,9311,16202,25513
05,05604,2009-12-31,9550,16234,25784
05,05604,2010-12-31,9771,16274,26045
05,05604,2011-12-31,10001,16324,26325
05,05604,2012-12-31,10210,16339,26549
05,05604,2013-12-31,10342,16342,26684
05,05604,2014-12-31,10557,16361,26918
05,05604,2015-12-31,10784,16430,27214
05,05604,2016-12-31,11019,16511,27530
05,05604,2017-12-31,11268,16601,27869
05,05604,2018-12-31,11632,16783,28415
05,05604,2019-12-31,12173,16888,29061
05,05604,2020-12-31,12663,16966,29629
05,05604,2021-12-31,13320,16774,30094
05,05604,2022-12-31,13836,16723,30559
05,05604,2023-12-31,14315,16721,31036
05,05604,2024-12-31,14595,16751,31346
05,05604,2025-12-31,14845,16785,31630
05,05604,2026-12-31,15068,16848,31916
05,05604,2027-12-31,15285,16938,32223
05,05604,2028-12-31,15490,17049,32539
05,05604,2029-12-31,15677,17209,32886
05,05604,2030-12-31,15825,17379,33204
05,05604,2031-12-31,15976,17559,33535
05,05604,2032-12-31,16130,17751,33881
05,05604,2033-12-31,16275,17932,34207
05,05604,2034-12-31,16407,18119,34526
05,05604,2035-12-31,16537,18307,34844
05,05607,1985-12-31,4474,7222,11696
05,05607,1986-12-31,4716,7385,12101
05,05607,1987-12-31,4957,7501,12458
05,05607,1988-12-31,5195,7631,12826
05,05607,1989-12-31,5457,7752,13209
05,05607,1990-12-31,5685,7872,13557
05,05607,1991-12-31,5934,7967,13901
05,05607,1992-12-31,6175,8102,14277
05,05607,1993-12-31,6429,8204,14633
05,05607,1994-12-31,6669,8315,14984
05,05607,1995-12-31,6929,8404,15333
05,05607,1996-12-31,7173,8518,15691
05,05607,1997-12-31,7420,8651,16071
05,05607,1998-12-31,7682,8761,16443
05,05607,1999-12-31,7939,8870,16809
05,05607,2000-12-31,8188,8972,17160
05,05607,2001-12-31,8425,9078,17503
05,05607,2002-12-31,8658,9181,17839
05,05607,2003-12-31,8878,9282,18160
05,05607,2004-12-31,9109,9394,18503
05,05607,2005-12-31,9327,9474,18801
05,05607,2006-12-31,9571,9589,19160
05,05607,2007-12-31,9805,9709,19514
05,05607,2008-12-31,10031,9826,19857
05,05607,2009-12-31,10267,9931,20198
05,05607,2010-12-31,10508,10029,20537
05,05607,2011-12-31,10750,10120,20870
05,05607,2012-12-31,10951,10217,21168
05,05607,2013-12-31,11141,10319,21460
05,05607,2014-12-31,11378,10455,21833
05,05607,2015-12-31,11617,10561,22178
05,05607,2016-12-31,11877,10609,22486
05,05607,2017-12-31,12145,10872,23017
05,05607,2018-12-31,12479,11035,23514
05,05607,2019-12-31,13051,11134,24185
05,05607,2020-12-31,13568,11189,24757
05,05607,2021-12-31,14084,11062,25146
05,05607,2022-12-31,14506,11028,25534
05,05607,2023-12-31,14906,11027,25933
05,05607,2024-12-31,15193,11038,26231
05,05607,2025-12-31,15455,11068,26523
05,05607,2026-12-31,15698,11103,26801
05,05607,2027-12-31,15920,11167,27087
05,05607,2028-12-31,16125,11248,27373
05,05607,2029-12-31,16318,11338,27656
05,05607,2030-12-31,16487,11450,27937
05,05607,2031-12-31,16654,11581,28235
05,05607,2032-12-31,16800,11707,28507
05,05607,2033-12-31,16953,11823,28776
05,05607,2034-12-31,17097,11941,29038
05,05607,2035-12-31,17238,12079,29317
05,05615,1985-12-31,19775,40738,60513
05,05615,1986-12-31,21662,41310,62972
05,05615,1987-12-31,23596,41720,65316
05,05615,1988-12-31,25536,42111,67647
05,05615,1989-12-31,27492,42483,69975
05,05615,1990-12-31,29480,42821,72301
05,05615,1991-12-31,31398,43143,74541
05,05615,1992-12-31,33328,43439,76767
05,05615,1993-12-31,35273,43760,79033
05,05615,1994-12-31,37188,44028,81216
05,05615,1995-12-31,39155,44336,83491
05,05615,1996-12-31,41113,44642,85755
05,05615,1997-12-31,43012,45108,88120
05,05615,1998-12-31,44961,45456,90417
05,05615,1999-12-31,46898,45806,92704
05,05615,2000-12-31,48832,46126,94958
05,05615,2001-12-31,50733,46428,97161
05,05615,2002-12-31,52620,46704,99324
05,05615,2003-12-31,54493,46964,101457
05,05615,2004-12-31,56345,47263,103608
05,05615,2005-12-31,58206,47478,105684
05,05615,2006-12-31,60074,47781,107855
05,05615,2007-12-31,61932,48095,110027
05,05615,2008-12-31,63787,48406,112193
05,05615,2009-12-31,65626,48735,114361
05,05615,2010-12-31,67508,49066,116574
05,05615,2011-12-31,69368,49413,118781
05,05615,2012-12-31,71184,49752,120936
05,05615,2013-12-31,72995,50022,123017
05,05615,2014-12-31,74824,50371,125195
05,05615,2015-12-31,76659,50732,127391
05,05615,2016-12-31,78583,51170,129753
05,05615,2017-12-31,80606,51695,132301
05,05615,2018-12-31,83007,52458,135465
05,05615,2019-12-31,86786,52767,139553
05,05615,2020-12-31,90256,52739,142995
05,05615,2021-12-31,93099,52143,145242
05,05615,2022-12-31,95502,51982,147484
05,05615,2023-12-31,97810,51976,149786
05,05615,2024-12-31,99698,52032,151730
05,05615,2025-12-31,101401,52160,153561
05,05615,2026-12-31,102991,52371,155362
05,05615,2027-12-31,104475,52641,157116
05,05615,2028-12-31,105836,53012,158848
05,05615,2029-12-31,107073,53467,160540
05,05615,2030-12-31,108209,54013,162222
05,05615,2031-12-31,109243,54599,163842
05,05615,2032-12-31,110259,55200,165459
05,05615,2033-12-31,111242,55794,167036
05,05615,2034-12-31,112187,56360,168547
05,05615,2035-12-31,113111,56937,170048
05,05628,1985-12-31,1497,6344,7841
05,05628,1986-12-31,1543,6363,7906
05,05628,1987-12-31,1572,6361,7933
05,05628,1988-12-31,1627,6352,7979
05,05628,1989-12-31,1669,6345,8014
05,05628,1990-12-31,1729,6334,8063
05,05628,1991-12-31,1773,6319,8092
05,05628,1992-12-31,1821,6289,8110
05,05628,1993-12-31,1857,6274,8131
05,05628,1994-12-31,1907,6251,8158
05,05628,1995-12-31,1952,6247,8199
05,05628,1996-12-31,1995,6213,8208
05,05628,1997-12-31,2032,6222,8254
05,05628,1998-12-31,2058,6204,8262
05,05628,1999-12-31,2103,6211,8314
05,05628,2000-12-31,2180,6197,8377
05,05628,2001-12-31,2237,6183,8420
05,05628,2002-12-31,2296,6179,8475
05,05628,2003-12-31,2328,6147,8475
05,05628,2004-12-31,2368,6143,8511
05,05628,2005-12-31,2406,6135,8541
05,05628,2006-12-31,2451,6114,8565
05,05628,2007-12-31,2503,6094,8597
05,05628,2008-12-31,2542,6096,8638
05,05628,2009-12-31,2580,6099,8679
05,05628,2010-12-31,2624,6064,8688
05,05628,2011-12-31,2660,6077,8737
05,05628,2012-12-31,2700,6048,8748
05,05628,2013-12-31,2727,6038,8765
05,05628,2014-12-31,2773,6028,8801
05,05628,2015-12-31,2810,6027,8837
05,05628,2016-12-31,2847,6034,8881
05,05628,2017-12-31,2900,6041,8941
05,05628,2018-12-31,2955,6077,9032
05,05628,2019-12-31,3071,6084,9155
05,05628,2020-12-31,3179,6099,9278
05,05628,2021-12-31,3392,6030,9422
05,05628,2022-12-31,3556,6011,9567
05,05628,2023-12-31,3706,6011,9717
05,05628,2024-12-31,3772,6017,9789
05,05628,2025-12-31,3841,6042,9883
05,05628,2026-12-31,3903,6051,9954
05,05628,2027-12-31,3956,6098,10054
05,05628,2028-12-31,4006,6135,10141
05,05628,2029-12-31,4056,6180,10236
05,05628,2030-12-31,4095,6251,10346
05,05628,2031-12-31,4145,6312,10457
05,05628,2032-12-31,4182,6379,10561
05,05628,2033-12-31,4215,6451,10666
05,05628,2034-12-31,4256,6521,10777
05,05628,2035-12-31,4293,6594,10887
05,05631,1985-12-31,15125,5600,20725
05,05631,1986-12-31,16738,5827,22565
05,05631,1987-12-31,18417,6024,24441
05,05631,1988-12-31,20113,6241,26354
05,05631,1989-12-31,21828,6439,28267
05,05631,1990-12-31,23520,6646,30166
05,05631,1991-12-31,25221,6846,32067
05,05631,1992-12-31,26924,7038,33962
05,05631,1993-12-31,28622,7237,35859
05,05631,1994-12-31,30302,7413,37715
05,05631,1995-12-31,32013,7604,39617
05,05631,1996-12-31,33727,7790,41517
05,05631,1997-12-31,35367,8004,43371
05,05631,1998-12-31,37084,8193,45277
05,05631,1999-12-31,38783,8382,47165
05,05631,2000-12-31,40455,8560,49015
05,05631,2001-12-31,42100,8750,50850
05,05631,2002-12-31,43762,8937,52699
05,05631,2003-12-31,45410,9092,54502
05,05631,2004-12-31,47028,9284,56312
05,05631,2005-12-31,48652,9465,58117
05,05631,2006-12-31,50285,9646,59931
05,05631,2007-12-31,51909,9821,61730
05,05631,2008-12-31,53546,10017,63563
05,05631,2009-12-31,55157,10213,65370
05,05631,2010-12-31,56806,10391,67197
05,05631,2011-12-31,58437,10552,68989
05,05631,2012-12-31,60064,10719,70783
05,05631,2013-12-31,61643,10910,72553
05,05631,2014-12-31,63241,11073,74314
05,05631,2015-12-31,64851,11238,76089
05,05631,2016-12-31,66527,11439,77966
05,05631,2017-12-31,68339,11644,79983
05,05631,2018-12-31,70401,11974,82375
05,05631,2019-12-31,74142,11342,85484
05,05631,2020-12-31,77424,10557,87981
05,05631,2021-12-31,78928,10436,89364
05,05631,2022-12-31,80340,10403,90743
05,05631,2023-12-31,81757,10402,92159
05,05631,2024-12-31,83215,10414,93629
05,05631,2025-12-31,84639,10449,95088
05,05631,2026-12-31,85954,10485,96439
05,05631,2027-12-31,87193,10541,97734
05,05631,2028-12-31,88325,10611,98936
05,05631,2029-12-31,89372,10701,100073
05,05631,2030-12-31,90309,10816,101125
05,05631,2031-12-31,91172,10936,102108
05,05631,2032-12-31,92017,11048,103065
05,05631,2033-12-31,92840,11168,104008
05,05631,2034-12-31,93633,11284,104917
05,05631,2035-12-31,94400,11396,105796
05,05642,1985-12-31,5798,16982,22780
05,05642,1986-12-31,5835,16886,22721
05,05642,1987-12-31,5902,16708,22610
05,05642,1988-12-31,5933,16546,22479
05,05642,1989-12-31,5976,16368,22344
05,05642,1990-12-31,5962,16181,22143
05,05642,1991-12-31,6016,15995,22011
05,05642,1992-12-31,6032,15799,21831
05,05642,1993-12-31,6108,15613,21721
05,05642,1994-12-31,6109,15412,21521
05,05642,1995-12-31,6160,15228,21388
05,05642,1996-12-31,6176,15035,21211
05,05642,1997-12-31,6193,14890,21083
05,05642,1998-12-31,6226,14728,20954
05,05642,1999-12-31,6274,14560,20834
05,05642,2000-12-31,6297,14378,20675
05,05642,2001-12-31,6319,14199,20518
05,05642,2002-12-31,6345,14010,20355
05,05642,2003-12-31,6367,13838,20205
05,05642,2004-12-31,6387,13656,20043
05,05642,2005-12-31,6414,13470,19884
05,05642,2006-12-31,6425,13301,19726
05,05642,2007-12-31,6447,13122,19569
05,05642,2008-12-31,6472,12948,19420
05,05642,2009-12-31,6499,12791,19290
05,05642,2010-12-31,6512,12645,19157
05,05642,2011-12-31,6567,12471,19038
05,05642,2012-12-31,6534,12288,18822
05,05642,2013-12-31,6564,12142,18706
05,05642,2014-12-31,6633,11960,18593
05,05642,2015-12-31,6631,11796,18427
05,05642,2016-12-31,6674,11667,18341
05,05642,2017-12-31,6666,11575,18241
05,05642,2018-12-31,6718,11540,18258
05,05642,2019-12-31,6872,11346,18218
05,05642,2020-12-31,7044,11217,18261
05,05642,2021-12-31,7475,11069,18544
05,05642,2022-12-31,7805,11026,18831
05,05642,2023-12-31,8101,11023,19124
05,05642,2024-12-31,8254,11046,19300
05,05642,2025-12-31,8394,11073,19467
05,05642,2026-12-31,8528,11112,19640
05,05642,2027-12-31,8654,11171,19825
05,05642,2028-12-31,8766,11253,20019
05,05642,2029-12-31,8866,11340,20206
05,05642,2030-12-31,8959,11460,20419
05,05642,2031-12-31,9044,11586,20630
05,05642,2032-12-31,9131,11714,20845
05,05642,2033-12-31,9204,11835,21039
05,05642,2034-12-31,9291,11960,21251
05,05642,2035-12-31,9367,12083,21450
05,05647,1985-12-31,1584,7127,8711
05,05647,1986-12-31,1625,7069,8694
05,05647,1987-12-31,1698,6989,8687
05,05647,1988-12-31,1719,6901,8620
05,05647,1989-12-31,1758,6811,8569
05,05647,1990-12-31,1806,6717,8523
05,05647,1991-12-31,1830,6623,8453
05,05647,1992-12-31,1873,6536,8409
05,05647,1993-12-31,1895,6431,8326
05,05647,1994-12-31,1954,6335,8289
05,05647,1995-12-31,1985,6240,8225
05,05647,1996-12-31,2025,6159,8184
05,05647,1997-12-31,2039,6075,8114
05,05647,1998-12-31,2073,5978,8051
05,05647,1999-12-31,2110,5902,8012
05,05647,2000-12-31,2152,5812,7964
05,05647,2001-12-31,2190,5723,7913
05,05647,2002-12-31,2238,5628,7866
05,05647,2003-12-31,2273,5558,7831
05,05647,2004-12-31,2320,5443,7763
05,05647,2005-12-31,2341,5358,7699
05,05647,2006-12-31,2377,5293,7670
05,05647,2007-12-31,2415,5214,7629
05,05647,2008-12-31,2451,5146,7597
05,05647,2009-12-31,2486,5019,7505
05,05647,2010-12-31,2514,4949,7463
05,05647,2011-12-31,2545,4879,7424
05,05647,2012-12-31,2590,4795,7385
05,05647,2013-12-31,2620,4720,7340
05,05647,2014-12-31,2657,4662,7319
05,05647,2015-12-31,2698,4582,7280
05,05647,2016-12-31,2735,4535,7270
05,05647,2017-12-31,2789,4454,7243
05,05647,2018-12-31,2848,4387,7235
05,05647,2019-12-31,2939,4301,7240
05,05647,2020-12-31,3029,4252,7281
05,05647,2021-12-31,3201,4193,7394
05,05647,2022-12-31,3329,4179,7508
05,05647,2023-12-31,3447,4178,7625
05,05647,2024-12-31,3521,4194,7715
05,05647,2025-12-31,3570,4196,7766
05,05647,2026-12-31,3624,4214,7838
05,05647,2027-12-31,3680,4233,7913
05,05647,2028-12-31,3727,4268,7995
05,05647,2029-12-31,3766,4306,8072
05,05647,2030-12-31,3811,4353,8164
05,05647,2031-12-31,3844,4392,8236
05,05647,2032-12-31,3890,4438,8328
05,05647,2033-12-31,3923,4482,8405
05,05647,2034-12-31,3947,4539,8486
05,05647,2035-12-31,3985,4577,8562
05,05649,1985-12-31,8742,18588,27330
05,05649,1986-12-31,8706,18375,27081
05,05649,1987-12-31,8672,18082,26754
05,05649,1988-12-31,8677,17781,26458
05,05649,1989-12-31,8663,17467,26130
05,05649,1990-12-31,8625,17141,25766
05,05649,1991-12-31,8592,16814,25406
05,05649,1992-12-31,8557,16483,25040
05,05649,1993-12-31,8512,16168,24680
05,05649,1994-12-31,8473,15799,24272
05,05649,1995-12-31,8431,15499,23930
05,05649,1996-12-31,8395,15171,23566
05,05649,1997-12-31,8341,14915,23256
05,05649,1998-12-31,8295,14607,22902
05,05649,1999-12-31,8266,14290,22556
05,05649,2000-12-31,8231,14001,22232
05,05649,2001-12-31,8179,13683,21862
05,05649,2002-12-31,8127,13369,21496
05,05649,2003-12-31,8076,13054,21130
05,05649,2004-12-31,8018,12734,20752
05,05649,2005-12-31,7967,12436,20403
05,05649,2006-12-31,7912,12138,20050
05,05649,2007-12-31,7869,11837,19706
05,05649,2008-12-31,7807,11538,19345
05,05649,2009-12-31,7753,11255,19008
05,05649,2010-12-31,7713,11001,18714
05,05649,2011-12-31,7669,10688,18357
05,05649,2012-12-31,7626,10405,18031
05,05649,2013-12-31,7584,10130,17714
05,05649,2014-12-31,7521,9873,17394
05,05649,2015-12-31,7442,9574,17016
05,05649,2016-12-31,7414,9325,16739
05,05649,2017-12-31,7398,9098,16496
05,05649,2018-12-31,7362,8885,16247
05,05649,2019-12-31,7287,8653,15940
05,05649,2020-12-31,7274,8537,15811
05,05649,2021-12-31,7623,8433,16056
05,05649,2022-12-31,7897,8407,16304
05,05649,2023-12-31,8153,8406,16559
05,05649,2024-12-31,8308,8419,16727
05,05649,2025-12-31,8451,8436,16887
05,05649,2026-12-31,8591,8465,17056
05,05649,2027-12-31,8713,8506,17219
05,05649,2028-12-31,8815,8573,17388
05,05649,2029-12-31,8932,8650,17582
05,05649,2030-12-31,9013,8728,17741
05,05649,2031-12-31,9109,8829,17938
05,05649,2032-12-31,9192,8918,18110
05,05649,2033-12-31,9271,9005,18276
05,05649,2034-12-31,9351,9103,18454
05,05649,2035-12-31,9429,9211,18640
05,05652,1985-12-31,0,0,0
05,05652,1986-12-31,1987,4654,6641
05,05652,1987-12-31,2031,4600,6631
05,05652,1988-12-31,2021,4571,6592
05,05652,1989-12-31,2044,4504,6548
05,05652,1990-12-31,2051,4449,6500
05,05652,1991-12-31,2070,4379,6449
05,05652,1992-12-31,2085,4346,6431
05,05652,1993-12-31,2085,4291,6376
05,05652,1994-12-31,2094,4231,6325
05,05652,1995-12-31,2124,4183,6307
05,05652,1996-12-31,2139,4130,6269
05,05652,1997-12-31,2153,4100,6253
05,05652,1998-12-31,2158,4059,6217
05,05652,1999-12-31,2184,3995,6179
05,05652,2000-12-31,2217,3962,6179
05,05652,2001-12-31,2223,3907,6130
05,05652,2002-12-31,2247,3849,6096
05,05652,2003-12-31,2247,3780,6027
05,05652,2004-12-31,2279,3740,6019
05,05652,2005-12-31,2287,3703,5990
05,05652,2006-12-31,2308,3654,5962
05,05652,2007-12-31,2324,3615,5939
05,05652,2008-12-31,2334,3546,5880
05,05652,2009-12-31,2357,3511,5868
05,05652,2010-12-31,2371,3459,5830
05,05652,2011-12-31,2383,3440,5823
05,05652,2012-12-31,2388,3387,5775
05,05652,2013-12-31,2394,3321,5715
05,05652,2014-12-31,2404,3294,5698
05,05652,2015-12-31,2417,3255,5672
05,05652,2016-12-31,2432,3217,5649
05,05652,2017-12-31,2433,3169,5602
05,05652,2018-12-31,2486,3162,5648
05,05652,2019-12-31,2582,3194,5776
05,05652,2020-12-31,2673,3216,5889
05,05652,2021-12-31,2801,3180,5981
05,05652,2022-12-31,2904,3170,6074
05,05652,2023-12-31,3000,3169,6169
05,05652,2024-12-31,3054,3164,6218
05,05652,2025-12-31,3116,3176,6292
05,05652,2026-12-31,3167,3193,6360
05,05652,2027-12-31,3201,3209,6410
05,05652,2028-12-31,3247,3233,6480
05,05652,2029-12-31,3287,3258,6545
05,05652,2030-12-31,3316,3296,6612
05,05652,2031-12-31,3338,3327,6665
05,05652,2032-12-31,3383,3367,6750
05,05652,2033-12-31,3406,3390,6796
05,05652,2034-12-31,3433,3430,6863
05,05652,2035-12-31,3468,3476,6944
05,05656,1985-12-31,1989,8802,10791
05,05656,1986-12-31,2135,8842,10977
05,05656,1987-12-31,2276,8839,11115
05,05656,1988-12-31,2420,8829,11249
05,05656,1989-12-31,2559,8831,11390
05,05656,1990-12-31,2696,8832,11528
05,05656,1991-12-31,2840,8805,11645
05,05656,1992-12-31,3007,8810,11817
05,05656,1993-12-31,3132,8737,11869
05,05656,1994-12-31,3287,8749,12036
05,05656,1995-12-31,3416,8736,12152
05,05656,1996-12-31,3570,8728,12298
05,05656,1997-12-31,3703,8742,12445
05,05656,1998-12-31,3855,8730,12585
05,05656,1999-12-31,4012,8717,12729
05,05656,2000-12-31,4160,8695,12855
05,05656,2001-12-31,4291,8681,12972
05,05656,2002-12-31,4429,8666,13095
05,05656,2003-12-31,4583,8649,13232
05,05656,2004-12-31,4692,8629,13321
05,05656,2005-12-31,4845,8625,13470
05,05656,2006-12-31,5008,8608,13616
05,05656,2007-12-31,5132,8593,13725
05,05656,2008-12-31,5261,8612,13873
05,05656,2009-12-31,5410,8610,14020
05,05656,2010-12-31,5547,8580,14127
05,05656,2011-12-31,5702,8575,14277
05,05656,2012-12-31,5854,8573,14427
05,05656,2013-12-31,5969,8609,14578
05,05656,2014-12-31,6130,8568,14698
05,05656,2015-12-31,6285,8515,14800
05,05656,2016-12-31,6384,8528,14912
05,05656,2017-12-31,6523,8600,15123
05,05656,2018-12-31,6704,8657,15361
05,05656,2019-12-31,6972,8738,15710
05,05656,2020-12-31,7222,8795,16017
05,05656,2021-12-31,7572,8696,16268
05,05656,2022-12-31,7851,8669,16520
05,05656,2023-12-31,8110,8668,16778
05,05656,2024-12-31,8264,8672,16936
05,05656,2025-12-31,8403,8702,17105
05,05656,2026-12-31,8545,8733,17278
05,05656,2027-12-31,8660,8781,17441
05,05656,2028-12-31,8780,8838,17618
05,05656,2029-12-31,8872,8908,17780
05,05656,2030-12-31,8970,9010,17980
05,05656,2031-12-31,9061,9108,18169
05,05656,2032-12-31,9142,9207,18349
05,05656,2033-12-31,9222,9304,18526
05,05656,2034-12-31,9298,9410,18708
05,05656,2035-12-31,9375,9489,18864
05,05658,1985-12-31,1993,585,2578
05,05658,1986-12-31,2001,620,2621
05,05658,1987-12-31,2005,660,2665
05,05658,1988-12-31,2034,662,2696
05,05658,1989-12-31,2025,713,2738
05,05658,1990-12-31,2036,703,2739
05,05658,1991-12-31,2054,721,2775
05,05658,1992-12-31,2073,745,2818
05,05658,1993-12-31,2083,755,2838
05,05658,1994-12-31,2088,805,2893
05,05658,1995-12-31,2103,809,2912
05,05658,1996-12-31,2122,846,2968
05,05658,1997-12-31,2129,869,2998
05,05658,1998-12-31,2144,888,3032
05,05658,1999-12-31,2159,909,3068
05,05658,2000-12-31,2169,911,3080
05,05658,2001-12-31,2186,941,3127
05,05658,2002-12-31,2192,963,3155
05,05658,2003-12-31,2200,986,3186
05,05658,2004-12-31,2213,992,3205
05,05658,2005-12-31,2216,1018,3234
05,05658,2006-12-31,2233,1038,3271
05,05658,2007-12-31,2225,1067,3292
05,05658,2008-12-31,2236,1082,3318
05,05658,2009-12-31,2239,1101,3340
05,05658,2010-12-31,2265,1131,3396
05,05658,2011-12-31,2277,1151,3428
05,05658,2012-12-31,2292,1155,3447
05,05658,2013-12-31,2306,1187,3493
05,05658,2014-12-31,2313,1222,3535
05,05658,2015-12-31,2330,1261,3591
05,05658,2016-12-31,2308,1268,3576
05,05658,2017-12-31,2307,1274,3581
05,05658,2018-12-31,2353,1293,3646
05,05658,2019-12-31,2392,1314,3706
05,05658,2020-12-31,2441,1324,3765
05,05658,2021-12-31,2514,1309,3823
05,05658,2022-12-31,2577,1305,3882
05,05658,2023-12-31,2638,1305,3943
05,05658,2024-12-31,2683,1301,3984
05,05658,2025-12-31,2734,1301,4035
05,05658,2026-12-31,2770,1313,4083
05,05658,2027-12-31,2806,1318,4124
05,05658,2028-12-31,2852,1328,4180
05,05658,2029-12-31,2892,1339,4231
05,05658,2030-12-31,2914,1355,4269
05,05658,2031-12-31,2946,1357,4303
05,05658,2032-12-31,2972,1373,4345
05,05658,2033-12-31,2988,1389,4377
05,05658,2034-12-31,3026,1412,4438
05,05658,2035-12-31,3040,1423,4463
05,05659,1985-12-31,0,0,0
05,05659,1986-12-31,4415,6269,10684
05,05659,1987-12-31,4518,6515,11033
05,05659,1988-12-31,4593,6765,11358
05,05659,1989-12-31,4656,6994,11650
05,05659,1990-12-31,4733,7230,11963
05,05659,1991-12-31,4803,7460,12263
05,05659,1992-12-31,4881,7688,12569
05,05659,1993-12-31,4956,7925,12881
05,05659,1994-12-31,5023,8121,13144
05,05659,1995-12-31,5084,8363,13447
05,05659,1996-12-31,5167,8570,13737
05,05659,1997-12-31,5231,8830,14061
05,05659,1998-12-31,5300,9046,14346
05,05659,1999-12-31,5372,9274,14646
05,05659,2000-12-31,5447,9503,14950
05,05659,2001-12-31,5517,9724,15241
05,05659,2002-12-31,5588,9935,15523
05,05659,2003-12-31,5641,10142,15783
05,05659,2004-12-31,5701,10345,16046
05,05659,2005-12-31,5777,10556,16333
05,05659,2006-12-31,5841,10768,16609
05,05659,2007-12-31,5906,10983,16889
05,05659,2008-12-31,5969,11186,17155
05,05659,2009-12-31,6026,11407,17433
05,05659,2010-12-31,6105,11632,17737
05,05659,2011-12-31,6138,11845,17983
05,05659,2012-12-31,6178,12052,18230
05,05659,2013-12-31,6273,12267,18540
05,05659,2014-12-31,6315,12452,18767
05,05659,2015-12-31,6361,12664,19025
05,05659,2016-12-31,6434,12898,19332
05,05659,2017-12-31,6511,13176,19687
05,05659,2018-12-31,6624,13469,20093
05,05659,2019-12-31,6881,13668,20549
05,05659,2020-12-31,7122,13828,20950
05,05659,2021-12-31,7607,13672,21279
05,05659,2022-12-31,7978,13630,21608
05,05659,2023-12-31,8317,13628,21945
05,05659,2024-12-31,8484,13641,22125
05,05659,2025-12-31,8633,13663,22296
05,05659,2026-12-31,8758,13719,22477
05,05659,2027-12-31,8885,13804,22689
05,05659,2028-12-31,9001,13887,22888
05,05659,2029-12-31,9100,14013,23113
05,05659,2030-12-31,9209,14157,23366
05,05659,2031-12-31,9287,14316,23603
05,05659,2032-12-31,9372,14464,23836
05,05659,2033-12-31,9454,14618,24072
05,05659,2034-12-31,9536,14772,24308
05,05659,2035-12-31,9614,14919,24533
05,05660,1985-12-31,3429,11200,14629
05,05660,1986-12-31,3593,11070,14663
05,05660,1987-12-31,3687,10897,14584
05,05660,1988-12-31,3810,10720,14530
05,05660,1989-12-31,3920,10549,14469
05,05660,1990-12-31,4047,10355,14402
05,05660,1991-12-31,4172,10166,14338
05,05660,1992-12-31,4289,9979,14268
05,05660,1993-12-31,4419,9780,14199
05,05660,1994-12-31,4551,9614,14165
05,05660,1995-12-31,4659,9392,14051
05,05660,1996-12-31,4790,9198,13988
05,05660,1997-12-31,4906,9051,13957
05,05660,1998-12-31,5032,8883,13915
05,05660,1999-12-31,5148,8708,13856
05,05660,2000-12-31,5270,8535,13805
05,05660,2001-12-31,5388,8349,13737
05,05660,2002-12-31,5500,8164,13664
05,05660,2003-12-31,5632,7991,13623
05,05660,2004-12-31,5739,7817,13556
05,05660,2005-12-31,5861,7637,13498
05,05660,2006-12-31,5983,7465,13448
05,05660,2007-12-31,6103,7295,13398
05,05660,2008-12-31,6212,7136,13348
05,05660,2009-12-31,6334,6978,13312
05,05660,2010-12-31,6442,6783,13225
05,05660,2011-12-31,6557,6630,13187
05,05660,2012-12-31,6681,6484,13165
05,05660,2013-12-31,6807,6334,13141
05,05660,2014-12-31,6890,6174,13064
05,05660,2015-12-31,6982,6040,13022
05,05660,2016-12-31,7107,5886,12993
05,05660,2017-12-31,7271,5734,13005
05,05660,2018-12-31,7408,5587,12995
05,05660,2019-12-31,7676,5359,13035
05,05660,2020-12-31,7925,5198,13123
05,05660,2021-12-31,8189,5138,13327
05,05660,2022-12-31,8410,5122,13532
05,05660,2023-12-31,8621,5122,13743
05,05660,2024-12-31,8783,5128,13911
05,05660,2025-12-31,8936,5144,14080
05,05660,2026-12-31,9079,5159,14238
05,05660,2027-12-31,9199,5185,14384
05,05660,2028-12-31,9321,5226,14547
05,05660,2029-12-31,9431,5271,14702
05,05660,2030-12-31,9539,5320,14859
05,05660,2031-12-31,9636,5374,15010
05,05660,2032-12-31,9714,5431,15145
05,05660,2033-12-31,9800,5499,15299
05,05660,2034-12-31,9888,5548,15436
05,05660,2035-12-31,9963,5603,15566
05,05664,1985-12-31,4789,9526,14315
05,05664,1986-12-31,4996,9587,14583
05,05664,1987-12-31,5238,9622,14860
05,05664,1988-12-31,5461,9645,15106
05,05664,1989-12-31,5658,9664,15322
05,05664,1990-12-31,5879,9679,15558
05,05664,1991-12-31,6080,9694,15774
05,05664,1992-12-31,6304,9695,15999
05,05664,1993-12-31,6530,9707,16237
05,05664,1994-12-31,6748,9707,16455
05,05664,1995-12-31,6968,9716,16684
05,05664,1996-12-31,7222,9712,16934
05,05664,1997-12-31,7388,9739,17127
05,05664,1998-12-31,7625,9784,17409
05,05664,1999-12-31,7841,9813,17654
05,05664,2000-12-31,8051,9815,17866
05,05664,2001-12-31,8260,9812,18072
05,05664,2002-12-31,8471,9821,18292
05,05664,2003-12-31,8678,9833,18511
05,05664,2004-12-31,8870,9838,18708
05,05664,2005-12-31,9066,9855,18921
05,05664,2006-12-31,9256,9859,19115
05,05664,2007-12-31,9456,9874,19330
05,05664,2008-12-31,9668,9897,19565
05,05664,2009-12-31,9870,9921,19791
05,05664,2010-12-31,10079,9941,20020
05,05664,2011-12-31,10279,9939,20218
05,05664,2012-12-31,10451,9948,20399
05,05664,2013-12-31,10621,9971,20592
05,05664,2014-12-31,10808,9976,20784
05,05664,2015-12-31,10982,9988,20970
05,05664,2016-12-31,11244,9982,21226
05,05664,2017-12-31,11430,10134,21564
05,05664,2018-12-31,11756,10193,21949
05,05664,2019-12-31,12405,10042,22447
05,05664,2020-12-31,12996,9889,22885
05,05664,2021-12-31,13469,9775,23244
05,05664,2022-12-31,13858,9745,23603
05,05664,2023-12-31,14228,9744,23972
05,05664,2024-12-31,14505,9748,24253
05,05664,2025-12-31,14755,9784,24539
05,05664,2026-12-31,14964,9807,24771
05,05664,2027-12-31,15191,9871,25062
05,05664,2028-12-31,15391,9945,25336
05,05664,2029-12-31,15575,10030,25605
05,05664,2030-12-31,15727,10123,25850
05,05664,2031-12-31,15882,10254,26136
05,05664,2032-12-31,16029,10360,26389
05,05664,2033-12-31,16177,10458,26635
05,05664,2034-12-31,16316,10581,26897
05,05664,2035-12-31,16443,10691,27134
05,05665,1985-12-31,4318,18407,22725
05,05665,1986-12-31,4587,18504,23091
05,05665,1987-12-31,4865,18513,23378
05,05665,1988-12-31,5110,18529,23639
05,05665,1989-12-31,5357,18523,23880
05,05665,1990-12-31,5603,18512,24115
05,05665,1991-12-31,5859,18499,24358
05,05665,1992-12-31,6109,18466,24575
05,05665,1993-12-31,6358,18456,24814
05,05665,1994-12-31,6622,18429,25051
05,05665,1995-12-31,6868,18399,25267
05,05665,1996-12-31,7123,18373,25496
05,05665,1997-12-31,7367,18415,25782
05,05665,1998-12-31,7617,18413,26030
05,05665,1999-12-31,7885,18399,26284
05,05665,2000-12-31,8123,18395,26518
05,05665,2001-12-31,8370,18379,26749
05,05665,2002-12-31,8633,18352,26985
05,05665,2003-12-31,8875,18332,27207
05,05665,2004-12-31,9107,18307,27414
05,05665,2005-12-31,9350,18275,27625
05,05665,2006-12-31,9581,18252,27833
05,05665,2007-12-31,9809,18233,28042
05,05665,2008-12-31,10048,18196,28244
05,05665,2009-12-31,10291,18184,28475
05,05665,2010-12-31,10534,18198,28732
05,05665,2011-12-31,10768,18213,28981
05,05665,2012-12-31,10986,18180,29166
05,05665,2013-12-31,11172,18187,29359
05,05665,2014-12-31,11406,18119,29525
05,05665,2015-12-31,11645,18147,29792
05,05665,2016-12-31,11887,18219,30106
05,05665,2017-12-31,12168,18263,30431
05,05665,2018-12-31,12494,18438,30932
05,05665,2019-12-31,13179,18392,31571
05,05665,2020-12-31,13832,18315,32147
05,05665,2021-12-31,14538,18108,32646
05,05665,2022-12-31,15098,18052,33150
05,05665,2023-12-31,15617,18050,33667
05,05665,2024-12-31,15919,18078,33997
05,05665,2025-12-31,16188,18111,34299
05,05665,2026-12-31,16446,18199,34645
05,05665,2027-12-31,16677,18279,34956
05,05665,2028-12-31,16893,18408,35301
05,05665,2029-12-31,17101,18552,35653
05,05665,2030-12-31,17282,18761,36043
05,05665,2031-12-31,17433,18950,36383
05,05665,2032-12-31,17606,19151,36757
05,05665,2033-12-31,17759,19356,37115
05,05665,2034-12-31,17898,19561,37459
05,05665,2035-12-31,18053,19749,37802
05,05667,1985-12-31,7032,11473,18505
05,05667,1986-12-31,7060,11404,18464
05,05667,1987-12-31,7117,11290,18407
05,05667,1988-12-31,7181,11189,18370
05,05667,1989-12-31,7211,11059,18270
05,05667,1990-12-31,7246,10944,18190
05,05667,1991-12-31,7279,10808,18087
05,05667,1992-12-31,7301,10685,17986
05,05667,1993-12-31,7337,10548,17885
05,05667,1994-12-31,7360,10412,17772
05,05667,1995-12-31,7387,10297,17684
05,05667,1996-12-31,7413,10166,17579
05,05667,1997-12-31,7439,10080,17519
05,05667,1998-12-31,7465,9947,17412
05,05667,1999-12-31,7493,9844,17337
05,05667,2000-12-31,7524,9717,17241
05,05667,2001-12-31,7551,9580,17131
05,05667,2002-12-31,7564,9439,17003
05,05667,2003-12-31,7584,9322,16906
05,05667,2004-12-31,7598,9212,16810
05,05667,2005-12-31,7619,9097,16716
05,05667,2006-12-31,7618,8982,16600
05,05667,2007-12-31,7648,8860,16508
05,05667,2008-12-31,7665,8760,16425
05,05667,2009-12-31,7684,8667,16351
05,05667,2010-12-31,7699,8544,16243
05,05667,2011-12-31,7717,8425,16142
05,05667,2012-12-31,7753,8324,16077
05,05667,2013-12-31,7777,8212,15989
05,05667,2014-12-31,7751,8130,15881
05,05667,2015-12-31,7753,8003,15756
05,05667,2016-12-31,7757,7964,15721
05,05667,2017-12-31,7858,7889,15747
05,05667,2018-12-31,7891,7807,15698
05,05667,2019-12-31,7946,7686,15632
05,05667,2020-12-31,8033,7630,15663
05,05667,2021-12-31,8362,7544,15906
05,05667,2022-12-31,8631,7520,16151
05,05667,2023-12-31,8884,7520,16404
05,05667,2024-12-31,9053,7530,16583
05,05667,2025-12-31,9208,7547,16755
05,05667,2026-12-31,9357,7577,16934
05,05667,2027-12-31,9491,7620,17111
05,05667,2028-12-31,9614,7668,17282
05,05667,2029-12-31,9725,7741,17466
05,05667,2030-12-31,9831,7802,17633
05,05667,2031-12-31,9922,7890,17812
05,05667,2032-12-31,10012,7988,18000
05,05667,2033-12-31,10093,8067,18160
05,05667,2034-12-31,10189,8144,18333
05,05667,2035-12-31,10264,8238,18502
05,05670,1985-12-31,3913,16507,20420
05,05670,1986-12-31,3995,16542,20537
05,05670,1987-12-31,4080,16499,20579
05,05670,1988-12-31,4158,16464,20622
05,05670,1989-12-31,4204,16411,20615
05,05670,1990-12-31,4324,16349,20673
05,05670,1991-12-31,4398,16291,20689
05,05670,1992-12-31,4485,16214,20699
05,05670,1993-12-31,4582,16148,20730
05,05670,1994-12-31,4636,16099,20735
05,05670,1995-12-31,4704,16016,20720
05,05670,1996-12-31,4797,15935,20732
05,05670,1997-12-31,4860,15924,20784
05,05670,1998-12-31,4964,15880,20844
05,05670,1999-12-31,5029,15820,20849
05,05670,2000-12-31,5118,15768,20886
05,05670,2001-12-31,5195,15713,20908
05,05670,2002-12-31,5263,15647,20910
05,05670,2003-12-31,5332,15569,20901
05,05670,2004-12-31,5406,15501,20907
05,05670,2005-12-31,5500,15424,20924
05,05670,2006-12-31,5540,15363,20903
05,05670,2007-12-31,5615,15306,20921
05,05670,2008-12-31,5697,15235,20932
05,05670,2009-12-31,5766,15199,20965
05,05670,2010-12-31,5841,15167,21008
05,05670,2011-12-31,5920,15125,21045
05,05670,2012-12-31,6005,15047,21052
05,05670,2013-12-31,6094,15013,21107
05,05670,2014-12-31,6172,14933,21105
05,05670,2015-12-31,6249,14922,21171
05,05670,2016-12-31,6303,14914,21217
05,05670,2017-12-31,6352,14894,21246
05,05670,2018-12-31,6481,15038,21519
05,05670,2019-12-31,6698,14835,21533
05,05670,2020-12-31,6909,14688,21597
05,05670,2021-12-31,7410,14522,21932
05,05670,2022-12-31,7794,14477,22271
05,05670,2023-12-31,8142,14476,22618
05,05670,2024-12-31,8304,14492,22796
05,05670,2025-12-31,8449,14527,22976
05,05670,2026-12-31,8576,14589,23165
05,05670,2027-12-31,8696,14659,23355
05,05670,2028-12-31,8817,14770,23587
05,05670,2029-12-31,8908,14893,23801
05,05670,2030-12-31,8995,15042,24037
05,05670,2031-12-31,9102,15212,24314
05,05670,2032-12-31,9175,15374,24549
05,05670,2033-12-31,9252,15546,24798
05,05670,2034-12-31,9336,15695,25031
05,05670,2035-12-31,9415,15860,25275
05,05674,1985-12-31,2678,19117,21795
05,05674,1986-12-31,2759,19140,21899
05,05674,1987-12-31,2845,19074,21919
05,05674,1988-12-31,2923,18986,21909
05,05674,1989-12-31,3001,18907,21908
05,05674,1990-12-31,3086,18819,21905
05,05674,1991-12-31,3165,18723,21888
05,05674,1992-12-31,3264,18609,21873
05,05674,1993-12-31,3353,18504,21857
05,05674,1994-12-31,3464,18394,21858
05,05674,1995-12-31,3536,18288,21824
05,05674,1996-12-31,3631,18203,21834
05,05674,1997-12-31,3705,18164,21869
05,05674,1998-12-31,3798,18069,21867
05,05674,1999-12-31,3858,17979,21837
05,05674,2000-12-31,3969,17901,21870
05,05674,2001-12-31,4055,17805,21860
05,05674,2002-12-31,4136,17701,21837
05,05674,2003-12-31,4221,17600,21821
05,05674,2004-12-31,4302,17490,21792
05,05674,2005-12-31,4383,17378,21761
05,05674,2006-12-31,4466,17263,21729
05,05674,2007-12-31,4546,17176,21722
05,05674,2008-12-31,4626,17099,21725
05,05674,2009-12-31,4716,17003,21719
05,05674,2010-12-31,4792,16954,21746
05,05674,2011-12-31,4878,16885,21763
05,05674,2012-12-31,4968,16796,21764
05,05674,2013-12-31,5048,16717,21765
05,05674,2014-12-31,5132,16626,21758
05,05674,2015-12-31,5221,16579,21800
05,05674,2016-12-31,5314,16546,21860
05,05674,2017-12-31,5399,16515,21914
05,05674,2018-12-31,5464,16629,22093
05,05674,2019-12-31,5718,16540,22258
05,05674,2020-12-31,5971,16498,22469
05,05674,2021-12-31,6507,16311,22818
05,05674,2022-12-31,6909,16261,23170
05,05674,2023-12-31,7272,16259,23531
05,05674,2024-12-31,7407,16283,23690
05,05674,2025-12-31,7541,16323,23864
05,05674,2026-12-31,7659,16378,24037
05,05674,2027-12-31,7771,16476,24247
05,05674,2028-12-31,7870,16582,24452
05,05674,2029-12-31,7958,16736,24694
05,05674,2030-12-31,8044,16900,24944
05,05674,2031-12-31,8116,17080,25196
05,05674,2032-12-31,8197,17279,25476
05,05674,2033-12-31,8274,17439,25713
05,05674,2034-12-31,8341,17623,25964
05,05674,2035-12-31,8407,17816,26223
05,05679,1985-12-31,8042,20116,28158
05,05679,1986-12-31,8141,21001,29142
05,05679,1987-12-31,8305,21798,30103
05,05679,1988-12-31,8462,22570,31032
05,05679,1989-12-31,8594,23340,31934
05,05679,1990-12-31,8719,24082,32801
05,05679,1991-12-31,8851,24814,33665
05,05679,1992-12-31,8988,25538,34526
05,05679,1993-12-31,9111,26259,35370
05,05679,1994-12-31,9240,26960,36200
05,05679,1995-12-31,9370,27662,37032
05,05679,1996-12-31,9502,28372,37874
05,05679,1997-12-31,9619,20062,29681
05,05679,1998-12-31,9730,19788,29518
05,05679,1999-12-31,9848,19504,29352
05,05679,2000-12-31,9981,19237,29218
05,05679,2001-12-31,10088,18948,29036
05,05679,2002-12-31,10200,18647,28847
05,05679,2003-12-31,10318,18363,28681
05,05679,2004-12-31,10424,18081,28505
05,05679,2005-12-31,10515,17754,28269
05,05679,2006-12-31,10639,17464,28103
05,05679,2007-12-31,10743,17191,27934
05,05679,2008-12-31,10855,16935,27790
05,05679,2009-12-31,10968,16662,27630
05,05679,2010-12-31,11082,16438,27520
05,05679,2011-12-31,11199,16195,27394
05,05679,2012-12-31,11296,15931,27227
05,05679,2013-12-31,11356,15691,27047
05,05679,2014-12-31,11462,15431,26893
05,05679,2015-12-31,11582,15189,26771
05,05679,2016-12-31,11679,14992,26671
05,05679,2017-12-31,11869,14758,26627
05,05679,2018-12-31,12083,14701,26784
05,05679,2019-12-31,12440,14504,26944
05,05679,2020-12-31,12804,14382,27186
05,05679,2021-12-31,13389,14219,27608
05,05679,2022-12-31,13858,14176,28034
05,05679,2023-12-31,14297,14174,28471
05,05679,2024-12-31,14569,14182,28751
05,05679,2025-12-31,14826,14210,29036
05,05679,2026-12-31,15053,14271,29324
05,05679,2027-12-31,15263,14344,29607
05,05679,2028-12-31,15468,14453,29921
05,05679,2029-12-31,15651,14566,30217
05,05679,2030-12-31,15818,14706,30524
05,05679,2031-12-31,15949,14875,30824
05,05679,2032-12-31,16112,15025,31137
05,05679,2033-12-31,16258,15189,31447
05,05679,2034-12-31,16397,15367,31764
05,05679,2035-12-31,16536,15513,32049
05,05686,1985-12-31,7225,17666,24891
05,05686,1986-12-31,7600,17713,25313
05,05686,1987-12-31,8013,17691,25704
05,05686,1988-12-31,8416,17654,26070
05,05686,1989-12-31,8820,17617,26437
05,05686,1990-12-31,9228,17559,26787
05,05686,1991-12-31,9611,17506,27117
05,05686,1992-12-31,10012,17435,27447
05,05686,1993-12-31,10406,17378,27784
05,05686,1994-12-31,10792,17300,28092
05,05686,1995-12-31,11176,17239,28415
05,05686,1996-12-31,11564,17179,28743
05,05686,1997-12-31,11943,17184,29127
05,05686,1998-12-31,12339,17137,29476
05,05686,1999-12-31,12732,17094,29826
05,05686,2000-12-31,13114,17043,30157
05,05686,2001-12-31,13489,17006,30495
05,05686,2002-12-31,13872,16926,30798
05,05686,2003-12-31,14234,16876,31110
05,05686,2004-12-31,14604,16803,31407
05,05686,2005-12-31,14966,16746,31712
05,05686,2006-12-31,15324,16682,32006
05,05686,2007-12-31,15696,16625,32321
05,05686,2008-12-31,16038,16595,32633
05,05686,2009-12-31,16412,16521,32933
05,05686,2010-12-31,16786,16493,33279
05,05686,2011-12-31,17079,16478,33557
05,05686,2012-12-31,17464,16410,33874
05,05686,2013-12-31,17838,16361,34199
05,05686,2014-12-31,18201,16287,34488
05,05686,2015-12-31,18592,16295,34887
05,05686,2016-12-31,19007,16301,35308
05,05686,2017-12-31,19370,16314,35684
05,05686,2018-12-31,19896,16422,36318
05,05686,2019-12-31,20790,16353,37143
05,05686,2020-12-31,21602,16267,37869
05,05686,2021-12-31,22380,16083,38463
05,05686,2022-12-31,23024,16034,39058
05,05686,2023-12-31,23635,16032,39667
05,05686,2024-12-31,24091,16047,40138
05,05686,2025-12-31,24500,16092,40592
05,05686,2026-12-31,24889,16145,41034
05,05686,2027-12-31,25237,16240,41477
05,05686,2028-12-31,25558,16345,41903
05,05686,2029-12-31,25868,16491,42359
05,05686,2030-12-31,26133,16659,42792
05,05686,2031-12-31,26400,16836,43236
05,05686,2032-12-31,26636,17026,43662
05,05686,2033-12-31,26876,17200,44076
05,05686,2034-12-31,27091,17391,44482
05,05686,2035-12-31,27321,17554,44875
05,05690,1985-12-31,2769,14063,16832
05,05690,1986-12-31,2783,13991,16774
05,05690,1987-12-31,2771,13830,16601
05,05690,1988-12-31,2776,13698,16474
05,05690,1989-12-31,2770,13562,16332
05,05690,1990-12-31,2779,13417,16196
05,05690,1991-12-31,2778,13249,16027
05,05690,1992-12-31,2785,13080,15865
05,05690,1993-12-31,2794,12937,15731
05,05690,1994-12-31,2789,12775,15564
05,05690,1995-12-31,2793,12622,15415
05,05690,1996-12-31,2795,12465,15260
05,05690,1997-12-31,2781,12358,15139
05,05690,1998-12-31,2777,12218,14995
05,05690,1999-12-31,2795,12076,14871
05,05690,2000-12-31,2782,11928,14710
05,05690,2001-12-31,2782,11761,14543
05,05690,2002-12-31,2782,11609,14391
05,05690,2003-12-31,2798,11466,14264
05,05690,2004-12-31,2802,11298,14100
05,05690,2005-12-31,2800,11159,13959
05,05690,2006-12-31,2791,11019,13810
05,05690,2007-12-31,2801,10889,13690
05,05690,2008-12-31,2777,10736,13513
05,05690,2009-12-31,2803,10613,13416
05,05690,2010-12-31,2806,10485,13291
05,05690,2011-12-31,2797,10330,13127
05,05690,2012-12-31,2816,10194,13010
05,05690,2013-12-31,2806,10071,12877
05,05690,2014-12-31,2788,9963,12751
05,05690,2015-12-31,2796,9808,12604
05,05690,2016-12-31,2823,9712,12535
05,05690,2017-12-31,2764,9662,12426
05,05690,2018-12-31,2808,9586,12394
05,05690,2019-12-31,2811,9515,12326
05,05690,2020-12-31,2830,9494,12324
05,05690,2021-12-31,3128,9387,12515
05,05690,2022-12-31,3350,9358,12708
05,05690,2023-12-31,3550,9357,12907
05,05690,2024-12-31,3616,9376,12992
05,05690,2025-12-31,3670,9385,13055
05,05690,2026-12-31,3739,9425,13164
05,05690,2027-12-31,3796,9484,13280
05,05690,2028-12-31,3841,9537,13378
05,05690,2029-12-31,3890,9631,13521
05,05690,2030-12-31,3936,9735,13671
05,05690,2031-12-31,3968,9832,13800
05,05690,2032-12-31,4003,9930,13933
05,05690,2033-12-31,4031,10049,14080
05,05690,2034-12-31,4071,10159,14230
05,05690,2035-12-31,4101,10254,14355
05,05697,1985-12-31,10785,13239,24024
05,05697,1986-12-31,11181,13224,24405
05,05697,1987-12-31,11624,13161,24785
05,05697,1988-12-31,12094,13076,25170
05,05697,1989-12-31,12507,13009,25516
05,05697,1990-12-31,12943,12923,25866
05,05697,1991-12-31,13366,12834,26200
05,05697,1992-12-31,13808,12732,26540
05,05697,1993-12-31,14252,12645,26897
05,05697,1994-12-31,14654,12538,27192
05,05697,1995-12-31,15097,12441,27538
05,05697,1996-12-31,15515,12360,27875
05,05697,1997-12-31,15905,12305,28210
05,05697,1998-12-31,16341,12234,28575
05,05697,1999-12-31,16780,12153,28933
05,05697,2000-12-31,17214,12052,29266
05,05697,2001-12-31,17623,11978,29601
05,05697,2002-12-31,18023,11902,29925
05,05697,2003-12-31,18423,11805,30228
05,05697,2004-12-31,18815,11697,30512
05,05697,2005-12-31,19206,11619,30825
05,05697,2006-12-31,19607,11534,31141
05,05697,2007-12-31,20002,11458,31460
05,05697,2008-12-31,20385,11384,31769
05,05697,2009-12-31,20788,11309,32097
05,05697,2010-12-31,21205,11241,32446
05,05697,2011-12-31,21568,11161,32729
05,05697,2012-12-31,21958,11072,33030
05,05697,2013-12-31,22375,11016,33391
05,05697,2014-12-31,22794,10913,33707
05,05697,2015-12-31,23151,10834,33985
05,05697,2016-12-31,23567,10780,34347
05,05697,2017-12-31,24057,10805,34862
05,05697,2018-12-31,24614,10808,35422
05,05697,2019-12-31,25604,10439,36043
05,05697,2020-12-31,26525,10080,36605
05,05697,2021-12-31,27209,9964,37173
05,05697,2022-12-31,27814,9933,37747
05,05697,2023-12-31,28404,9932,38336
05,05697,2024-12-31,28940,9947,38887
05,05697,2025-12-31,29408,9963,39371
05,05697,2026-12-31,29889,10008,39897
05,05697,2027-12-31,30301,10067,40368
05,05697,2028-12-31,30706,10127,40833
05,05697,2029-12-31,31063,10220,41283
05,05697,2030-12-31,31392,10320,41712
05,05697,2031-12-31,31682,10428,42110
05,05697,2032-12-31,31985,10541,42526
05,05697,2033-12-31,32271,10649,42920
05,05697,2034-12-31,32534,10761,43295
05,05697,2035-12-31,32813,10870,43683
05,05736,1985-12-31,14517,6850,21367
05,05736,1986-12-31,14983,6900,21883
05,05736,1987-12-31,15457,6948,22405
05,05736,1988-12-31,15959,6938,22897
05,05736,1989-12-31,16486,7008,23494
05,05736,1990-12-31,16976,7034,24010
05,05736,1991-12-31,17456,7035,24491
05,05736,1992-12-31,17962,7049,25011
05,05736,1993-12-31,18454,7081,25535
05,05736,1994-12-31,18938,7097,26035
05,05736,1995-12-31,19430,7114,26544
05,05736,1996-12-31,19917,7134,27051
05,05736,1997-12-31,20363,7191,27554
05,05736,1998-12-31,20858,7215,28073
05,05736,1999-12-31,21348,7238,28586
05,05736,2000-12-31,21825,7273,29098
05,05736,2001-12-31,22297,7278,29575
05,05736,2002-12-31,22750,7291,30041
05,05736,2003-12-31,23196,7315,30511
05,05736,2004-12-31,23635,7323,30958
05,05736,2005-12-31,24092,7371,31463
05,05736,2006-12-31,24537,7389,31926
05,05736,2007-12-31,24973,7422,32395
05,05736,2008-12-31,25411,7437,32848
05,05736,2009-12-31,25853,7457,33310
05,05736,2010-12-31,26295,7471,33766
05,05736,2011-12-31,26732,7507,34239
05,05736,2012-12-31,27187,7538,34725
05,05736,2013-12-31,27633,7584,35217
05,05736,2014-12-31,28045,7614,35659
05,05736,2015-12-31,28487,7601,36088
05,05736,2016-12-31,28971,7634,36605
05,05736,2017-12-31,29495,7676,37171
05,05736,2018-12-31,30133,7767,37900
05,05736,2019-12-31,31301,7391,38692
05,05736,2020-12-31,32396,6983,39379
05,05736,2021-12-31,33087,6903,39990
05,05736,2022-12-31,33726,6881,40607
05,05736,2023-12-31,34360,6881,41241
05,05736,2024-12-31,34993,6888,41881
05,05736,2025-12-31,35596,6911,42507
05,05736,2026-12-31,36159,6940,43099
05,05736,2027-12-31,36665,6967,43632
05,05736,2028-12-31,37147,7028,44175
05,05736,2029-12-31,37587,7080,44667
05,05736,2030-12-31,37978,7153,45131
05,05736,2031-12-31,38341,7236,45577
05,05736,2032-12-31,38688,7312,46000
05,05736,2033-12-31,39033,7385,46418
05,05736,2034-12-31,39375,7460,46835
05,05736,2035-12-31,39675,7538,47213
05,05756,1985-12-31,15312,26405,41717
05,05756,1986-12-31,15325,26304,41629
05,05756,1987-12-31,15391,26083,41474
05,05756,1988-12-31,15497,25857,41354
05,05756,1989-12-31,15580,25615,41195
05,05756,1990-12-31,15656,25362,41018
05,05756,1991-12-31,15725,25105,40830
05,05756,1992-12-31,15760,24839,40599
05,05756,1993-12-31,15856,24585,40441
05,05756,1994-12-31,15916,24306,40222
05,05756,1995-12-31,15989,24061,40050
05,05756,1996-12-31,16062,23793,39855
05,05756,1997-12-31,16095,23630,39725
05,05756,1998-12-31,16155,23408,39563
05,05756,1999-12-31,16226,23176,39402
05,05756,2000-12-31,16290,22939,39229
05,05756,2001-12-31,16344,22702,39046
05,05756,2002-12-31,16387,22467,38854
05,05756,2003-12-31,16424,22210,38634
05,05756,2004-12-31,16459,21953,38412
05,05756,2005-12-31,16473,21672,38145
05,05756,2006-12-31,16506,21442,37948
05,05756,2007-12-31,16555,21207,37762
05,05756,2008-12-31,16583,20974,37557
05,05756,2009-12-31,16622,20745,37367
05,05756,2010-12-31,16671,20553,37224
05,05756,2011-12-31,16678,20324,37002
05,05756,2012-12-31,16714,20111,36825
05,05756,2013-12-31,16747,19874,36621
05,05756,2014-12-31,16804,19670,36474
05,05756,2015-12-31,16857,19506,36363
05,05756,2016-12-31,16912,19330,36242
05,05756,2017-12-31,16971,19174,36145
05,05756,2018-12-31,17169,19152,36321
05,05756,2019-12-31,17442,18952,36394
05,05756,2020-12-31,17787,18838,36625
05,05756,2021-12-31,18568,18625,37193
05,05756,2022-12-31,19199,18568,37767
05,05756,2023-12-31,19791,18566,38357
05,05756,2024-12-31,20172,18592,38764
05,05756,2025-12-31,20513,18636,39149
05,05756,2026-12-31,20827,18713,39540
05,05756,2027-12-31,21145,18814,39959
05,05756,2028-12-31,21407,18944,40351
05,05756,2029-12-31,21651,19099,40750
05,05756,2030-12-31,21895,19294,41189
05,05756,2031-12-31,22109,19501,41610
05,05756,2032-12-31,22303,19720,42023
05,05756,2033-12-31,22502,19913,42415
05,05756,2034-12-31,22686,20129,42815
05,05756,2035-12-31,22890,20331,43221
05,05761,1985-12-31,4608,8574,13182
05,05761,1986-12-31,4686,8628,13314
05,05761,1987-12-31,4763,8637,13400
05,05761,1988-12-31,4821,8606,13427
05,05761,1989-12-31,4872,8605,13477
05,05761,1990-12-31,4934,8606,13540
05,05761,1991-12-31,4990,8593,13583
05,05761,1992-12-31,5049,8595,13644
05,05761,1993-12-31,5108,8583,13691
05,05761,1994-12-31,5174,8552,13726
05,05761,1995-12-31,5233,8534,13767
05,05761,1996-12-31,5297,8520,13817
05,05761,1997-12-31,5357,8517,13874
05,05761,1998-12-31,5417,8523,13940
05,05761,1999-12-31,5478,8514,13992
05,05761,2000-12-31,5534,8497,14031
05,05761,2001-12-31,5591,8517,14108
05,05761,2002-12-31,5647,8505,14152
05,05761,2003-12-31,5696,8498,14194
05,05761,2004-12-31,5752,8477,14229
05,05761,2005-12-31,5808,8478,14286
05,05761,2006-12-31,5862,8489,14351
05,05761,2007-12-31,5911,8476,14387
05,05761,2008-12-31,5969,8460,14429
05,05761,2009-12-31,6019,8459,14478
05,05761,2010-12-31,6070,8423,14493
05,05761,2011-12-31,6119,8410,14529
05,05761,2012-12-31,6174,8402,14576
05,05761,2013-12-31,6223,8389,14612
05,05761,2014-12-31,6270,8418,14688
05,05761,2015-12-31,6346,8427,14773
05,05761,2016-12-31,6426,8456,14882
05,05761,2017-12-31,6417,8468,14885
05,05761,2018-12-31,6522,8531,15053
05,05761,2019-12-31,6713,8580,15293
05,05761,2020-12-31,6901,8611,15512
05,05761,2021-12-31,7239,8514,15753
05,05761,2022-12-31,7509,8487,15996
05,05761,2023-12-31,7759,8486,16245
05,05761,2024-12-31,7912,8495,16407
05,05761,2025-12-31,8043,8518,16561
05,05761,2026-12-31,8168,8545,16713
05,05761,2027-12-31,8287,8592,16879
05,05761,2028-12-31,8396,8660,17056
05,05761,2029-12-31,8496,8731,17227
05,05761,2030-12-31,8589,8810,17399
05,05761,2031-12-31,8672,8903,17575
05,05761,2032-12-31,8740,9011,17751
05,05761,2033-12-31,8830,9115,17945
05,05761,2034-12-31,8900,9218,18118
05,05761,2035-12-31,8969,9289,18258
05,05789,1985-12-31,5835,15990,21825
05,05789,1986-12-31,5880,15848,21728
05,05789,1987-12-31,5959,15630,21589
05,05789,1988-12-31,5999,15406,21405
05,05789,1989-12-31,6043,15179,21222
05,05789,1990-12-31,6107,14935,21042
05,05789,1991-12-31,6145,14701,20846
05,05789,1992-12-31,6172,14461,20633
05,05789,1993-12-31,6247,14230,20477
05,05789,1994-12-31,6289,13979,20268
05,05789,1995-12-31,6333,13740,20073
05,05789,1996-12-31,6376,13517,19893
05,05789,1997-12-31,6417,13333,19750
05,05789,1998-12-31,6461,13110,19571
05,05789,1999-12-31,6502,12896,19398
05,05789,2000-12-31,6551,12680,19231
05,05789,2001-12-31,6583,12440,19023
05,05789,2002-12-31,6619,12216,18835
05,05789,2003-12-31,6660,12000,18660
05,05789,2004-12-31,6688,11744,18432
05,05789,2005-12-31,6725,11534,18259
05,05789,2006-12-31,6766,11316,18082
05,05789,2007-12-31,6810,11107,17917
05,05789,2008-12-31,6834,10897,17731
05,05789,2009-12-31,6888,10692,17580
05,05789,2010-12-31,6922,10471,17393
05,05789,2011-12-31,6971,10251,17222
05,05789,2012-12-31,6993,10058,17051
05,05789,2013-12-31,7045,9867,16912
05,05789,2014-12-31,7082,9676,16758
05,05789,2015-12-31,7084,9480,16564
05,05789,2016-12-31,7141,9300,16441
05,05789,2017-12-31,7241,9154,16395
05,05789,2018-12-31,7256,9025,16281
05,05789,2019-12-31,7404,8789,16193
05,05789,2020-12-31,7572,8629,16201
05,05789,2021-12-31,7922,8530,16452
05,05789,2022-12-31,8203,8503,16706
05,05789,2023-12-31,8465,8502,16967
05,05789,2024-12-31,8626,8510,17136
05,05789,2025-12-31,8777,8523,17300
05,05789,2026-12-31,8905,8560,17465
05,05789,2027-12-31,9039,8611,17650
05,05789,2028-12-31,9159,8667,17826
05,05789,2029-12-31,9267,8747,18014
05,05789,2030-12-31,9361,8836,18197
05,05789,2031-12-31,9444,8935,18379
05,05789,2032-12-31,9544,9034,18578
05,05789,2033-12-31,9633,9121,18754
05,05789,2034-12-31,9711,9212,18923
05,05789,2035-12-31,9779,9319,19098
05,05790,1985-12-31,5507,9028,14535
05,05790,1986-12-31,5734,9247,14981
05,05790,1987-12-31,5999,9410,15409
05,05790,1988-12-31,6215,9592,15807
05,05790,1989-12-31,6429,9757,16186
05,05790,1990-12-31,6657,9920,16577
05,05790,1991-12-31,6874,10075,16949
05,05790,1992-12-31,7091,10238,17329
05,05790,1993-12-31,7315,10386,17701
05,05790,1994-12-31,7533,10514,18047
05,05790,1995-12-31,7751,10683,18434
05,05790,1996-12-31,7975,10835,18810
05,05790,1997-12-31,8181,11023,19204
05,05790,1998-12-31,8429,11179,19608
05,05790,1999-12-31,8646,11334,19980
05,05790,2000-12-31,8877,11487,20364
05,05790,2001-12-31,9098,11640,20738
05,05790,2002-12-31,9309,11793,21102
05,05790,2003-12-31,9517,11930,21447
05,05790,2004-12-31,9726,12068,21794
05,05790,2005-12-31,9923,12218,22141
05,05790,2006-12-31,10119,12346,22465
05,05790,2007-12-31,10318,12508,22826
05,05790,2008-12-31,10525,12641,23166
05,05790,2009-12-31,10740,12801,23541
05,05790,2010-12-31,10945,12965,23910
05,05790,2011-12-31,11158,13127,24285
05,05790,2012-12-31,11310,13260,24570
05,05790,2013-12-31,11486,13389,24875
05,05790,2014-12-31,11685,13506,25191
05,05790,2015-12-31,11897,13669,25566
05,05790,2016-12-31,12112,13861,25973
05,05790,2017-12-31,12347,14054,26401
05,05790,2018-12-31,12657,14307,26964
05,05790,2019-12-31,13148,14369,27517
05,05790,2020-12-31,13608,14387,27995
05,05790,2021-12-31,14205,14224,28429
05,05790,2022-12-31,14687,14181,28868
05,05790,2023-12-31,15140,14179,29319
05,05790,2024-12-31,15432,14204,29636
05,05790,2025-12-31,15705,14233,29938
05,05790,2026-12-31,15934,14285,30219
05,05790,2027-12-31,16158,14363,30521
05,05790,2028-12-31,16387,14466,30853
05,05790,2029-12-31,16568,14578,31146
05,05790,2030-12-31,16743,14732,31475
05,05790,2031-12-31,16902,14894,31796
05,05790,2032-12-31,17068,15044,32112
05,05790,2033-12-31,17210,15211,32421
05,05790,2034-12-31,17366,15368,32734
05,05790,2035-12-31,17492,15520,33012
05,05792,1985-12-31,2537,4681,7218
05,05792,1986-12-31,2557,4650,7207
05,05792,1987-12-31,2593,4604,7197
05,05792,1988-12-31,2620,4547,7167
05,05792,1989-12-31,2627,4467,7094
05,05792,1990-12-31,2651,4403,7054
05,05792,1991-12-31,2680,4352,7032
05,05792,1992-12-31,2693,4285,6978
05,05792,1993-12-31,2729,4219,6948
05,05792,1994-12-31,2750,4140,6890
05,05792,1995-12-31,2767,4086,6853
05,05792,1996-12-31,2802,4025,6827
05,05792,1997-12-31,2826,3979,6805
05,05792,1998-12-31,2859,3908,6767
05,05792,1999-12-31,2870,3857,6727
05,05792,2000-12-31,2897,3811,6708
05,05792,2001-12-31,2924,3755,6679
05,05792,2002-12-31,2957,3687,6644
05,05792,2003-12-31,2946,3625,6571
05,05792,2004-12-31,2973,3558,6531
05,05792,2005-12-31,3015,3511,6526
05,05792,2006-12-31,3003,3453,6456
05,05792,2007-12-31,3045,3385,6430
05,05792,2008-12-31,3071,3328,6399
05,05792,2009-12-31,3115,3296,6411
05,05792,2010-12-31,3141,3238,6379
05,05792,2011-12-31,3168,3218,6386
05,05792,2012-12-31,3193,3138,6331
05,05792,2013-12-31,3220,3059,6279
05,05792,2014-12-31,3246,3010,6256
05,05792,2015-12-31,3233,2977,6210
05,05792,2016-12-31,3228,2913,6141
05,05792,2017-12-31,3267,2866,6133
05,05792,2018-12-31,3324,2860,6184
05,05792,2019-12-31,3411,2783,6194
05,05792,2020-12-31,3500,2731,6231
05,05792,2021-12-31,3628,2700,6328
05,05792,2022-12-31,3734,2691,6425
05,05792,2023-12-31,3835,2691,6526
05,05792,2024-12-31,3908,2692,6600
05,05792,2025-12-31,3981,2698,6679
05,05792,2026-12-31,4044,2709,6753
05,05792,2027-12-31,4101,2718,6819
05,05792,2028-12-31,4150,2745,6895
05,05792,2029-12-31,4200,2766,6966
05,05792,2030-12-31,4247,2788,7035
05,05792,2031-12-31,4291,2823,7114
05,05792,2032-12-31,4315,2853,7168
05,05792,2033-12-31,4369,2884,7253
05,05792,2034-12-31,4405,2920,7325
05,05792,2035-12-31,4433,2943,7376
05,05809,1985-12-31,3549,11081,14630
05,05809,1986-12-31,3576,10992,14568
05,05809,1987-12-31,3616,10819,14435
05,05809,1988-12-31,3653,10676,14329
05,05809,1989-12-31,3683,10508,14191
05,05809,1990-12-31,3705,10334,14039
05,05809,1991-12-31,3730,10181,13911
05,05809,1992-12-31,3758,10014,13772
05,05809,1993-12-31,3794,9848,13642
05,05809,1994-12-31,3875,9668,13543
05,05809,1995-12-31,3872,9508,13380
05,05809,1996-12-31,3898,9347,13245
05,05809,1997-12-31,3927,9209,13136
05,05809,1998-12-31,3963,9060,13023
05,05809,1999-12-31,4027,8904,12931
05,05809,2000-12-31,4041,8747,12788
05,05809,2001-12-31,4075,8579,12654
05,05809,2002-12-31,4092,8411,12503
05,05809,2003-12-31,4148,8248,12396
05,05809,2004-12-31,4159,8099,12258
05,05809,2005-12-31,4200,7954,12154
05,05809,2006-12-31,4209,7797,12006
05,05809,2007-12-31,4246,7657,11903
05,05809,2008-12-31,4279,7515,11794
05,05809,2009-12-31,4306,7349,11655
05,05809,2010-12-31,4337,7200,11537
05,05809,2011-12-31,4371,7080,11451
05,05809,2012-12-31,4411,6931,11342
05,05809,2013-12-31,4439,6800,11239
05,05809,2014-12-31,4479,6662,11141
05,05809,2015-12-31,4492,6521,11013
05,05809,2016-12-31,4557,6435,10992
05,05809,2017-12-31,4557,6308,10865
05,05809,2018-12-31,4591,6184,10775
05,05809,2019-12-31,4769,5947,10716
05,05809,2020-12-31,4936,5783,10719
05,05809,2021-12-31,5169,5716,10885
05,05809,2022-12-31,5354,5699,11053
05,05809,2023-12-31,5528,5698,11226
05,05809,2024-12-31,5634,5697,11331
05,05809,2025-12-31,5721,5714,11435
05,05809,2026-12-31,5820,5746,11566
05,05809,2027-12-31,5899,5758,11657
05,05809,2028-12-31,5982,5808,11790
05,05809,2029-12-31,6053,5863,11916
05,05809,2030-12-31,6110,5920,12030
05,05809,2031-12-31,6180,5977,12157
05,05809,2032-12-31,6232,6042,12274
05,05809,2033-12-31,6282,6106,12388
05,05809,2034-12-31,6330,6177,12507
05,05809,2035-12-31,6395,6251,12646
05,05819,1985-12-31,864,5873,6737
05,05819,1986-12-31,916,5817,6733
05,05819,1987-12-31,944,5740,6684
05,05819,1988-12-31,971,5657,6628
05,05819,1989-12-31,955,5575,6530
05,05819,1990-12-31,1010,5484,6494
05,05819,1991-12-31,1038,5393,6431
05,05819,1992-12-31,1068,5295,6363
05,05819,1993-12-31,1088,5202,6290
05,05819,1994-12-31,1101,5105,6206
05,05819,1995-12-31,1113,5017,6130
05,05819,1996-12-31,1158,4941,6099
05,05819,1997-12-31,1179,4873,6052
05,05819,1998-12-31,1212,4791,6003
05,05819,1999-12-31,1242,4716,5958
05,05819,2000-12-31,1262,4660,5922
05,05819,2001-12-31,1291,4574,5865
05,05819,2002-12-31,1318,4487,5805
05,05819,2003-12-31,1321,4383,5704
05,05819,2004-12-31,1359,4304,5663
05,05819,2005-12-31,1376,4220,5596
05,05819,2006-12-31,1404,4169,5573
05,05819,2007-12-31,1428,4050,5478
05,05819,2008-12-31,1452,3983,5435
05,05819,2009-12-31,1459,3891,5350
05,05819,2010-12-31,1493,3824,5317
05,05819,2011-12-31,1503,3752,5255
05,05819,2012-12-31,1517,3682,5199
05,05819,2013-12-31,1539,3620,5159
05,05819,2014-12-31,1564,3549,5113
05,05819,2015-12-31,1593,3492,5085
05,05819,2016-12-31,1630,3419,5049
05,05819,2017-12-31,1658,3355,5013
05,05819,2018-12-31,1700,3293,4993
05,05819,2019-12-31,1741,3264,5005
05,05819,2020-12-31,1779,3264,5043
05,05819,2021-12-31,1894,3227,5121
05,05819,2022-12-31,1983,3217,5200
05,05819,2023-12-31,2064,3217,5281
05,05819,2024-12-31,2104,3217,5321
05,05819,2025-12-31,2139,3224,5363
05,05819,2026-12-31,2173,3247,5420
05,05819,2027-12-31,2209,3257,5466
05,05819,2028-12-31,2230,3281,5511
05,05819,2029-12-31,2259,3310,5569
05,05819,2030-12-31,2281,3345,5626
05,05819,2031-12-31,2299,3382,5681
05,05819,2032-12-31,2322,3416,5738
05,05819,2033-12-31,2348,3459,5807
05,05819,2034-12-31,2369,3486,5855
05,05819,2035-12-31,2385,3524,5909
05,05837,1985-12-31,25415,45638,71053
05,05837,1986-12-31,26079,46852,72931
05,05837,1987-12-31,26832,47851,74683
05,05837,1988-12-31,27572,48851,76423
05,05837,1989-12-31,28350,49804,78154
05,05837,1990-12-31,29066,50731,79797
05,05837,1991-12-31,29843,51645,81488
05,05837,1992-12-31,30606,52523,83129
05,05837,1993-12-31,31308,53411,84719
05,05837,1994-12-31,32023,54250,86273
05,05837,1995-12-31,32755,55120,87875
05,05837,1996-12-31,33494,55979,89473
05,05837,1997-12-31,34186,57043,91229
05,05837,1998-12-31,34926,57971,92897
05,05837,1999-12-31,35668,58872,94540
05,05837,2000-12-31,36393,59775,96168
05,05837,2001-12-31,37082,60622,97704
05,05837,2002-12-31,37769,61444,99213
05,05837,2003-12-31,38447,62242,100689
05,05837,2004-12-31,39120,63058,102178
05,05837,2005-12-31,39770,63822,103592
05,05837,2006-12-31,40437,64620,105057
05,05837,2007-12-31,41087,65450,106537
05,05837,2008-12-31,41742,66275,108017
05,05837,2009-12-31,42389,67107,109496
05,05837,2010-12-31,43059,67969,111028
05,05837,2011-12-31,43753,68849,112602
05,05837,2012-12-31,44368,69708,114076
05,05837,2013-12-31,45022,70520,115542
05,05837,2014-12-31,45649,71377,117026
05,05837,2015-12-31,46312,72259,118571
05,05837,2016-12-31,46999,73239,120238
05,05837,2017-12-31,47797,74371,122168
05,05837,2018-12-31,48787,75765,124552
05,05837,2019-12-31,50679,76886,127565
05,05837,2020-12-31,52453,77738,130191
05,05837,2021-12-31,55377,76859,132236
05,05837,2022-12-31,57656,76622,134278
05,05837,2023-12-31,59761,76613,136374
05,05837,2024-12-31,60917,76705,137622
05,05837,2025-12-31,61964,76912,138876
05,05837,2026-12-31,62923,77189,140112
05,05837,2027-12-31,63812,77603,141415
05,05837,2028-12-31,64657,78130,142787
05,05837,2029-12-31,65417,78807,144224
05,05837,2030-12-31,66088,79598,145686
05,05837,2031-12-31,66717,80477,147194
05,05837,2032-12-31,67344,81341,148685
05,05837,2033-12-31,67935,82187,150122
05,05837,2034-12-31,68495,83046,151541
05,05837,2035-12-31,69049,83901,152950
05,05842,1985-12-31,1740,7460,9200
05,05842,1986-12-31,1745,7403,9148
05,05842,1987-12-31,1753,7325,9078
05,05842,1988-12-31,1763,7238,9001
05,05842,1989-12-31,1769,7156,8925
05,05842,1990-12-31,1791,7066,8857
05,05842,1991-12-31,1795,6979,8774
05,05842,1992-12-31,1824,6876,8700
05,05842,1993-12-31,1835,6780,8615
05,05842,1994-12-31,1833,6697,8530
05,05842,1995-12-31,1854,6591,8445
05,05842,1996-12-31,1863,6520,8383
05,05842,1997-12-31,1868,6457,8325
05,05842,1998-12-31,1884,6349,8233
05,05842,1999-12-31,1899,6268,8167
05,05842,2000-12-31,1913,6175,8088
05,05842,2001-12-31,1927,6099,8026
05,05842,2002-12-31,1932,6011,7943
05,05842,2003-12-31,1942,5938,7880
05,05842,2004-12-31,1951,5814,7765
05,05842,2005-12-31,1944,5746,7690
05,05842,2006-12-31,1961,5640,7601
05,05842,2007-12-31,1980,5567,7547
05,05842,2008-12-31,1985,5473,7458
05,05842,2009-12-31,2010,5405,7415
05,05842,2010-12-31,2027,5301,7328
05,05842,2011-12-31,2039,5229,7268
05,05842,2012-12-31,2030,5165,7195
05,05842,2013-12-31,2049,5097,7146
05,05842,2014-12-31,2060,5024,7084
05,05842,2015-12-31,2069,4981,7050
05,05842,2016-12-31,2043,4914,6957
05,05842,2017-12-31,2080,4832,6912
05,05842,2018-12-31,2111,4777,6888
05,05842,2019-12-31,2154,4721,6875
05,05842,2020-12-31,2202,4697,6899
05,05842,2021-12-31,2362,4644,7006
05,05842,2022-12-31,2484,4630,7114
05,05842,2023-12-31,2596,4629,7225
05,05842,2024-12-31,2650,4634,7284
05,05842,2025-12-31,2695,4641,7336
05,05842,2026-12-31,2735,4668,7403
05,05842,2027-12-31,2767,4691,7458
05,05842,2028-12-31,2807,4717,7524
05,05842,2029-12-31,2847,4760,7607
05,05842,2030-12-31,2864,4820,7684
05,05842,2031-12-31,2896,4855,7751
05,05842,2032-12-31,2924,4907,7831
05,05842,2033-12-31,2947,4974,7921
05,05842,2034-12-31,2972,5019,7991
05,05842,2035-12-31,3002,5069,8071
05,05847,1985-12-31,10332,17447,27779
05,05847,1986-12-31,10474,17426,27900
05,05847,1987-12-31,10676,17333,28009
05,05847,1988-12-31,10874,17234,28108
05,05847,1989-12-31,11059,17129,28188
05,05847,1990-12-31,11235,17004,28239
05,05847,1991-12-31,11436,16901,28337
05,05847,1992-12-31,11614,16770,28384
05,05847,1993-12-31,11793,16653,28446
05,05847,1994-12-31,11974,16505,28479
05,05847,1995-12-31,12151,16396,28547
05,05847,1996-12-31,12335,16264,28599
05,05847,1997-12-31,12491,16206,28697
05,05847,1998-12-31,12665,16115,28780
05,05847,1999-12-31,12847,16013,28860
05,05847,2000-12-31,13005,15903,28908
05,05847,2001-12-31,13179,15785,28964
05,05847,2002-12-31,13334,15670,29004
05,05847,2003-12-31,13489,15539,29028
05,05847,2004-12-31,13632,15415,29047
05,05847,2005-12-31,13779,15296,29075
05,05847,2006-12-31,13938,15187,29125
05,05847,2007-12-31,14121,15087,29208
05,05847,2008-12-31,14191,14970,29161
05,05847,2009-12-31,14387,14858,29245
05,05847,2010-12-31,14544,14780,29324
05,05847,2011-12-31,14677,14694,29371
05,05847,2012-12-31,14789,14576,29365
05,05847,2013-12-31,14942,14465,29407
05,05847,2014-12-31,15102,14348,29450
05,05847,2015-12-31,15265,14275,29540
05,05847,2016-12-31,15443,14188,29631
05,05847,2017-12-31,15631,14160,29791
05,05847,2018-12-31,15918,14209,30127
05,05847,2019-12-31,16418,14066,30484
05,05847,2020-12-31,16917,13959,30876
05,05847,2021-12-31,17554,13801,31355
05,05847,2022-12-31,18080,13759,31839
05,05847,2023-12-31,18579,13757,32336
05,05847,2024-12-31,18945,13769,32714
05,05847,2025-12-31,19249,13804,33053
05,05847,2026-12-31,19568,13853,33421
05,05847,2027-12-31,19836,13929,33765
05,05847,2028-12-31,20100,14030,34130
05,05847,2029-12-31,20338,14151,34489
05,05847,2030-12-31,20553,14289,34842
05,05847,2031-12-31,20754,14455,35209
05,05847,2032-12-31,20940,14607,35547
05,05847,2033-12-31,21126,14752,35878
05,05847,2034-12-31,21293,14914,36207
05,05847,2035-12-31,21469,15058,36527
05,05854,1985-12-31,2587,10894,13481
05,05854,1986-12-31,2615,10926,13541
05,05854,1987-12-31,2646,10877,13523
05,05854,1988-12-31,2684,10881,13565
05,05854,1989-12-31,2709,10858,13567
05,05854,1990-12-31,2745,10821,13566
05,05854,1991-12-31,2789,10789,13578
05,05854,1992-12-31,2846,10756,13602
05,05854,1993-12-31,2868,10717,13585
05,05854,1994-12-31,2896,10669,13565
05,05854,1995-12-31,2917,10639,13556
05,05854,1996-12-31,2953,10599,13552
05,05854,1997-12-31,3000,10608,13608
05,05854,1998-12-31,3034,10583,13617
05,05854,1999-12-31,3074,10551,13625
05,05854,2000-12-31,3097,10525,13622
05,05854,2001-12-31,3113,10492,13605
05,05854,2002-12-31,3149,10464,13613
05,05854,2003-12-31,3179,10429,13608
05,05854,2004-12-31,3216,10388,13604
05,05854,2005-12-31,3243,10353,13596
05,05854,2006-12-31,3285,10332,13617
05,05854,2007-12-31,3290,10283,13573
05,05854,2008-12-31,3318,10260,13578
05,05854,2009-12-31,3359,10245,13604
05,05854,2010-12-31,3381,10237,13618
05,05854,2011-12-31,3431,10205,13636
05,05854,2012-12-31,3456,10186,13642
05,05854,2013-12-31,3483,10165,13648
05,05854,2014-12-31,3510,10141,13651
05,05854,2015-12-31,3581,10117,13698
05,05854,2016-12-31,3588,10095,13683
05,05854,2017-12-31,3599,10101,13700
05,05854,2018-12-31,3637,10164,13801
05,05854,2019-12-31,3778,10172,13950
05,05854,2020-12-31,3910,10192,14102
05,05854,2021-12-31,4244,10077,14321
05,05854,2022-12-31,4496,10046,14542
05,05854,2023-12-31,4724,10045,14769
05,05854,2024-12-31,4819,10060,14879
05,05854,2025-12-31,4893,10074,14967
05,05854,2026-12-31,4978,10123,15101
05,05854,2027-12-31,5046,10182,15228
05,05854,2028-12-31,5111,10252,15363
05,05854,2029-12-31,5174,10335,15509
05,05854,2030-12-31,5223,10440,15663
05,05854,2031-12-31,5269,10548,15817
05,05854,2032-12-31,5323,10664,15987
05,05854,2033-12-31,5378,10780,16158
05,05854,2034-12-31,5415,10887,16302
05,05854,2035-12-31,5467,10994,16461
05,05856,1985-12-31,3037,5744,8781
05,05856,1986-12-31,3060,5865,8925
05,05856,1987-12-31,3071,5981,9052
05,05856,1988-12-31,3085,6101,9186
05,05856,1989-12-31,3100,6222,9322
05,05856,1990-12-31,3121,6296,9417
05,05856,1991-12-31,3156,6390,9546
05,05856,1992-12-31,3149,6514,9663
05,05856,1993-12-31,3177,6601,9778
05,05856,1994-12-31,3202,6676,9878
05,05856,1995-12-31,3241,6786,10027
05,05856,1996-12-31,3232,6885,10117
05,05856,1997-12-31,3253,5726,8979
05,05856,1998-12-31,3291,5587,8878
05,05856,1999-12-31,3299,5440,8739
05,05856,2000-12-31,3329,5291,8620
05,05856,2001-12-31,3347,5160,8507
05,05856,2002-12-31,3363,5000,8363
05,05856,2003-12-31,3388,4851,8239
05,05856,2004-12-31,3384,4725,8109
05,05856,2005-12-31,3400,4563,7963
05,05856,2006-12-31,3423,4426,7849
05,05856,2007-12-31,3443,4285,7728
05,05856,2008-12-31,3455,4128,7583
05,05856,2009-12-31,3481,4001,7482
05,05856,2010-12-31,3494,3879,7373
05,05856,2011-12-31,3513,3763,7276
05,05856,2012-12-31,3527,3619,7146
05,05856,2013-12-31,3529,3493,7022
05,05856,2014-12-31,3551,3378,6929
05,05856,2015-12-31,3593,3228,6821
05,05856,2016-12-31,3626,3121,6747
05,05856,2017-12-31,3571,2985,6556
05,05856,2018-12-31,3639,2859,6498
05,05856,2019-12-31,3705,2757,6462
05,05856,2020-12-31,3784,2688,6472
05,05856,2021-12-31,3915,2657,6572
05,05856,2022-12-31,4025,2649,6674
05,05856,2023-12-31,4129,2649,6778
05,05856,2024-12-31,4211,2652,6863
05,05856,2025-12-31,4288,2661,6949
05,05856,2026-12-31,4345,2665,7010
05,05856,2027-12-31,4413,2676,7089
05,05856,2028-12-31,4463,2706,7169
05,05856,2029-12-31,4518,2724,7242
05,05856,2030-12-31,4573,2749,7322
05,05856,2031-12-31,4613,2780,7393
05,05856,2032-12-31,4655,2811,7466
05,05856,2033-12-31,4705,2835,7540
05,05856,2034-12-31,4742,2867,7609
05,05856,2035-12-31,4774,2901,7675
05,05858,1985-12-31,3058,9622,12680
05,05858,1986-12-31,3225,9474,12699
05,05858,1987-12-31,3379,9283,12662
05,05858,1988-12-31,3520,9107,12627
05,05858,1989-12-31,3671,8915,12586
05,05858,1990-12-31,3824,8721,12545
05,05858,1991-12-31,3980,8529,12509
05,05858,1992-12-31,4129,8329,12458
05,05858,1993-12-31,4289,8130,12419
05,05858,1994-12-31,4440,7928,12368
05,05858,1995-12-31,4594,7746,12340
05,05858,1996-12-31,4757,7563,12320
05,05858,1997-12-31,4904,7393,12297
05,05858,1998-12-31,5058,7193,12251
05,05858,1999-12-31,5204,7030,12234
05,05858,2000-12-31,5380,6826,12206
05,05858,2001-12-31,5532,6647,12179
05,05858,2002-12-31,5680,6463,12143
05,05858,2003-12-31,5830,6284,12114
05,05858,2004-12-31,5961,6108,12069
05,05858,2005-12-31,6113,5920,12033
05,05858,2006-12-31,6243,5732,11975
05,05858,2007-12-31,6391,5566,11957
05,05858,2008-12-31,6572,5392,11964
05,05858,2009-12-31,6736,5208,11944
05,05858,2010-12-31,6880,5034,11914
05,05858,2011-12-31,7020,4868,11888
05,05858,2012-12-31,7185,4710,11895
05,05858,2013-12-31,7329,4544,11873
05,05858,2014-12-31,7427,4393,11820
05,05858,2015-12-31,7527,4223,11750
05,05858,2016-12-31,7681,4076,11757
05,05858,2017-12-31,7860,3919,11779
05,05858,2018-12-31,8055,3755,11810
05,05858,2019-12-31,8323,3587,11910
05,05858,2020-12-31,8571,3468,12039
05,05858,2021-12-31,8798,3428,12226
05,05858,2022-12-31,8996,3418,12414
05,05858,2023-12-31,9191,3417,12608
05,05858,2024-12-31,9365,3419,12784
05,05858,2025-12-31,9531,3424,12955
05,05858,2026-12-31,9675,3443,13118
05,05858,2027-12-31,9822,3463,13285
05,05858,2028-12-31,9951,3483,13434
05,05858,2029-12-31,10063,3511,13574
05,05858,2030-12-31,10158,3538,13696
05,05858,2031-12-31,10269,3585,13854
05,05858,2032-12-31,10356,3623,13979
05,05858,2033-12-31,10445,3668,14113
05,05858,2034-12-31,10546,3706,14252
05,05858,2035-12-31,10627,3747,14374
05,05861,1985-12-31,4235,8991,13226
05,05861,1986-12-31,4252,8969,13221
05,05861,1987-12-31,4266,8884,13150
05,05861,1988-12-31,4313,8812,13125
05,05861,1989-12-31,4341,8720,13061
05,05861,1990-12-31,4347,8634,12981
05,05861,1991-12-31,4363,8553,12916
05,05861,1992-12-31,4459,8463,12922
05,05861,1993-12-31,4444,8375,12819
05,05861,1994-12-31,4502,8281,12783
05,05861,1995-12-31,4499,8191,12690
05,05861,1996-12-31,4537,8096,12633
05,05861,1997-12-31,4572,8034,12606
05,05861,1998-12-31,4587,7958,12545
05,05861,1999-12-31,4621,7866,12487
05,05861,2000-12-31,4650,7798,12448
05,05861,2001-12-31,4681,7708,12389
05,05861,2002-12-31,4702,7628,12330
05,05861,2003-12-31,4728,7525,12253
05,05861,2004-12-31,4748,7450,12198
05,05861,2005-12-31,4776,7365,12141
05,05861,2006-12-31,4798,7290,12088
05,05861,2007-12-31,4814,7228,12042
05,05861,2008-12-31,4824,7153,11977
05,05861,2009-12-31,4870,7032,11902
05,05861,2010-12-31,4893,6982,11875
05,05861,2011-12-31,4905,6882,11787
05,05861,2012-12-31,4963,6874,11837
05,05861,2013-12-31,4978,6795,11773
05,05861,2014-12-31,4966,6724,11690
05,05861,2015-12-31,4973,6653,11626
05,05861,2016-12-31,4995,6639,11634
05,05861,2017-12-31,5028,6529,11557
05,05861,2018-12-31,5089,6513,11602
05,05861,2019-12-31,5215,6421,11636
05,05861,2020-12-31,5352,6363,11715
05,05861,2021-12-31,5606,6291,11897
05,05861,2022-12-31,5808,6272,12080
05,05861,2023-12-31,5998,6271,12269
05,05861,2024-12-31,6117,6280,12397
05,05861,2025-12-31,6215,6296,12511
05,05861,2026-12-31,6311,6317,12628
05,05861,2027-12-31,6415,6350,12765
05,05861,2028-12-31,6495,6385,12880
05,05861,2029-12-31,6559,6448,13007
05,05861,2030-12-31,6638,6503,13141
05,05861,2031-12-31,6706,6576,13282
05,05861,2032-12-31,6757,6651,13408
05,05861,2033-12-31,6830,6728,13558
05,05861,2034-12-31,6880,6793,13673
05,05861,2035-12-31,6941,6862,13803
05,05873,1985-12-31,1288,5380,6668
05,05873,1986-12-31,1369,5421,6790
05,05873,1987-12-31,1421,5438,6859
05,05873,1988-12-31,1472,5458,6930
05,05873,1989-12-31,1533,5477,7010
05,05873,1990-12-31,1584,5483,7067
05,05873,1991-12-31,1624,5502,7126
05,05873,1992-12-31,1679,5530,7209
05,05873,1993-12-31,1731,5523,7254
05,05873,1994-12-31,1792,5523,7315
05,05873,1995-12-31,1861,5544,7405
05,05873,1996-12-31,1907,5554,7461
05,05873,1997-12-31,1979,5587,7566
05,05873,1998-12-31,1984,5611,7595
05,05873,1999-12-31,2072,5632,7704
05,05873,2000-12-31,2120,5651,7771
05,05873,2001-12-31,2203,5660,7863
05,05873,2002-12-31,2229,5673,7902
05,05873,2003-12-31,2296,5733,8029
05,05873,2004-12-31,2346,5711,8057
05,05873,2005-12-31,2396,5722,8118
05,05873,2006-12-31,2453,5716,8169
05,05873,2007-12-31,2505,5741,8246
05,05873,2008-12-31,2561,5752,8313
05,05873,2009-12-31,2602,5760,8362
05,05873,2010-12-31,2666,5772,8438
05,05873,2011-12-31,2698,5798,8496
05,05873,2012-12-31,2752,5817,8569
05,05873,2013-12-31,2815,5836,8651
05,05873,2014-12-31,2877,5871,8748
05,05873,2015-12-31,2901,5875,8776
05,05873,2016-12-31,2955,5887,8842
05,05873,2017-12-31,3031,5931,8962
05,05873,2018-12-31,3102,5991,9093
05,05873,2019-12-31,3201,6064,9265
05,05873,2020-12-31,3292,6131,9423
05,05873,2021-12-31,3507,6062,9569
05,05873,2022-12-31,3674,6043,9717
05,05873,2023-12-31,3827,6042,9869
05,05873,2024-12-31,3905,6052,9957
05,05873,2025-12-31,3964,6064,10028
05,05873,2026-12-31,4028,6089,10117
05,05873,2027-12-31,4091,6118,10209
05,05873,2028-12-31,4141,6154,10295
05,05873,2029-12-31,4184,6208,10392
05,05873,2030-12-31,4236,6284,10520
05,05873,2031-12-31,4278,6338,10616
05,05873,2032-12-31,4311,6407,10718
05,05873,2033-12-31,4350,6486,10836
05,05873,2034-12-31,4392,6555,10947
05,05873,2035-12-31,4428,6610,11038
05,05885,1985-12-31,2689,5241,7930
05,05885,1986-12-31,2726,5218,7944
05,05885,1987-12-31,2721,5189,7910
05,05885,1988-12-31,2770,5149,7919
05,05885,1989-12-31,2819,5103,7922
05,05885,1990-12-31,2843,5064,7907
05,05885,1991-12-31,2889,5011,7900
05,05885,1992-12-31,2903,4976,7879
05,05885,1993-12-31,2929,4930,7859
05,05885,1994-12-31,2971,4893,7864
05,05885,1995-12-31,2962,4831,7793
05,05885,1996-12-31,2992,4759,7751
05,05885,1997-12-31,3025,4745,7770
05,05885,1998-12-31,3058,4722,7780
05,05885,1999-12-31,3081,4678,7759
05,05885,2000-12-31,3120,4643,7763
05,05885,2001-12-31,3156,4603,7759
05,05885,2002-12-31,3171,4558,7729
05,05885,2003-12-31,3192,4522,7714
05,05885,2004-12-31,3221,4454,7675
05,05885,2005-12-31,3248,4421,7669
05,05885,2006-12-31,3264,4384,7648
05,05885,2007-12-31,3293,4349,7642
05,05885,2008-12-31,3322,4311,7633
05,05885,2009-12-31,3341,4263,7604
05,05885,2010-12-31,3380,4242,7622
05,05885,2011-12-31,3396,4209,7605
05,05885,2012-12-31,3405,4190,7595
05,05885,2013-12-31,3439,4137,7576
05,05885,2014-12-31,3467,4122,7589
05,05885,2015-12-31,3513,4093,7606
05,05885,2016-12-31,3536,4082,7618
05,05885,2017-12-31,3522,4019,7541
05,05885,2018-12-31,3587,4021,7608
05,05885,2019-12-31,3649,3981,7630
05,05885,2020-12-31,3723,3958,7681
05,05885,2021-12-31,3887,3913,7800
05,05885,2022-12-31,4020,3901,7921
05,05885,2023-12-31,4143,3901,8044
05,05885,2024-12-31,4223,3902,8125
05,05885,2025-12-31,4296,3913,8209
05,05885,2026-12-31,4370,3934,8304
05,05885,2027-12-31,4433,3949,8382
05,05885,2028-12-31,4485,3980,8465
05,05885,2029-12-31,4535,4019,8554
05,05885,2030-12-31,4575,4064,8639
05,05885,2031-12-31,4624,4098,8722
05,05885,2032-12-31,4670,4141,8811
05,05885,2033-12-31,4705,4190,8895
05,05885,2034-12-31,4756,4231,8987
05,05885,2035-12-31,4797,4274,9071
05,05887,1985-12-31,18939,15138,34077
05,05887,1986-12-31,19198,15136,34334
05,05887,1987-12-31,19545,15070,34615
05,05887,1988-12-31,19874,14952,34826
05,05887,1989-12-31,20246,14873,35119
05,05887,1990-12-31,20575,14796,35371
05,05887,1991-12-31,20868,14677,35545
05,05887,1992-12-31,21226,14589,35815
05,05887,1993-12-31,21554,14491,36045
05,05887,1994-12-31,21873,14376,36249
05,05887,1995-12-31,22165,14279,36444
05,05887,1996-12-31,22490,14175,36665
05,05887,1997-12-31,22792,14141,36933
05,05887,1998-12-31,23095,14045,37140
05,05887,1999-12-31,23432,13958,37390
05,05887,2000-12-31,23749,13867,37616
05,05887,2001-12-31,24059,13784,37843
05,05887,2002-12-31,24338,13669,38007
05,05887,2003-12-31,24617,13556,38173
05,05887,2004-12-31,24899,13463,38362
05,05887,2005-12-31,25172,13364,38536
05,05887,2006-12-31,25447,13284,38731
05,05887,2007-12-31,25718,13205,38923
05,05887,2008-12-31,25983,13100,39083
05,05887,2009-12-31,26267,13022,39289
05,05887,2010-12-31,26534,12957,39491
05,05887,2011-12-31,26807,12874,39681
05,05887,2012-12-31,27092,12776,39868
05,05887,2013-12-31,27374,12696,40070
05,05887,2014-12-31,27629,12588,40217
05,05887,2015-12-31,27898,12520,40418
05,05887,2016-12-31,28216,12475,40691
05,05887,2017-12-31,28570,12459,41029
05,05887,2018-12-31,29049,12493,41542
05,05887,2019-12-31,29942,12174,42116
05,05887,2020-12-31,30827,11851,42678
05,05887,2021-12-31,31625,11715,43340
05,05887,2022-12-31,32330,11679,44009
05,05887,2023-12-31,33019,11677,44696
05,05887,2024-12-31,33655,11684,45339
05,05887,2025-12-31,34233,11718,45951
05,05887,2026-12-31,34759,11771,46530
05,05887,2027-12-31,35261,11837,47098
05,05887,2028-12-31,35723,11905,47628
05,05887,2029-12-31,36153,12012,48165
05,05887,2030-12-31,36535,12130,48665
05,05887,2031-12-31,36886,12276,49162
05,05887,2032-12-31,37228,12394,49622
05,05887,2033-12-31,37548,12519,50067
05,05887,2034-12-31,37851,12643,50494
05,05887,2035-12-31,38149,12771,50920
05,05890,1985-12-31,4906,17333,22239
05,05890,1986-12-31,4975,17376,22351
05,05890,1987-12-31,5036,17338,22374
05,05890,1988-12-31,5093,17295,22388
05,05890,1989-12-31,5160,17246,22406
05,05890,1990-12-31,5227,17183,22410
05,05890,1991-12-31,5302,17111,22413
05,05890,1992-12-31,5335,17037,22372
05,05890,1993-12-31,5408,16972,22380
05,05890,1994-12-31,5454,16889,22343
05,05890,1995-12-31,5499,16821,22320
05,05890,1996-12-31,5579,16745,22324
05,05890,1997-12-31,5634,16728,22362
05,05890,1998-12-31,5689,16674,22363
05,05890,1999-12-31,5750,16628,22378
05,05890,2000-12-31,5800,16556,22356
05,05890,2001-12-31,5861,16493,22354
05,05890,2002-12-31,5914,16440,22354
05,05890,2003-12-31,5966,16347,22313
05,05890,2004-12-31,6024,16272,22296
05,05890,2005-12-31,6074,16186,22260
05,05890,2006-12-31,6121,16120,22241
05,05890,2007-12-31,6176,16036,22212
05,05890,2008-12-31,6223,15965,22188
05,05890,2009-12-31,6280,15937,22217
05,05890,2010-12-31,6335,15900,22235
05,05890,2011-12-31,6378,15855,22233
05,05890,2012-12-31,6437,15782,22219
05,05890,2013-12-31,6481,15733,22214
05,05890,2014-12-31,6522,15668,22190
05,05890,2015-12-31,6573,15636,22209
05,05890,2016-12-31,6639,15639,22278
05,05890,2017-12-31,6701,15644,22345
05,05890,2018-12-31,6768,15770,22538
05,05890,2019-12-31,6930,16120,23050
05,05890,2020-12-31,7104,16397,23501
05,05890,2021-12-31,7658,16212,23870
05,05890,2022-12-31,8077,16162,24239
05,05890,2023-12-31,8457,16160,24617
05,05890,2024-12-31,8632,16182,24814
05,05890,2025-12-31,8766,16221,24987
05,05890,2026-12-31,8900,16290,25190
05,05890,2027-12-31,9028,16367,25395
05,05890,2028-12-31,9146,16492,25638
05,05890,2029-12-31,9254,16628,25882
05,05890,2030-12-31,9345,16792,26137
05,05890,2031-12-31,9438,16970,26408
05,05890,2032-12-31,9540,17167,26707
05,05890,2033-12-31,9620,17345,26965
05,05890,2034-12-31,9709,17530,27239
05,05890,2035-12-31,9781,17695,27476
05,05893,1985-12-31,2290,5098,7388
05,05893,1986-12-31,2518,5257,7775
05,05893,1987-12-31,2750,5420,8170
05,05893,1988-12-31,2966,5533,8499
05,05893,1989-12-31,3177,5659,8836
05,05893,1990-12-31,3408,5790,9198
05,05893,1991-12-31,3623,5939,9562
05,05893,1992-12-31,3851,6061,9912
05,05893,1993-12-31,4079,6193,10272
05,05893,1994-12-31,4311,6321,10632
05,05893,1995-12-31,4541,6459,11000
05,05893,1996-12-31,4763,6552,11315
05,05893,1997-12-31,4989,6739,11728
05,05893,1998-12-31,5212,6829,12041
05,05893,1999-12-31,5448,6965,12413
05,05893,2000-12-31,5688,7090,12778
05,05893,2001-12-31,5897,7218,13115
05,05893,2002-12-31,6141,7319,13460
05,05893,2003-12-31,6355,7449,13804
05,05893,2004-12-31,6578,7576,14154
05,05893,2005-12-31,6767,7692,14459
05,05893,2006-12-31,7005,7805,14810
05,05893,2007-12-31,7217,7899,15116
05,05893,2008-12-31,7437,8059,15496
05,05893,2009-12-31,7655,8214,15869
05,05893,2010-12-31,7863,8295,16158
05,05893,2011-12-31,8081,8427,16508
05,05893,2012-12-31,8314,8556,16870
05,05893,2013-12-31,8483,8697,17180
05,05893,2014-12-31,8668,8828,17496
05,05893,2015-12-31,8886,8927,17813
05,05893,2016-12-31,9145,9059,18204
05,05893,2017-12-31,9350,9260,18610
05,05893,2018-12-31,9640,9400,19040
05,05893,2019-12-31,10130,9494,19624
05,05893,2020-12-31,10571,9539,20110
05,05893,2021-12-31,10995,9431,20426
05,05893,2022-12-31,11339,9402,20741
05,05893,2023-12-31,11664,9401,21065
05,05893,2024-12-31,11886,9419,21305
05,05893,2025-12-31,12091,9438,21529
05,05893,2026-12-31,12281,9469,21750
05,05893,2027-12-31,12456,9521,21977
05,05893,2028-12-31,12629,9585,22214
05,05893,2029-12-31,12763,9673,22436
05,05893,2030-12-31,12888,9781,22669
05,05893,2031-12-31,13017,9888,22905
05,05893,2032-12-31,13144,9978,23122
05,05893,2033-12-31,13265,10077,23342
05,05893,2034-12-31,13375,10175,23550
05,05893,2035-12-31,13489,10277,23766
05,05895,1985-12-31,11657,10455,22112
05,05895,1986-12-31,11634,10607,22241
05,05895,1987-12-31,11623,10710,22333
05,05895,1988-12-31,11646,10804,22450
05,05895,1989-12-31,11665,10905,22570
05,05895,1990-12-31,11672,11004,22676
05,05895,1991-12-31,11662,11083,22745
05,05895,1992-12-31,11663,11156,22819
05,05895,1993-12-31,11657,11240,22897
05,05895,1994-12-31,11650,11316,22966
05,05895,1995-12-31,11644,11394,23038
05,05895,1996-12-31,11637,11466,23103
05,05895,1997-12-31,11611,11599,23210
05,05895,1998-12-31,11606,11682,23288
05,05895,1999-12-31,11594,11760,23354
05,05895,2000-12-31,11586,11858,23444
05,05895,2001-12-31,11556,11924,23480
05,05895,2002-12-31,11539,12010,23549
05,05895,2003-12-31,11517,12092,23609
05,05895,2004-12-31,11491,12151,23642
05,05895,2005-12-31,11459,12229,23688
05,05895,2006-12-31,11413,12315,23728
05,05895,2007-12-31,11372,12389,23761
05,05895,2008-12-31,11354,12468,23822
05,05895,2009-12-31,11335,12555,23890
05,05895,2010-12-31,11302,12656,23958
05,05895,2011-12-31,11279,12736,24015
05,05895,2012-12-31,11222,12810,24032
05,05895,2013-12-31,11147,12895,24042
05,05895,2014-12-31,11126,12960,24086
05,05895,2015-12-31,11106,13039,24145
05,05895,2016-12-31,11080,13153,24233
05,05895,2017-12-31,11109,13321,24430
05,05895,2018-12-31,11173,13478,24651
05,05895,2019-12-31,11606,13604,25210
05,05895,2020-12-31,12012,13691,25703
05,05895,2021-12-31,12570,13536,26106
05,05895,2022-12-31,13015,13495,26510
05,05895,2023-12-31,13431,13493,26924
05,05895,2024-12-31,13694,13510,27204
05,05895,2025-12-31,13923,13542,27465
05,05895,2026-12-31,14136,13597,27733
05,05895,2027-12-31,14344,13662,28006
05,05895,2028-12-31,14525,13758,28283
05,05895,2029-12-31,14702,13875,28577
05,05895,2030-12-31,14854,14008,28862
05,05895,2031-12-31,14997,14157,29154
05,05895,2032-12-31,15132,14324,29456
05,05895,2033-12-31,15264,14480,29744
05,05895,2034-12-31,15389,14627,30016
05,05895,2035-12-31,15507,14779,30286
08,08001,1985-12-31,830657,3262,833919
08,08001,1986-12-31,846793,3226,850019
08,08001,1987-12-31,862702,3223,865925
08,08001,1988-12-31,878342,3181,881523
08,08001,1989-12-31,893696,3145,896841
08,08001,1990-12-31,908658,3102,911760
08,08001,1991-12-31,923420,3038,926458
08,08001,1992-12-31,938185,3018,941203
08,08001,1993-12-31,953585,2939,956524
08,08001,1994-12-31,967385,2878,970263
08,08001,1995-12-31,980714,2791,983505
08,08001,1996-12-31,993549,2713,996262
08,08001,1997-12-31,1005955,2618,1008573
08,08001,1998-12-31,1018028,2521,1020549
08,08001,1999-12-31,1029790,2415,1032205
08,08001,2000-12-31,1041015,2312,1043327
08,08001,2001-12-31,1051667,2232,1053899
08,08001,2002-12-31,1061719,2158,1063877
08,08001,2003-12-31,1071158,1988,1073146
08,08001,2004-12-31,1080143,1918,1082061
08,08001,2005-12-31,1089069,1866,1090935
08,08001,2006-12-31,1097127,1809,1098936
08,08001,2007-12-31,1105010,1744,1106754
08,08001,2008-12-31,1112412,1678,1114090
08,08001,2009-12-31,1119605,1616,1121221
08,08001,2010-12-31,1126487,1551,1128038
08,08001,2011-12-31,1132927,1493,1134420
08,08001,2012-12-31,1138925,1420,1140345
08,08001,2013-12-31,1144826,1360,1146186
08,08001,2014-12-31,1150526,1337,1151863
08,08001,2015-12-31,1156825,1226,1158051
08,08001,2016-12-31,1166409,1146,1167555
08,08001,2017-12-31,1179786,1074,1180860
08,08001,2018-12-31,1205284,1035,1206319
08,08001,2019-12-31,1242237,819,1243056
08,08001,2020-12-31,1273646,604,1274250
08,08001,2021-12-31,1296471,611,1297082
08,08001,2022-12-31,1311856,617,1312473
08,08001,2023-12-31,1326588,621,1327209
08,08001,2024-12-31,1341160,625,1341785
08,08001,2025-12-31,1354676,630,1355306
08,08001,2026-12-31,1367674,638,1368312
08,08001,2027-12-31,1380190,647,1380837
08,08001,2028-12-31,1392150,655,1392805
08,08001,2029-12-31,1403601,659,1404260
08,08001,2030-12-31,1414452,670,1415122
08,08001,2031-12-31,1424853,672,1425525
08,08001,2032-12-31,1434764,682,1435446
08,08001,2033-12-31,1444201,691,1444892
08,08001,2034-12-31,1453100,699,1453799
08,08001,2035-12-31,1461534,718,1462252
08,08078,1985-12-31,25408,6678,32086
08,08078,1986-12-31,26334,6937,33271
08,08078,1987-12-31,27273,7111,34384
08,08078,1988-12-31,28198,7343,35541
08,08078,1989-12-31,29116,7561,36677
08,08078,1990-12-31,30007,7763,37770
08,08078,1991-12-31,30923,7945,38868
08,08078,1992-12-31,31891,8142,40033
08,08078,1993-12-31,32827,8326,41153
08,08078,1994-12-31,33720,8453,42173
08,08078,1995-12-31,34582,8601,43183
08,08078,1996-12-31,35441,8688,44129
08,08078,1997-12-31,36306,8765,45071
08,08078,1998-12-31,37131,8810,45941
08,08078,1999-12-31,37965,8832,46797
08,08078,2000-12-31,38771,8868,47639
08,08078,2001-12-31,39557,8885,48442
08,08078,2002-12-31,40320,8900,49220
08,08078,2003-12-31,41032,8949,49981
08,08078,2004-12-31,41757,9006,50763
08,08078,2005-12-31,42469,9079,51548
08,08078,2006-12-31,43191,9095,52286
08,08078,2007-12-31,43835,9158,52993
08,08078,2008-12-31,44498,9269,53767
08,08078,2009-12-31,45134,9393,54527
08,08078,2010-12-31,45826,9505,55331
08,08078,2011-12-31,46381,9619,56000
08,08078,2012-12-31,46957,9714,56671
08,08078,2013-12-31,47520,9827,57347
08,08078,2014-12-31,48099,9936,58035
08,08078,2015-12-31,48688,10059,58747
08,08078,2016-12-31,49423,10199,59622
08,08078,2017-12-31,50313,10363,60676
08,08078,2018-12-31,51730,10652,62382
08,08078,2019-12-31,53911,11038,64949
08,08078,2020-12-31,55697,11353,67050
08,08078,2021-12-31,56768,11496,68264
08,08078,2022-12-31,57504,11571,69075
08,08078,2023-12-31,58186,11665,69851
08,08078,2024-12-31,58863,11763,70626
08,08078,2025-12-31,59474,11873,71347
08,08078,2026-12-31,60063,11994,72057
08,08078,2027-12-31,60630,12127,72757
08,08078,2028-12-31,61148,12274,73422
08,08078,2029-12-31,61663,12433,74096
08,08078,2030-12-31,62145,12593,74738
08,08078,2031-12-31,62610,12784,75394
08,08078,2032-12-31,63049,12969,76018
08,08078,2033-12-31,63457,13146,76603
08,08078,2034-12-31,63863,13327,77190
08,08078,2035-12-31,64233,13517,77750
08,08137,1985-12-31,21402,2046,23448
08,08137,1986-12-31,21496,2108,23604
08,08137,1987-12-31,21576,2127,23703
08,08137,1988-12-31,21632,2222,23854
08,08137,1989-12-31,21689,2246,23935
08,08137,1990-12-31,21714,2318,24032
08,08137,1991-12-31,21771,2361,24132
08,08137,1992-12-31,21836,2402,24238
08,08137,1993-12-31,21884,2452,24336
08,08137,1994-12-31,21861,2483,24344
08,08137,1995-12-31,21856,2503,24359
08,08137,1996-12-31,21843,2500,24343
08,08137,1997-12-31,21797,2558,24355
08,08137,1998-12-31,21774,2546,24320
08,08137,1999-12-31,21721,2525,24246
08,08137,2000-12-31,21662,2535,24197
08,08137,2001-12-31,21595,2548,24143
08,08137,2002-12-31,21510,2572,24082
08,08137,2003-12-31,21425,2560,23985
08,08137,2004-12-31,21322,2534,23856
08,08137,2005-12-31,21211,2561,23772
08,08137,2006-12-31,21106,2576,23682
08,08137,2007-12-31,20993,2613,23606
08,08137,2008-12-31,20853,2661,23514
08,08137,2009-12-31,20726,2676,23402
08,08137,2010-12-31,20608,2681,23289
08,08137,2011-12-31,20431,2687,23118
08,08137,2012-12-31,20259,2688,22947
08,08137,2013-12-31,20162,2696,22858
08,08137,2014-12-31,20007,2716,22723
08,08137,2015-12-31,19843,2756,22599
08,08137,2016-12-31,19761,2794,22555
08,08137,2017-12-31,19765,2839,22604
08,08137,2018-12-31,19961,2918,22879
08,08137,2019-12-31,20134,3096,23230
08,08137,2020-12-31,20311,3256,23567
08,08137,2021-12-31,20691,3298,23989
08,08137,2022-12-31,20955,3319,24274
08,08137,2023-12-31,21200,3346,24546
08,08137,2024-12-31,21461,3359,24820
08,08137,2025-12-31,21687,3401,25088
08,08137,2026-12-31,21877,3435,25312
08,08137,2027-12-31,22095,3470,25565
08,08137,2028-12-31,22288,3512,25800
08,08137,2029-12-31,22467,3562,26029
08,08137,2030-12-31,22647,3613,26260
08,08137,2031-12-31,22817,3663,26480
08,08137,2032-12-31,22968,3721,26689
08,08137,2033-12-31,23125,3769,26894
08,08137,2034-12-31,23259,3833,27092
08,08137,2035-12-31,23385,3869,27254
08,08141,1985-12-31,5268,3298,8566
08,08141,1986-12-31,5484,3377,8861
08,08141,1987-12-31,5718,3447,9165
08,08141,1988-12-31,5954,3504,9458
08,08141,1989-12-31,6143,3618,9761
08,08141,1990-12-31,6360,3684,10044
08,08141,1991-12-31,6564,3763,10327
08,08141,1992-12-31,6744,3840,10584
08,08141,1993-12-31,6976,3888,10864
08,08141,1994-12-31,7175,3936,11111
08,08141,1995-12-31,7373,3966,11339
08,08141,1996-12-31,7575,3991,11566
08,08141,1997-12-31,7782,4011,11793
08,08141,1998-12-31,7984,3998,11982
08,08141,1999-12-31,8166,4015,12181
08,08141,2000-12-31,8352,4010,12362
08,08141,2001-12-31,8534,3985,12519
08,08141,2002-12-31,8722,3982,12704
08,08141,2003-12-31,8910,4014,12924
08,08141,2004-12-31,9075,3988,13063
08,08141,2005-12-31,9249,3993,13242
08,08141,2006-12-31,9425,4035,13460
08,08141,2007-12-31,9555,4066,13621
08,08141,2008-12-31,9722,4120,13842
08,08141,2009-12-31,9859,4111,13970
08,08141,2010-12-31,10032,4140,14172
08,08141,2011-12-31,10195,4165,14360
08,08141,2012-12-31,10362,4174,14536
08,08141,2013-12-31,10492,4198,14690
08,08141,2014-12-31,10626,4243,14869
08,08141,2015-12-31,10758,4277,15035
08,08141,2016-12-31,10933,4321,15254
08,08141,2017-12-31,11147,4396,15543
08,08141,2018-12-31,11461,4521,15982
08,08141,2019-12-31,11936,4712,16648
08,08141,2020-12-31,12325,4870,17195
08,08141,2021-12-31,12574,4932,17506
08,08141,2022-12-31,12749,4965,17714
08,08141,2023-12-31,12908,5005,17913
08,08141,2024-12-31,13067,5050,18117
08,08141,2025-12-31,13200,5097,18297
08,08141,2026-12-31,13338,5150,18488
08,08141,2027-12-31,13461,5195,18656
08,08141,2028-12-31,13576,5269,18845
08,08141,2029-12-31,13683,5330,19013
08,08141,2030-12-31,13799,5408,19207
08,08141,2031-12-31,13898,5487,19385
08,08141,2032-12-31,14004,5561,19565
08,08141,2033-12-31,14083,5630,19713
08,08141,2034-12-31,14169,5714,19883
08,08141,2035-12-31,14262,5796,20058
08,08296,1985-12-31,12232,849,13081
08,08296,1986-12-31,13599,966,14565
08,08296,1987-12-31,14969,1093,16062
08,08296,1988-12-31,16365,1233,17598
08,08296,1989-12-31,17757,1379,19136
08,08296,1990-12-31,19154,1511,20665
08,08296,1991-12-31,20556,1648,22204
08,08296,1992-12-31,22021,1771,23792
08,08296,1993-12-31,23444,1936,25380
08,08296,1994-12-31,24835,2037,26872
08,08296,1995-12-31,26259,2162,28421
08,08296,1996-12-31,27665,2279,29944
08,08296,1997-12-31,29049,2377,31426
08,08296,1998-12-31,30436,2474,32910
08,08296,1999-12-31,31805,2561,34366
08,08296,2000-12-31,33188,2653,35841
08,08296,2001-12-31,34531,2745,37276
08,08296,2002-12-31,35859,2838,38697
08,08296,2003-12-31,37177,2941,40118
08,08296,2004-12-31,38447,2994,41441
08,08296,2005-12-31,39728,3079,42807
08,08296,2006-12-31,40971,3197,44168
08,08296,2007-12-31,42236,3312,45548
08,08296,2008-12-31,43426,3427,46853
08,08296,2009-12-31,44629,3514,48143
08,08296,2010-12-31,45831,3609,49440
08,08296,2011-12-31,47014,3699,50713
08,08296,2012-12-31,48091,3776,51867
08,08296,2013-12-31,49221,3896,53117
08,08296,2014-12-31,50321,3999,54320
08,08296,2015-12-31,51435,4100,55535
08,08296,2016-12-31,52710,4236,56946
08,08296,2017-12-31,54145,4348,58493
08,08296,2018-12-31,56167,4541,60708
08,08296,2019-12-31,59530,4730,64260
08,08296,2020-12-31,62159,4862,67021
08,08296,2021-12-31,63311,4924,68235
08,08296,2022-12-31,64088,4957,69045
08,08296,2023-12-31,64823,4997,69820
08,08296,2024-12-31,65526,5040,70566
08,08296,2025-12-31,66176,5090,71266
08,08296,2026-12-31,66817,5133,71950
08,08296,2027-12-31,67433,5191,72624
08,08296,2028-12-31,68012,5251,73263
08,08296,2029-12-31,68572,5324,73896
08,08296,2030-12-31,69110,5407,74517
08,08296,2031-12-31,69620,5468,75088
08,08296,2032-12-31,70120,5544,75664
08,08296,2033-12-31,70580,5627,76207
08,08296,2034-12-31,71017,5697,76714
08,08296,2035-12-31,71446,5774,77220
08,08372,1985-12-31,4723,4506,9229
08,08372,1986-12-31,5009,4672,9681
08,08372,1987-12-31,5275,4854,10129
08,08372,1988-12-31,5550,5001,10551
08,08372,1989-12-31,5829,5168,10997
08,08372,1990-12-31,6128,5325,11453
08,08372,1991-12-31,6383,5494,11877
08,08372,1992-12-31,6627,5648,12275
08,08372,1993-12-31,6932,5786,12718
08,08372,1994-12-31,7218,5914,13132
08,08372,1995-12-31,7484,6018,13502
08,08372,1996-12-31,7738,6108,13846
08,08372,1997-12-31,8009,6179,14188
08,08372,1998-12-31,8267,6234,14501
08,08372,1999-12-31,8547,6288,14835
08,08372,2000-12-31,8809,6312,15121
08,08372,2001-12-31,9066,6319,15385
08,08372,2002-12-31,9302,6361,15663
08,08372,2003-12-31,9549,6407,15956
08,08372,2004-12-31,9794,6469,16263
08,08372,2005-12-31,10029,6528,16557
08,08372,2006-12-31,10263,6610,16873
08,08372,2007-12-31,10475,6699,17174
08,08372,2008-12-31,10701,6762,17463
08,08372,2009-12-31,10938,6839,17777
08,08372,2010-12-31,11109,6936,18045
08,08372,2011-12-31,11369,7037,18406
08,08372,2012-12-31,11609,7139,18748
08,08372,2013-12-31,11746,7247,18993
08,08372,2014-12-31,11978,7345,19323
08,08372,2015-12-31,12153,7441,19594
08,08372,2016-12-31,12392,7531,19923
08,08372,2017-12-31,12688,7678,20366
08,08372,2018-12-31,13095,7904,20999
08,08372,2019-12-31,13742,8229,21971
08,08372,2020-12-31,14260,8492,22752
08,08372,2021-12-31,14563,8601,23164
08,08372,2022-12-31,14782,8657,23439
08,08372,2023-12-31,14974,8728,23702
08,08372,2024-12-31,15160,8790,23950
08,08372,2025-12-31,15328,8869,24197
08,08372,2026-12-31,15489,8961,24450
08,08372,2027-12-31,15633,9064,24697
08,08372,2028-12-31,15780,9167,24947
08,08372,2029-12-31,15903,9283,25186
08,08372,2030-12-31,16035,9416,25451
08,08372,2031-12-31,16153,9544,25697
08,08372,2032-12-31,16263,9688,25951
08,08372,2033-12-31,16371,9819,26190
08,08372,2034-12-31,16490,9965,26455
08,08372,2035-12-31,16571,10095,26666
08,08421,1985-12-31,6962,10122,17084
08,08421,1986-12-31,7221,10397,17618
08,08421,1987-12-31,7477,10652,18129
08,08421,1988-12-31,7720,10911,18631
08,08421,1989-12-31,8003,11165,19168
08,08421,1990-12-31,8252,11394,19646
08,08421,1991-12-31,8507,11603,20110
08,08421,1992-12-31,8727,11825,20552
08,08421,1993-12-31,9012,12023,21035
08,08421,1994-12-31,9247,12163,21410
08,08421,1995-12-31,9499,12286,21785
08,08421,1996-12-31,9737,12353,22090
08,08421,1997-12-31,9970,12398,22368
08,08421,1998-12-31,10209,12400,22609
08,08421,1999-12-31,10433,12357,22790
08,08421,2000-12-31,10658,12342,23000
08,08421,2001-12-31,10871,12332,23203
08,08421,2002-12-31,11087,12295,23382
08,08421,2003-12-31,11291,12324,23615
08,08421,2004-12-31,11487,12332,23819
08,08421,2005-12-31,11690,12376,24066
08,08421,2006-12-31,11875,12405,24280
08,08421,2007-12-31,12065,12435,24500
08,08421,2008-12-31,12236,12543,24779
08,08421,2009-12-31,12430,12616,25046
08,08421,2010-12-31,12603,12741,25344
08,08421,2011-12-31,12752,12854,25606
08,08421,2012-12-31,12955,12935,25890
08,08421,2013-12-31,13068,13075,26143
08,08421,2014-12-31,13218,13141,26359
08,08421,2015-12-31,13417,13240,26657
08,08421,2016-12-31,13623,13424,27047
08,08421,2017-12-31,13853,13602,27455
08,08421,2018-12-31,14251,13924,28175
08,08421,2019-12-31,14846,14502,29348
08,08421,2020-12-31,15333,14981,30314
08,08421,2021-12-31,15690,15173,30863
08,08421,2022-12-31,15957,15273,31230
08,08421,2023-12-31,16183,15397,31580
08,08421,2024-12-31,16373,15538,31911
08,08421,2025-12-31,16539,15654,32193
08,08421,2026-12-31,16702,15823,32525
08,08421,2027-12-31,16859,15997,32856
08,08421,2028-12-31,17004,16184,33188
08,08421,2029-12-31,17140,16403,33543
08,08421,2030-12-31,17267,16609,33876
08,08421,2031-12-31,17398,16868,34266
08,08421,2032-12-31,17526,17098,34624
08,08421,2033-12-31,17637,17341,34978
08,08421,2034-12-31,17750,17576,35326
08,08421,2035-12-31,17870,17827,35697
08,08433,1985-12-31,45535,3663,49198
08,08433,1986-12-31,48000,3858,51858
08,08433,1987-12-31,50474,4050,54524
08,08433,1988-12-31,52970,4248,57218
08,08433,1989-12-31,55431,4474,59905
08,08433,1990-12-31,57898,4655,62553
08,08433,1991-12-31,60374,4838,65212
08,08433,1992-12-31,62914,5033,67947
08,08433,1993-12-31,65454,5210,70664
08,08433,1994-12-31,67909,5393,73302
08,08433,1995-12-31,70338,5531,75869
08,08433,1996-12-31,72734,5678,78412
08,08433,1997-12-31,75111,5781,80892
08,08433,1998-12-31,77477,5873,83350
08,08433,1999-12-31,79805,5962,85767
08,08433,2000-12-31,82098,5998,88096
08,08433,2001-12-31,84350,6079,90429
08,08433,2002-12-31,86546,6156,92702
08,08433,2003-12-31,88700,6241,94941
08,08433,2004-12-31,90802,6357,97159
08,08433,2005-12-31,92896,6447,99343
08,08433,2006-12-31,94931,6590,101521
08,08433,2007-12-31,96936,6676,103612
08,08433,2008-12-31,98896,6815,105711
08,08433,2009-12-31,100808,6952,107760
08,08433,2010-12-31,102701,7070,109771
08,08433,2011-12-31,104528,7206,111734
08,08433,2012-12-31,106308,7341,113649
08,08433,2013-12-31,108080,7460,115540
08,08433,2014-12-31,109831,7580,117411
08,08433,2015-12-31,111606,7723,119329
08,08433,2016-12-31,113699,7890,121589
08,08433,2017-12-31,116176,8075,124251
08,08433,2018-12-31,119878,8325,128203
08,08433,2019-12-31,125521,8947,134468
08,08433,2020-12-31,130135,9431,139566
08,08433,2021-12-31,132543,9552,142095
08,08433,2022-12-31,134166,9615,143781
08,08433,2023-12-31,135703,9693,145396
08,08433,2024-12-31,137213,9778,146991
08,08433,2025-12-31,138600,9872,148472
08,08433,2026-12-31,139964,9968,149932
08,08433,2027-12-31,141234,10075,151309
08,08433,2028-12-31,142482,10203,152685
08,08433,2029-12-31,143651,10317,153968
08,08433,2030-12-31,144785,10458,155243
08,08433,2031-12-31,145829,10609,156438
08,08433,2032-12-31,146864,10761,157625
08,08433,2033-12-31,147840,10909,158749
08,08433,2034-12-31,148754,11064,159818
08,08433,2035-12-31,149613,11224,160837
08,08436,1985-12-31,13922,456,14378
08,08436,1986-12-31,14121,527,14648
08,08436,1987-12-31,14315,589,14904
08,08436,1988-12-31,14490,663,15153
08,08436,1989-12-31,14652,734,15386
08,08436,1990-12-31,14864,795,15659
08,08436,1991-12-31,15019,871,15890
08,08436,1992-12-31,15158,945,16103
08,08436,1993-12-31,15321,997,16318
08,08436,1994-12-31,15488,1065,16553
08,08436,1995-12-31,15618,1124,16742
08,08436,1996-12-31,15754,1171,16925
08,08436,1997-12-31,15898,1249,17147
08,08436,1998-12-31,15964,1287,17251
08,08436,1999-12-31,16091,1332,17423
08,08436,2000-12-31,16196,1371,17567
08,08436,2001-12-31,16288,1408,17696
08,08436,2002-12-31,16357,1445,17802
08,08436,2003-12-31,16447,1453,17900
08,08436,2004-12-31,16509,1528,18037
08,08436,2005-12-31,16577,1579,18156
08,08436,2006-12-31,16660,1611,18271
08,08436,2007-12-31,16696,1680,18376
08,08436,2008-12-31,16748,1763,18511
08,08436,2009-12-31,16798,1834,18632
08,08436,2010-12-31,16854,1885,18739
08,08436,2011-12-31,16848,1943,18791
08,08436,2012-12-31,16889,2005,18894
08,08436,2013-12-31,16907,2038,18945
08,08436,2014-12-31,16940,2075,19015
08,08436,2015-12-31,16964,2116,19080
08,08436,2016-12-31,17051,2157,19208
08,08436,2017-12-31,17193,2233,19426
08,08436,2018-12-31,17499,2309,19808
08,08436,2019-12-31,18223,2475,20698
08,08436,2020-12-31,18815,2627,21442
08,08436,2021-12-31,19169,2661,21830
08,08436,2022-12-31,19412,2678,22090
08,08436,2023-12-31,19638,2700,22338
08,08436,2024-12-31,19863,2718,22581
08,08436,2025-12-31,20059,2750,22809
08,08436,2026-12-31,20271,2775,23046
08,08436,2027-12-31,20450,2812,23262
08,08436,2028-12-31,20640,2839,23479
08,08436,2029-12-31,20815,2878,23693
08,08436,2030-12-31,20970,2915,23885
08,08436,2031-12-31,21135,2955,24090
08,08436,2032-12-31,21289,2999,24288
08,08436,2033-12-31,21430,3043,24473
08,08436,2034-12-31,21572,3079,24651
08,08436,2035-12-31,21695,3125,24820
08,08520,1985-12-31,12572,698,13270
08,08520,1986-12-31,13070,729,13799
08,08520,1987-12-31,13623,756,14379
08,08520,1988-12-31,14147,769,14916
08,08520,1989-12-31,14659,783,15442
08,08520,1990-12-31,15185,816,16001
08,08520,1991-12-31,15709,844,16553
08,08520,1992-12-31,16228,860,17088
08,08520,1993-12-31,16752,908,17660
08,08520,1994-12-31,17271,919,18190
08,08520,1995-12-31,17764,936,18700
08,08520,1996-12-31,18266,932,19198
08,08520,1997-12-31,18730,986,19716
08,08520,1998-12-31,19225,982,20207
08,08520,1999-12-31,19712,990,20702
08,08520,2000-12-31,20178,943,21121
08,08520,2001-12-31,20639,917,21556
08,08520,2002-12-31,21062,942,22004
08,08520,2003-12-31,21491,958,22449
08,08520,2004-12-31,21921,980,22901
08,08520,2005-12-31,22355,995,23350
08,08520,2006-12-31,22725,990,23715
08,08520,2007-12-31,23142,1003,24145
08,08520,2008-12-31,23523,1019,24542
08,08520,2009-12-31,23882,1026,24908
08,08520,2010-12-31,24290,1042,25332
08,08520,2011-12-31,24646,1059,25705
08,08520,2012-12-31,24942,1081,26023
08,08520,2013-12-31,25304,1096,26400
08,08520,2014-12-31,25639,1108,26747
08,08520,2015-12-31,26028,1130,27158
08,08520,2016-12-31,26417,1144,27561
08,08520,2017-12-31,26941,1172,28113
08,08520,2018-12-31,27728,1204,28932
08,08520,2019-12-31,28861,1233,30094
08,08520,2020-12-31,29786,1252,31038
08,08520,2021-12-31,30326,1268,31594
08,08520,2022-12-31,30693,1276,31969
08,08520,2023-12-31,31041,1287,32328
08,08520,2024-12-31,31352,1286,32638
08,08520,2025-12-31,31689,1304,32993
08,08520,2026-12-31,31974,1316,33290
08,08520,2027-12-31,32267,1338,33605
08,08520,2028-12-31,32553,1351,33904
08,08520,2029-12-31,32820,1359,34179
08,08520,2030-12-31,33075,1379,34454
08,08520,2031-12-31,33317,1403,34720
08,08520,2032-12-31,33563,1423,34986
08,08520,2033-12-31,33769,1450,35219
08,08520,2034-12-31,33979,1464,35443
08,08520,2035-12-31,34186,1486,35672
08,08549,1985-12-31,1441,2077,3518
08,08549,1986-12-31,1516,2151,3667
08,08549,1987-12-31,1559,2232,3791
08,08549,1988-12-31,1608,2299,3907
08,08549,1989-12-31,1647,2413,4060
08,08549,1990-12-31,1683,2479,4162
08,08549,1991-12-31,1726,2566,4292
08,08549,1992-12-31,1769,2647,4416
08,08549,1993-12-31,1819,2736,4555
08,08549,1994-12-31,1845,2793,4638
08,08549,1995-12-31,1887,2862,4749
08,08549,1996-12-31,1931,2899,4830
08,08549,1997-12-31,1962,2916,4878
08,08549,1998-12-31,2014,2945,4959
08,08549,1999-12-31,2056,2980,5036
08,08549,2000-12-31,2107,3006,5113
08,08549,2001-12-31,2156,3002,5158
08,08549,2002-12-31,2213,3021,5234
08,08549,2003-12-31,2241,3063,5304
08,08549,2004-12-31,2271,3052,5323
08,08549,2005-12-31,2312,3089,5401
08,08549,2006-12-31,2343,3135,5478
08,08549,2007-12-31,2373,3190,5563
08,08549,2008-12-31,2408,3239,5647
08,08549,2009-12-31,2469,3297,5766
08,08549,2010-12-31,2521,3353,5874
08,08549,2011-12-31,2561,3382,5943
08,08549,2012-12-31,2590,3399,5989
08,08549,2013-12-31,2611,3451,6062
08,08549,2014-12-31,2635,3491,6126
08,08549,2015-12-31,2659,3542,6201
08,08549,2016-12-31,2700,3595,6295
08,08549,2017-12-31,2745,3670,6415
08,08549,2018-12-31,2812,3796,6608
08,08549,2019-12-31,2928,3945,6873
08,08549,2020-12-31,3022,4067,7089
08,08549,2021-12-31,3097,4119,7216
08,08549,2022-12-31,3156,4146,7302
08,08549,2023-12-31,3204,4180,7384
08,08549,2024-12-31,3242,4213,7455
08,08549,2025-12-31,3275,4257,7532
08,08549,2026-12-31,3308,4295,7603
08,08549,2027-12-31,3333,4343,7676
08,08549,2028-12-31,3365,4393,7758
08,08549,2029-12-31,3390,4454,7844
08,08549,2030-12-31,3418,4509,7927
08,08549,2031-12-31,3449,4574,8023
08,08549,2032-12-31,3465,4632,8097
08,08549,2033-12-31,3488,4714,8202
08,08549,2034-12-31,3515,4772,8287
08,08549,2035-12-31,3535,4844,8379
08,08558,1985-12-31,7406,1918,9324
08,08558,1986-12-31,7676,1969,9645
08,08558,1987-12-31,7953,2005,9958
08,08558,1988-12-31,8208,2077,10285
08,08558,1989-12-31,8504,2145,10649
08,08558,1990-12-31,8765,2198,10963
08,08558,1991-12-31,9046,2263,11309
08,08558,1992-12-31,9264,2317,11581
08,08558,1993-12-31,9576,2377,11953
08,08558,1994-12-31,9821,2408,12229
08,08558,1995-12-31,10090,2434,12524
08,08558,1996-12-31,10355,2509,12864
08,08558,1997-12-31,10593,2522,13115
08,08558,1998-12-31,10831,2540,13371
08,08558,1999-12-31,11060,2525,13585
08,08558,2000-12-31,11309,2549,13858
08,08558,2001-12-31,11540,2560,14100
08,08558,2002-12-31,11748,2582,14330
08,08558,2003-12-31,11972,2567,14539
08,08558,2004-12-31,12201,2555,14756
08,08558,2005-12-31,12401,2596,14997
08,08558,2006-12-31,12604,2652,15256
08,08558,2007-12-31,12813,2700,15513
08,08558,2008-12-31,12987,2725,15712
08,08558,2009-12-31,13193,2745,15938
08,08558,2010-12-31,13381,2781,16162
08,08558,2011-12-31,13528,2810,16338
08,08558,2012-12-31,13755,2799,16554
08,08558,2013-12-31,13861,2811,16672
08,08558,2014-12-31,14055,2841,16896
08,08558,2015-12-31,14213,2877,17090
08,08558,2016-12-31,14432,2939,17371
08,08558,2017-12-31,14688,3010,17698
08,08558,2018-12-31,15111,3086,18197
08,08558,2019-12-31,15736,3205,18941
08,08558,2020-12-31,16247,3298,19545
08,08558,2021-12-31,16559,3340,19899
08,08558,2022-12-31,16773,3362,20135
08,08558,2023-12-31,16971,3390,20361
08,08558,2024-12-31,17168,3419,20587
08,08558,2025-12-31,17333,3457,20790
08,08558,2026-12-31,17513,3489,21002
08,08558,2027-12-31,17669,3522,21191
08,08558,2028-12-31,17824,3571,21395
08,08558,2029-12-31,17972,3613,21585
08,08558,2030-12-31,18106,3665,21771
08,08558,2031-12-31,18246,3723,21969
08,08558,2032-12-31,18366,3767,22133
08,08558,2033-12-31,18487,3825,22312
08,08558,2034-12-31,18604,3873,22477
08,08558,2035-12-31,18707,3922,22629
08,08560,1985-12-31,6498,6435,12933
08,08560,1986-12-31,6741,6625,13366
08,08560,1987-12-31,6991,6851,13842
08,08560,1988-12-31,7239,7067,14306
08,08560,1989-12-31,7508,7256,14764
08,08560,1990-12-31,7743,7456,15199
08,08560,1991-12-31,7998,7634,15632
08,08560,1992-12-31,8206,7816,16022
08,08560,1993-12-31,8494,7984,16478
08,08560,1994-12-31,8713,8143,16856
08,08560,1995-12-31,8956,8246,17202
08,08560,1996-12-31,9189,8359,17548
08,08560,1997-12-31,9438,8407,17845
08,08560,1998-12-31,9662,8446,18108
08,08560,1999-12-31,9887,8474,18361
08,08560,2000-12-31,10100,8490,18590
08,08560,2001-12-31,10310,8493,18803
08,08560,2002-12-31,10523,8512,19035
08,08560,2003-12-31,10731,8568,19299
08,08560,2004-12-31,10919,8627,19546
08,08560,2005-12-31,11112,8675,19787
08,08560,2006-12-31,11316,8754,20070
08,08560,2007-12-31,11500,8799,20299
08,08560,2008-12-31,11680,8890,20570
08,08560,2009-12-31,11867,9013,20880
08,08560,2010-12-31,12022,9119,21141
08,08560,2011-12-31,12175,9229,21404
08,08560,2012-12-31,12397,9322,21719
08,08560,2013-12-31,12493,9386,21879
08,08560,2014-12-31,12679,9530,22209
08,08560,2015-12-31,12836,9626,22462
08,08560,2016-12-31,13025,9753,22778
08,08560,2017-12-31,13258,9935,23193
08,08560,2018-12-31,13652,10196,23848
08,08560,2019-12-31,14217,10660,24877
08,08560,2020-12-31,14679,11049,25728
08,08560,2021-12-31,15004,11190,26194
08,08560,2022-12-31,15241,11264,26505
08,08560,2023-12-31,15447,11356,26803
08,08560,2024-12-31,15637,11456,27093
08,08560,2025-12-31,15790,11555,27345
08,08560,2026-12-31,15947,11657,27604
08,08560,2027-12-31,16090,11800,27890
08,08560,2028-12-31,16231,11908,28139
08,08560,2029-12-31,16372,12088,28460
08,08560,2030-12-31,16498,12262,28760
08,08560,2031-12-31,16630,12435,29065
08,08560,2032-12-31,16734,12607,29341
08,08560,2033-12-31,16854,12786,29640
08,08560,2034-12-31,16954,12972,29926
08,08560,2035-12-31,17053,13148,30201
08,08573,1985-12-31,11423,6883,18306
08,08573,1986-12-31,12439,6975,19414
08,08573,1987-12-31,13424,7045,20469
08,08573,1988-12-31,14422,7125,21547
08,08573,1989-12-31,15428,7187,22615
08,08573,1990-12-31,16432,7250,23682
08,08573,1991-12-31,17483,7305,24788
08,08573,1992-12-31,18514,7336,25850
08,08573,1993-12-31,19539,7367,26906
08,08573,1994-12-31,20567,7369,27936
08,08573,1995-12-31,21574,7351,28925
08,08573,1996-12-31,22566,7304,29870
08,08573,1997-12-31,23549,7229,30778
08,08573,1998-12-31,24546,7159,31705
08,08573,1999-12-31,25537,7034,32571
08,08573,2000-12-31,26506,6953,33459
08,08573,2001-12-31,27475,6858,34333
08,08573,2002-12-31,28423,6768,35191
08,08573,2003-12-31,29341,6681,36022
08,08573,2004-12-31,30271,6635,36906
08,08573,2005-12-31,31169,6566,37735
08,08573,2006-12-31,32039,6548,38587
08,08573,2007-12-31,32913,6544,39457
08,08573,2008-12-31,33761,6470,40231
08,08573,2009-12-31,34607,6421,41028
08,08573,2010-12-31,35432,6422,41854
08,08573,2011-12-31,36264,6362,42626
08,08573,2012-12-31,37021,6387,43408
08,08573,2013-12-31,37830,6380,44210
08,08573,2014-12-31,38593,6361,44954
08,08573,2015-12-31,39382,6359,45741
08,08573,2016-12-31,40300,6338,46638
08,08573,2017-12-31,41323,6351,47674
08,08573,2018-12-31,42803,6461,49264
08,08573,2019-12-31,45119,6576,51695
08,08573,2020-12-31,46952,6697,53649
08,08573,2021-12-31,47840,6781,54621
08,08573,2022-12-31,48443,6826,55269
08,08573,2023-12-31,49008,6882,55890
08,08573,2024-12-31,49526,6968,56494
08,08573,2025-12-31,50038,7038,57076
08,08573,2026-12-31,50497,7108,57605
08,08573,2027-12-31,50972,7182,58154
08,08573,2028-12-31,51414,7276,58690
08,08573,2029-12-31,51840,7364,59204
08,08573,2030-12-31,52257,7463,59720
08,08573,2031-12-31,52629,7565,60194
08,08573,2032-12-31,52993,7683,60676
08,08573,2033-12-31,53341,7790,61131
08,08573,2034-12-31,53682,7903,61585
08,08573,2035-12-31,54001,8020,62021
08,08606,1985-12-31,9616,6389,16005
08,08606,1986-12-31,9904,6532,16436
08,08606,1987-12-31,10205,6721,16926
08,08606,1988-12-31,10487,6876,17363
08,08606,1989-12-31,10775,7012,17787
08,08606,1990-12-31,11067,7162,18229
08,08606,1991-12-31,11341,7278,18619
08,08606,1992-12-31,11639,7414,19053
08,08606,1993-12-31,11940,7536,19476
08,08606,1994-12-31,12207,7630,19837
08,08606,1995-12-31,12491,7706,20197
08,08606,1996-12-31,12753,7720,20473
08,08606,1997-12-31,13024,7751,20775
08,08606,1998-12-31,13279,7757,21036
08,08606,1999-12-31,13514,7738,21252
08,08606,2000-12-31,13752,7712,21464
08,08606,2001-12-31,13979,7678,21657
08,08606,2002-12-31,14204,7653,21857
08,08606,2003-12-31,14429,7652,22081
08,08606,2004-12-31,14669,7680,22349
08,08606,2005-12-31,14884,7692,22576
08,08606,2006-12-31,15068,7723,22791
08,08606,2007-12-31,15270,7762,23032
08,08606,2008-12-31,15490,7753,23243
08,08606,2009-12-31,15630,7840,23470
08,08606,2010-12-31,15823,7882,23705
08,08606,2011-12-31,15985,7949,23934
08,08606,2012-12-31,16161,8014,24175
08,08606,2013-12-31,16314,8064,24378
08,08606,2014-12-31,16483,8107,24590
08,08606,2015-12-31,16664,8174,24838
08,08606,2016-12-31,16869,8274,25143
08,08606,2017-12-31,17145,8379,25524
08,08606,2018-12-31,17608,8592,26200
08,08606,2019-12-31,18307,8942,27249
08,08606,2020-12-31,18882,9220,28102
08,08606,2021-12-31,19268,9338,28606
08,08606,2022-12-31,19546,9399,28945
08,08606,2023-12-31,19794,9476,29270
08,08606,2024-12-31,20015,9556,29571
08,08606,2025-12-31,20208,9650,29858
08,08606,2026-12-31,20422,9742,30164
08,08606,2027-12-31,20601,9846,30447
08,08606,2028-12-31,20788,9976,30764
08,08606,2029-12-31,20946,10096,31042
08,08606,2030-12-31,21108,10236,31344
08,08606,2031-12-31,21276,10383,31659
08,08606,2032-12-31,21416,10524,31940
08,08606,2033-12-31,21556,10673,32229
08,08606,2034-12-31,21690,10823,32513
08,08606,2035-12-31,21825,10971,32796
08,08634,1985-12-31,11895,859,12754
08,08634,1986-12-31,12508,901,13409
08,08634,1987-12-31,13127,952,14079
08,08634,1988-12-31,13760,983,14743
08,08634,1989-12-31,14394,1016,15410
08,08634,1990-12-31,15030,1053,16083
08,08634,1991-12-31,15667,1081,16748
08,08634,1992-12-31,16298,1108,17406
08,08634,1993-12-31,16923,1101,18024
08,08634,1994-12-31,17556,1151,18707
08,08634,1995-12-31,18178,1200,19378
08,08634,1996-12-31,18773,1225,19998
08,08634,1997-12-31,19397,1230,20627
08,08634,1998-12-31,19985,1241,21226
08,08634,1999-12-31,20580,1252,21832
08,08634,2000-12-31,21177,1252,22429
08,08634,2001-12-31,21747,1230,22977
08,08634,2002-12-31,22302,1203,23505
08,08634,2003-12-31,22850,1216,24066
08,08634,2004-12-31,23362,1280,24642
08,08634,2005-12-31,23912,1288,25200
08,08634,2006-12-31,24426,1300,25726
08,08634,2007-12-31,24912,1310,26222
08,08634,2008-12-31,25427,1344,26771
08,08634,2009-12-31,25894,1368,27262
08,08634,2010-12-31,26392,1387,27779
08,08634,2011-12-31,26855,1412,28267
08,08634,2012-12-31,27255,1441,28696
08,08634,2013-12-31,27776,1457,29233
08,08634,2014-12-31,28166,1469,29635
08,08634,2015-12-31,28630,1487,30117
08,08634,2016-12-31,29186,1519,30705
08,08634,2017-12-31,29817,1556,31373
08,08634,2018-12-31,30739,1595,32334
08,08634,2019-12-31,32229,1629,33858
08,08634,2020-12-31,33437,1647,35084
08,08634,2021-12-31,34052,1668,35720
08,08634,2022-12-31,34465,1679,36144
08,08634,2023-12-31,34857,1692,36549
08,08634,2024-12-31,35211,1702,36913
08,08634,2025-12-31,35567,1720,37287
08,08634,2026-12-31,35909,1739,37648
08,08634,2027-12-31,36233,1759,37992
08,08634,2028-12-31,36560,1771,38331
08,08634,2029-12-31,36856,1787,38643
08,08634,2030-12-31,37146,1816,38962
08,08634,2031-12-31,37411,1852,39263
08,08634,2032-12-31,37686,1883,39569
08,08634,2033-12-31,37942,1908,39850
08,08634,2034-12-31,38171,1936,40107
08,08634,2035-12-31,38393,1962,40355
08,08638,1985-12-31,33196,16135,49331
08,08638,1986-12-31,34461,16630,51091
08,08638,1987-12-31,35721,17117,52838
08,08638,1988-12-31,37016,17583,54599
08,08638,1989-12-31,38251,18044,56295
08,08638,1990-12-31,39485,18466,57951
08,08638,1991-12-31,40716,18870,59586
08,08638,1992-12-31,42016,19287,61303
08,08638,1993-12-31,43298,19670,62968
08,08638,1994-12-31,44506,19953,64459
08,08638,1995-12-31,45710,20216,65926
08,08638,1996-12-31,46882,20377,67259
08,08638,1997-12-31,48032,20477,68509
08,08638,1998-12-31,49183,20545,69728
08,08638,1999-12-31,50296,20542,70838
08,08638,2000-12-31,51417,20560,71977
08,08638,2001-12-31,52481,20546,73027
08,08638,2002-12-31,53531,20564,74095
08,08638,2003-12-31,54554,20672,75226
08,08638,2004-12-31,55538,20716,76254
08,08638,2005-12-31,56522,20825,77347
08,08638,2006-12-31,57471,20920,78391
08,08638,2007-12-31,58407,21069,79476
08,08638,2008-12-31,59292,21281,80573
08,08638,2009-12-31,60180,21502,81682
08,08638,2010-12-31,61054,21727,82781
08,08638,2011-12-31,61901,21925,83826
08,08638,2012-12-31,62659,22126,84785
08,08638,2013-12-31,63492,22338,85830
08,08638,2014-12-31,64274,22548,86822
08,08638,2015-12-31,65084,22790,87874
08,08638,2016-12-31,66101,23087,89188
08,08638,2017-12-31,67308,23461,90769
08,08638,2018-12-31,69230,24031,93261
08,08638,2019-12-31,72224,24781,97005
08,08638,2020-12-31,74713,25336,100049
08,08638,2021-12-31,76188,25655,101843
08,08638,2022-12-31,77226,25824,103050
08,08638,2023-12-31,78172,26035,104207
08,08638,2024-12-31,79096,26301,105397
08,08638,2025-12-31,79939,26523,106462
08,08638,2026-12-31,80763,26797,107560
08,08638,2027-12-31,81529,27081,108610
08,08638,2028-12-31,82255,27406,109661
08,08638,2029-12-31,82958,27769,110727
08,08638,2030-12-31,83619,28157,111776
08,08638,2031-12-31,84251,28542,112793
08,08638,2032-12-31,84851,28958,113809
08,08638,2033-12-31,85408,29351,114759
08,08638,2034-12-31,85966,29754,115720
08,08638,2035-12-31,86462,30167,116629
08,08675,1985-12-31,5878,946,6824
08,08675,1986-12-31,6141,1019,7160
08,08675,1987-12-31,6418,1073,7491
08,08675,1988-12-31,6706,1138,7844
08,08675,1989-12-31,6965,1197,8162
08,08675,1990-12-31,7236,1247,8483
08,08675,1991-12-31,7498,1309,8807
08,08675,1992-12-31,7714,1364,9078
08,08675,1993-12-31,8024,1417,9441
08,08675,1994-12-31,8279,1456,9735
08,08675,1995-12-31,8515,1507,10022
08,08675,1996-12-31,8772,1552,10324
08,08675,1997-12-31,9044,1576,10620
08,08675,1998-12-31,9298,1589,10887
08,08675,1999-12-31,9522,1644,11166
08,08675,2000-12-31,9754,1660,11414
08,08675,2001-12-31,9987,1682,11669
08,08675,2002-12-31,10211,1693,11904
08,08675,2003-12-31,10455,1710,12165
08,08675,2004-12-31,10669,1743,12412
08,08675,2005-12-31,10861,1786,12647
08,08675,2006-12-31,11106,1815,12921
08,08675,2007-12-31,11284,1873,13157
08,08675,2008-12-31,11493,1906,13399
08,08675,2009-12-31,11715,1934,13649
08,08675,2010-12-31,11896,1992,13888
08,08675,2011-12-31,12078,2052,14130
08,08675,2012-12-31,12327,2102,14429
08,08675,2013-12-31,12424,2120,14544
08,08675,2014-12-31,12617,2147,14764
08,08675,2015-12-31,12798,2193,14991
08,08675,2016-12-31,13034,2219,15253
08,08675,2017-12-31,13278,2270,15548
08,08675,2018-12-31,13676,2347,16023
08,08675,2019-12-31,14209,2415,16624
08,08675,2020-12-31,14638,2466,17104
08,08675,2021-12-31,14913,2497,17410
08,08675,2022-12-31,15104,2513,17617
08,08675,2023-12-31,15281,2534,17815
08,08675,2024-12-31,15448,2559,18007
08,08675,2025-12-31,15610,2572,18182
08,08675,2026-12-31,15753,2601,18354
08,08675,2027-12-31,15897,2629,18526
08,08675,2028-12-31,16041,2666,18707
08,08675,2029-12-31,16169,2699,18868
08,08675,2030-12-31,16295,2738,19033
08,08675,2031-12-31,16410,2768,19178
08,08675,2032-12-31,16526,2810,19336
08,08675,2033-12-31,16641,2861,19502
08,08675,2034-12-31,16732,2901,19633
08,08675,2035-12-31,16844,2932,19776
08,08685,1985-12-31,14191,854,15045
08,08685,1986-12-31,14682,887,15569
08,08685,1987-12-31,15192,952,16144
08,08685,1988-12-31,15671,1005,16676
08,08685,1989-12-31,16156,1028,17184
08,08685,1990-12-31,16643,1075,17718
08,08685,1991-12-31,17140,1107,18247
08,08685,1992-12-31,17643,1138,18781
08,08685,1993-12-31,18125,1166,19291
08,08685,1994-12-31,18598,1194,19792
08,08685,1995-12-31,19075,1225,20300
08,08685,1996-12-31,19520,1273,20793
08,08685,1997-12-31,19972,1282,21254
08,08685,1998-12-31,20413,1305,21718
08,08685,1999-12-31,20850,1326,22176
08,08685,2000-12-31,21280,1342,22622
08,08685,2001-12-31,21702,1335,23037
08,08685,2002-12-31,22109,1341,23450
08,08685,2003-12-31,22471,1301,23772
08,08685,2004-12-31,22861,1358,24219
08,08685,2005-12-31,23248,1372,24620
08,08685,2006-12-31,23584,1413,24997
08,08685,2007-12-31,23948,1446,25394
08,08685,2008-12-31,24283,1446,25729
08,08685,2009-12-31,24612,1469,26081
08,08685,2010-12-31,24972,1497,26469
08,08685,2011-12-31,25262,1517,26779
08,08685,2012-12-31,25524,1537,27061
08,08685,2013-12-31,25882,1565,27447
08,08685,2014-12-31,26179,1583,27762
08,08685,2015-12-31,26493,1614,28107
08,08685,2016-12-31,26862,1640,28502
08,08685,2017-12-31,27318,1683,29001
08,08685,2018-12-31,28095,1734,29829
08,08685,2019-12-31,29258,1769,31027
08,08685,2020-12-31,30211,1789,32000
08,08685,2021-12-31,30762,1812,32574
08,08685,2022-12-31,31137,1823,32960
08,08685,2023-12-31,31492,1838,33330
08,08685,2024-12-31,31846,1858,33704
08,08685,2025-12-31,32170,1872,34042
08,08685,2026-12-31,32481,1890,34371
08,08685,2027-12-31,32789,1909,34698
08,08685,2028-12-31,33072,1931,35003
08,08685,2029-12-31,33346,1953,35299
08,08685,2030-12-31,33628,1977,35605
08,08685,2031-12-31,33872,2008,35880
08,08685,2032-12-31,34114,2038,36152
08,08685,2033-12-31,34345,2064,36409
08,08685,2034-12-31,34559,2098,36657
08,08685,2035-12-31,34766,2120,36886
08,08758,1985-12-31,151811,1138,152949
08,08758,1986-12-31,166008,1161,167169
08,08758,1987-12-31,180313,1191,181504
08,08758,1988-12-31,194716,1207,195923
08,08758,1989-12-31,209171,1212,210383
08,08758,1990-12-31,223646,1256,224902
08,08758,1991-12-31,238184,1286,239470
08,08758,1992-12-31,252882,1265,254147
08,08758,1993-12-31,267788,1290,269078
08,08758,1994-12-31,282367,1297,283664
08,08758,1995-12-31,296884,1293,298177
08,08758,1996-12-31,311305,1326,312631
08,08758,1997-12-31,325640,1263,326903
08,08758,1998-12-31,339887,1283,341170
08,08758,1999-12-31,354035,1281,355316
08,08758,2000-12-31,368002,1255,369257
08,08758,2001-12-31,381810,1276,383086
08,08758,2002-12-31,395376,1228,396604
08,08758,2003-12-31,408712,1226,409938
08,08758,2004-12-31,421816,1200,423016
08,08758,2005-12-31,434893,1238,436131
08,08758,2006-12-31,447636,1270,448906
08,08758,2007-12-31,460241,1265,461506
08,08758,2008-12-31,472601,1259,473860
08,08758,2009-12-31,484791,1275,486066
08,08758,2010-12-31,496783,1274,498057
08,08758,2011-12-31,508523,1295,509818
08,08758,2012-12-31,519964,1311,521275
08,08758,2013-12-31,531338,1318,532656
08,08758,2014-12-31,542538,1319,543857
08,08758,2015-12-31,553945,1321,555266
08,08758,2016-12-31,566882,1319,568201
08,08758,2017-12-31,581706,1330,583036
08,08758,2018-12-31,602644,1355,603999
08,08758,2019-12-31,636953,1112,638065
08,08758,2020-12-31,664141,880,665021
08,08758,2021-12-31,676179,891,677070
08,08758,2022-12-31,684209,897,685106
08,08758,2023-12-31,691895,904,692799
08,08758,2024-12-31,698489,900,699389
08,08758,2025-12-31,705540,909,706449
08,08758,2026-12-31,712320,930,713250
08,08758,2027-12-31,718861,936,719797
08,08758,2028-12-31,725111,947,726058
08,08758,2029-12-31,731096,951,732047
08,08758,2030-12-31,736768,966,737734
08,08758,2031-12-31,742226,988,743214
08,08758,2032-12-31,747408,997,748405
08,08758,2033-12-31,752371,1014,753385
08,08758,2034-12-31,757031,1030,758061
08,08758,2035-12-31,761457,1046,762503
08,08770,1985-12-31,8299,528,8827
08,08770,1986-12-31,8438,560,8998
08,08770,1987-12-31,8569,558,9127
08,08770,1988-12-31,8701,569,9270
08,08770,1989-12-31,8838,567,9405
08,08770,1990-12-31,8952,598,9550
08,08770,1991-12-31,9090,628,9718
08,08770,1992-12-31,9181,618,9799
08,08770,1993-12-31,9340,632,9972
08,08770,1994-12-31,9428,668,10096
08,08770,1995-12-31,9545,651,10196
08,08770,1996-12-31,9665,648,10313
08,08770,1997-12-31,9759,634,10393
08,08770,1998-12-31,9845,655,10500
08,08770,1999-12-31,9931,609,10540
08,08770,2000-12-31,10020,592,10612
08,08770,2001-12-31,10095,609,10704
08,08770,2002-12-31,10182,613,10795
08,08770,2003-12-31,10246,606,10852
08,08770,2004-12-31,10329,615,10944
08,08770,2005-12-31,10371,634,11005
08,08770,2006-12-31,10448,635,11083
08,08770,2007-12-31,10467,647,11114
08,08770,2008-12-31,10538,634,11172
08,08770,2009-12-31,10615,650,11265
08,08770,2010-12-31,10605,638,11243
08,08770,2011-12-31,10675,634,11309
08,08770,2012-12-31,10756,636,11392
08,08770,2013-12-31,10777,643,11420
08,08770,2014-12-31,10812,645,11457
08,08770,2015-12-31,10826,658,11484
08,08770,2016-12-31,10894,663,11557
08,08770,2017-12-31,11020,676,11696
08,08770,2018-12-31,11239,701,11940
08,08770,2019-12-31,11518,764,12282
08,08770,2020-12-31,11752,820,12572
08,08770,2021-12-31,11967,830,12797
08,08770,2022-12-31,12113,836,12949
08,08770,2023-12-31,12252,843,13095
08,08770,2024-12-31,12394,840,13234
08,08770,2025-12-31,12520,854,13374
08,08770,2026-12-31,12633,860,13493
08,08770,2027-12-31,12744,868,13612
08,08770,2028-12-31,12872,872,13744
08,08770,2029-12-31,12965,883,13848
08,08770,2030-12-31,13069,898,13967
08,08770,2031-12-31,13163,915,14078
08,08770,2032-12-31,13255,928,14183
08,08770,2033-12-31,13340,941,14281
08,08770,2034-12-31,13422,951,14373
08,08770,2035-12-31,13516,965,14481
08,08832,1985-12-31,3693,2559,6252
08,08832,1986-12-31,3885,2772,6657
08,08832,1987-12-31,4049,3038,7087
08,08832,1988-12-31,4220,3280,7500
08,08832,1989-12-31,4403,3507,7910
08,08832,1990-12-31,4582,3729,8311
08,08832,1991-12-31,4727,3959,8686
08,08832,1992-12-31,4872,4188,9060
08,08832,1993-12-31,5023,4408,9431
08,08832,1994-12-31,5247,4628,9875
08,08832,1995-12-31,5392,4816,10208
08,08832,1996-12-31,5559,4990,10549
08,08832,1997-12-31,5712,5164,10876
08,08832,1998-12-31,5863,5273,11136
08,08832,1999-12-31,6020,5424,11444
08,08832,2000-12-31,6173,5541,11714
08,08832,2001-12-31,6337,5665,12002
08,08832,2002-12-31,6486,5785,12271
08,08832,2003-12-31,6629,5931,12560
08,08832,2004-12-31,6779,6065,12844
08,08832,2005-12-31,6923,6202,13125
08,08832,2006-12-31,7068,6374,13442
08,08832,2007-12-31,7219,6540,13759
08,08832,2008-12-31,7336,6693,14029
08,08832,2009-12-31,7433,6853,14286
08,08832,2010-12-31,7567,7006,14573
08,08832,2011-12-31,7711,7158,14869
08,08832,2012-12-31,7853,7371,15224
08,08832,2013-12-31,8002,7557,15559
08,08832,2014-12-31,8084,7718,15802
08,08832,2015-12-31,8191,7877,16068
08,08832,2016-12-31,8343,8099,16442
08,08832,2017-12-31,8521,8306,16827
08,08832,2018-12-31,8774,8603,17377
08,08832,2019-12-31,9138,9052,18190
08,08832,2020-12-31,9436,9410,18846
08,08832,2021-12-31,9657,9530,19187
08,08832,2022-12-31,9822,9593,19415
08,08832,2023-12-31,9961,9672,19633
08,08832,2024-12-31,10081,9745,19826
08,08832,2025-12-31,10187,9852,20039
08,08832,2026-12-31,10290,9951,20241
08,08832,2027-12-31,10389,10059,20448
08,08832,2028-12-31,10474,10181,20655
08,08832,2029-12-31,10560,10309,20869
08,08832,2030-12-31,10645,10448,21093
08,08832,2031-12-31,10718,10600,21318
08,08832,2032-12-31,10799,10750,21549
08,08832,2033-12-31,10865,10903,21768
08,08832,2034-12-31,10941,11058,21999
08,08832,2035-12-31,10994,11214,22208
08,08849,1985-12-31,5135,329,5464
08,08849,1986-12-31,5350,371,5721
08,08849,1987-12-31,5565,397,5962
08,08849,1988-12-31,5789,399,6188
08,08849,1989-12-31,5985,417,6402
08,08849,1990-12-31,6223,437,6660
08,08849,1991-12-31,6419,478,6897
08,08849,1992-12-31,6613,468,7081
08,08849,1993-12-31,6834,511,7345
08,08849,1994-12-31,7052,545,7597
08,08849,1995-12-31,7259,560,7819
08,08849,1996-12-31,7451,543,7994
08,08849,1997-12-31,7656,564,8220
08,08849,1998-12-31,7867,575,8442
08,08849,1999-12-31,8056,583,8639
08,08849,2000-12-31,8262,575,8837
08,08849,2001-12-31,8450,595,9045
08,08849,2002-12-31,8632,612,9244
08,08849,2003-12-31,8803,624,9427
08,08849,2004-12-31,8983,641,9624
08,08849,2005-12-31,9134,655,9789
08,08849,2006-12-31,9308,651,9959
08,08849,2007-12-31,9481,686,10167
08,08849,2008-12-31,9647,709,10356
08,08849,2009-12-31,9798,717,10515
08,08849,2010-12-31,9912,717,10629
08,08849,2011-12-31,10101,750,10851
08,08849,2012-12-31,10285,799,11084
08,08849,2013-12-31,10413,813,11226
08,08849,2014-12-31,10534,826,11360
08,08849,2015-12-31,10703,830,11533
08,08849,2016-12-31,10882,831,11713
08,08849,2017-12-31,11052,836,11888
08,08849,2018-12-31,11394,856,12250
08,08849,2019-12-31,11865,878,12743
08,08849,2020-12-31,12251,893,13144
08,08849,2021-12-31,12476,904,13380
08,08849,2022-12-31,12628,910,13538
08,08849,2023-12-31,12772,918,13690
08,08849,2024-12-31,12912,922,13834
08,08849,2025-12-31,13039,924,13963
08,08849,2026-12-31,13157,940,14097
08,08849,2027-12-31,13285,950,14235
08,08849,2028-12-31,13399,957,14356
08,08849,2029-12-31,13505,970,14475
08,08849,2030-12-31,13611,989,14600
08,08849,2031-12-31,13720,1000,14720
08,08849,2032-12-31,13806,1011,14817
08,08849,2033-12-31,13896,1020,14916
08,08849,2034-12-31,13982,1040,15022
08,08849,2035-12-31,14066,1055,15121
11,11001,1985-12-31,3796404,8232,3804636
11,11001,1986-12-31,3964247,8594,3972841
11,11001,1987-12-31,4130981,8965,4139946
11,11001,1988-12-31,4297094,9339,4306433
11,11001,1989-12-31,4462125,9716,4471841
11,11001,1990-12-31,4625430,10084,4635514
11,11001,1991-12-31,4787812,10462,4798274
11,11001,1992-12-31,4951180,10842,4962022
11,11001,1993-12-31,5126977,11256,5138233
11,11001,1994-12-31,5285066,11642,5296708
11,11001,1995-12-31,5443783,12036,5455819
11,11001,1996-12-31,5601765,12438,5614203
11,11001,1997-12-31,5755891,12847,5768738
11,11001,1998-12-31,5902975,13255,5916230
11,11001,1999-12-31,6041648,13655,6055303
11,11001,2000-12-31,6170826,14054,6184880
11,11001,2001-12-31,6289891,14471,6304362
11,11001,2002-12-31,6400030,14874,6414904
11,11001,2003-12-31,6503230,15298,6518528
11,11001,2004-12-31,6600764,15749,6616513
11,11001,2005-12-31,6694694,16216,6710910
11,11001,2006-12-31,6784611,16732,6801343
11,11001,2007-12-31,6867311,17258,6884569
11,11001,2008-12-31,6942679,17833,6960512
11,11001,2009-12-31,7012963,18436,7031399
11,11001,2010-12-31,7077814,19072,7096886
11,11001,2011-12-31,7132915,19741,7152656
11,11001,2012-12-31,7175553,20427,7195980
11,11001,2013-12-31,7207289,21138,7228427
11,11001,2014-12-31,7231097,21852,7252949
11,11001,2015-12-31,7250675,22590,7273265
11,11001,2016-12-31,7277543,23375,7300918
11,11001,2017-12-31,7313244,24205,7337449
11,11001,2018-12-31,7387400,25166,7412566
11,11001,2019-12-31,7566185,26686,7592871
11,11001,2020-12-31,7715778,28177,7743955
11,11001,2021-12-31,7804660,29507,7834167
11,11001,2022-12-31,7871075,30578,7901653
11,11001,2023-12-31,7936532,31563,7968095
11,11001,2024-12-31,8002180,32469,8034649
11,11001,2025-12-31,8068116,33296,8101412
11,11001,2026-12-31,8134378,34043,8168421
11,11001,2027-12-31,8200804,34708,8235512
11,11001,2028-12-31,8267153,35289,8302442
11,11001,2029-12-31,8333130,35785,8368915
11,11001,2030-12-31,8398502,36198,8434700
11,11001,2031-12-31,8462155,36561,8498716
11,11001,2032-12-31,8523036,36906,8559942
11,11001,2033-12-31,8581087,37232,8618319
11,11001,2034-12-31,8636266,37538,8673804
11,11001,2035-12-31,8688573,37829,8726402
13,13001,1985-12-31,451854,49056,500910
13,13001,1986-12-31,467729,50377,518106
13,13001,1987-12-31,484811,51510,536321
13,13001,1988-12-31,502795,52505,555300
13,13001,1989-12-31,521726,53322,575048
13,13001,1990-12-31,541168,53988,595156
13,13001,1991-12-31,561047,54552,615599
13,13001,1992-12-31,581106,55111,636217
13,13001,1993-12-31,601147,55689,656836
13,13001,1994-12-31,620074,56260,676334
13,13001,1995-12-31,630404,57096,687500
13,13001,1996-12-31,646813,55335,702148
13,13001,1997-12-31,665622,55808,721430
13,13001,1998-12-31,683621,56377,739998
13,13001,1999-12-31,702161,56891,759052
13,13001,2000-12-31,715074,58579,773653
13,13001,2001-12-31,727349,60382,787731
13,13001,2002-12-31,739091,62267,801358
13,13001,2003-12-31,750109,64200,814309
13,13001,2004-12-31,760585,66233,826818
13,13001,2005-12-31,770314,68443,838757
13,13001,2006-12-31,779889,70563,850452
13,13001,2007-12-31,788864,72699,861563
13,13001,2008-12-31,796594,74903,871497
13,13001,2009-12-31,808058,76078,884136
13,13001,2010-12-31,815554,78142,893696
13,13001,2011-12-31,822568,80229,902797
13,13001,2012-12-31,829123,82291,911414
13,13001,2013-12-31,835444,84350,919794
13,13001,2014-12-31,841388,86444,927832
13,13001,2015-12-31,847378,88509,935887
13,13001,2016-12-31,854575,90741,945316
13,13001,2017-12-31,863280,93184,956464
13,13001,2018-12-31,876885,96160,973045
13,13001,2019-12-31,897656,106029,1003685
13,13001,2020-12-31,914552,114184,1028736
13,13001,2021-12-31,926747,117179,1043926
13,13001,2022-12-31,935362,119673,1055035
13,13001,2023-12-31,943502,122068,1065570
13,13001,2024-12-31,950011,124331,1074342
13,13001,2025-12-31,956022,126540,1082562
13,13001,2026-12-31,961910,128685,1090595
13,13001,2027-12-31,967764,130726,1098490
13,13001,2028-12-31,973577,132697,1106274
13,13001,2029-12-31,979412,134561,1113973
13,13001,2030-12-31,985304,136344,1121648
13,13001,2031-12-31,991056,138075,1129131
13,13001,2032-12-31,996448,139795,1136243
13,13001,2033-12-31,1001503,141512,1143015
13,13001,2034-12-31,1006188,143201,1149389
13,13001,2035-12-31,1010538,144886,1155424
13,13006,1985-12-31,1156,26980,28136
13,13006,1986-12-31,1333,26928,28261
13,13006,1987-12-31,1488,26794,28282
13,13006,1988-12-31,1628,26602,28230
13,13006,1989-12-31,1763,26311,28074
13,13006,1990-12-31,1854,25994,27848
13,13006,1991-12-31,2056,25638,27694
13,13006,1992-12-31,2221,25317,27538
13,13006,1993-12-31,2403,25023,27426
13,13006,1994-12-31,2546,24752,27298
13,13006,1995-12-31,2707,19372,22079
13,13006,1996-12-31,2876,18740,21616
13,13006,1997-12-31,3026,14015,17041
13,13006,1998-12-31,3203,13940,17143
13,13006,1999-12-31,3370,13851,17221
13,13006,2000-12-31,3504,14060,17564
13,13006,2001-12-31,3654,14284,17938
13,13006,2002-12-31,3779,14531,18310
13,13006,2003-12-31,3937,14784,18721
13,13006,2004-12-31,4046,15060,19106
13,13006,2005-12-31,4183,15292,19475
13,13006,2006-12-31,4314,15576,19890
13,13006,2007-12-31,4431,15852,20283
13,13006,2008-12-31,4524,16140,20664
13,13006,2009-12-31,4662,16229,20891
13,13006,2010-12-31,4779,16431,21210
13,13006,2011-12-31,4887,16701,21588
13,13006,2012-12-31,5008,16959,21967
13,13006,2013-12-31,5103,17192,22295
13,13006,2014-12-31,5206,17434,22640
13,13006,2015-12-31,5275,17687,22962
13,13006,2016-12-31,5414,17970,23384
13,13006,2017-12-31,5532,18271,23803
13,13006,2018-12-31,5648,18704,24352
13,13006,2019-12-31,5728,18882,24610
13,13006,2020-12-31,5779,19121,24900
13,13006,2021-12-31,5645,19618,25263
13,13006,2022-12-31,5495,20036,25531
13,13006,2023-12-31,5349,20437,25786
13,13006,2024-12-31,5289,20819,26108
13,13006,2025-12-31,5275,21179,26454
13,13006,2026-12-31,5283,21532,26815
13,13006,2027-12-31,5314,21886,27200
13,13006,2028-12-31,5342,22196,27538
13,13006,2029-12-31,5375,22506,27881
13,13006,2030-12-31,5400,22796,28196
13,13006,2031-12-31,5439,23082,28521
13,13006,2032-12-31,5464,23359,28823
13,13006,2033-12-31,5497,23655,29152
13,13006,2034-12-31,5532,23937,29469
13,13006,2035-12-31,5549,24201,29750
13,13030,1985-12-31,0,0,0
13,13030,1986-12-31,0,0,0
13,13030,1987-12-31,0,0,0
13,13030,1988-12-31,0,0,0
13,13030,1989-12-31,0,0,0
13,13030,1990-12-31,0,0,0
13,13030,1991-12-31,0,0,0
13,13030,1992-12-31,0,0,0
13,13030,1993-12-31,0,0,0
13,13030,1994-12-31,0,0,0
13,13030,1995-12-31,3013,5052,8065
13,13030,1996-12-31,3084,4829,7913
13,13030,1997-12-31,3179,4846,8025
13,13030,1998-12-31,3247,4818,8065
13,13030,1999-12-31,3336,4816,8152
13,13030,2000-12-31,3399,4913,8312
13,13030,2001-12-31,3445,5018,8463
13,13030,2002-12-31,3486,5129,8615
13,13030,2003-12-31,3528,5223,8751
13,13030,2004-12-31,3568,5344,8912
13,13030,2005-12-31,3590,5450,9040
13,13030,2006-12-31,3633,5573,9206
13,13030,2007-12-31,3676,5699,9375
13,13030,2008-12-31,3711,5812,9523
13,13030,2009-12-31,3763,5858,9621
13,13030,2010-12-31,3770,5973,9743
13,13030,2011-12-31,3800,6085,9885
13,13030,2012-12-31,3800,6200,10000
13,13030,2013-12-31,3813,6306,10119
13,13030,2014-12-31,3866,6435,10301
13,13030,2015-12-31,3846,6532,10378
13,13030,2016-12-31,3913,6659,10572
13,13030,2017-12-31,3989,6787,10776
13,13030,2018-12-31,4001,6971,10972
13,13030,2019-12-31,4097,7212,11309
13,13030,2020-12-31,4174,7411,11585
13,13030,2021-12-31,4152,7604,11756
13,13030,2022-12-31,4116,7765,11881
13,13030,2023-12-31,4079,7921,12000
13,13030,2024-12-31,4082,8080,12162
13,13030,2025-12-31,4097,8221,12318
13,13030,2026-12-31,4124,8363,12487
13,13030,2027-12-31,4145,8490,12635
13,13030,2028-12-31,4169,8612,12781
13,13030,2029-12-31,4198,8739,12937
13,13030,2030-12-31,4229,8852,13081
13,13030,2031-12-31,4255,8958,13213
13,13030,2032-12-31,4275,9081,13356
13,13030,2033-12-31,4293,9180,13473
13,13030,2034-12-31,4310,9282,13592
13,13030,2035-12-31,4338,9389,13727
13,13042,1985-12-31,0,0,0
13,13042,1986-12-31,0,0,0
13,13042,1987-12-31,0,0,0
13,13042,1988-12-31,0,0,0
13,13042,1989-12-31,0,0,0
13,13042,1990-12-31,0,0,0
13,13042,1991-12-31,0,0,0
13,13042,1992-12-31,0,0,0
13,13042,1993-12-31,0,0,0
13,13042,1994-12-31,0,0,0
13,13042,1995-12-31,0,0,0
13,13042,1996-12-31,2253,5605,7858
13,13042,1997-12-31,2367,5382,7749
13,13042,1998-12-31,2486,5165,7651
13,13042,1999-12-31,2635,4950,7585
13,13042,2000-12-31,2771,4865,7636
13,13042,2001-12-31,2882,4767,7649
13,13042,2002-12-31,2990,4682,7672
13,13042,2003-12-31,3108,4570,7678
13,13042,2004-12-31,3215,4489,7704
13,13042,2005-12-31,3321,4390,7711
13,13042,2006-12-31,3420,4286,7706
13,13042,2007-12-31,3503,4188,7691
13,13042,2008-12-31,3591,4098,7689
13,13042,2009-12-31,3706,3935,7641
13,13042,2010-12-31,3786,3822,7608
13,13042,2011-12-31,3887,3705,7592
13,13042,2012-12-31,3964,3616,7580
13,13042,2013-12-31,4055,3480,7535
13,13042,2014-12-31,4117,3352,7469
13,13042,2015-12-31,4178,3218,7396
13,13042,2016-12-31,4279,3082,7361
13,13042,2017-12-31,4407,2986,7393
13,13042,2018-12-31,4496,2869,7365
13,13042,2019-12-31,4611,2979,7590
13,13042,2020-12-31,4704,3071,7775
13,13042,2021-12-31,4739,3151,7890
13,13042,2022-12-31,4756,3218,7974
13,13042,2023-12-31,4771,3282,8053
13,13042,2024-12-31,4795,3342,8137
13,13042,2025-12-31,4837,3408,8245
13,13042,2026-12-31,4857,3458,8315
13,13042,2027-12-31,4882,3522,8404
13,13042,2028-12-31,4917,3570,8487
13,13042,2029-12-31,4944,3620,8564
13,13042,2030-12-31,4974,3664,8638
13,13042,2031-12-31,5005,3711,8716
13,13042,2032-12-31,5032,3764,8796
13,13042,2033-12-31,5063,3798,8861
13,13042,2034-12-31,5080,3843,8923
13,13042,2035-12-31,5109,3893,9002
13,13052,1985-12-31,27170,9168,36338
13,13052,1986-12-31,28191,9304,37495
13,13052,1987-12-31,29295,9398,38693
13,13052,1988-12-31,30448,9463,39911
13,13052,1989-12-31,31675,9504,41179
13,13052,1990-12-31,32919,9530,42449
13,13052,1991-12-31,34198,9543,43741
13,13052,1992-12-31,35487,9560,45047
13,13052,1993-12-31,36772,9552,46324
13,13052,1994-12-31,37999,9578,47577
13,13052,1995-12-31,38693,9637,48330
13,13052,1996-12-31,39799,9265,49064
13,13052,1997-12-31,40985,9295,50280
13,13052,1998-12-31,42147,9299,51446
13,13052,1999-12-31,43358,9317,52675
13,13052,2000-12-31,44204,9535,53739
13,13052,2001-12-31,45018,9783,54801
13,13052,2002-12-31,45805,10023,55828
13,13052,2003-12-31,46543,10276,56819
13,13052,2004-12-31,47246,10532,57778
13,13052,2005-12-31,47904,10825,58729
13,13052,2006-12-31,48537,11100,59637
13,13052,2007-12-31,49166,11383,60549
13,13052,2008-12-31,49693,11658,61351
13,13052,2009-12-31,50455,11791,62246
13,13052,2010-12-31,50970,12062,63032
13,13052,2011-12-31,51450,12315,63765
13,13052,2012-12-31,51905,12580,64485
13,13052,2013-12-31,52330,12851,65181
13,13052,2014-12-31,52758,13097,65855
13,13052,2015-12-31,53208,13370,66578
13,13052,2016-12-31,53684,13667,67351
13,13052,2017-12-31,54189,13976,68165
13,13052,2018-12-31,55134,14369,69503
13,13052,2019-12-31,56558,15279,71837
13,13052,2020-12-31,57700,16030,73730
13,13052,2021-12-31,58369,16450,74819
13,13052,2022-12-31,58815,16800,75615
13,13052,2023-12-31,59233,17137,76370
13,13052,2024-12-31,59645,17445,77090
13,13052,2025-12-31,60064,17755,77819
13,13052,2026-12-31,60483,18061,78544
13,13052,2027-12-31,60891,18343,79234
13,13052,2028-12-31,61291,18624,79915
13,13052,2029-12-31,61698,18881,80579
13,13052,2030-12-31,62112,19126,81238
13,13052,2031-12-31,62517,19371,81888
13,13052,2032-12-31,62915,19613,82528
13,13052,2033-12-31,63261,19857,83118
13,13052,2034-12-31,63593,20090,83683
13,13052,2035-12-31,63910,20317,84227
13,13062,1985-12-31,0,0,0
13,13062,1986-12-31,0,0,0
13,13062,1987-12-31,0,0,0
13,13062,1988-12-31,0,0,0
13,13062,1989-12-31,0,0,0
13,13062,1990-12-31,0,0,0
13,13062,1991-12-31,0,0,0
13,13062,1992-12-31,0,0,0
13,13062,1993-12-31,0,0,0
13,13062,1994-12-31,0,0,0
13,13062,1995-12-31,0,0,0
13,13062,1996-12-31,0,0,0
13,13062,1997-12-31,0,0,0
13,13062,1998-12-31,4855,3806,8661
13,13062,1999-12-31,4923,3722,8645
13,13062,2000-12-31,4927,3709,8636
13,13062,2001-12-31,4924,3703,8627
13,13062,2002-12-31,4930,3690,8620
13,13062,2003-12-31,4901,3682,8583
13,13062,2004-12-31,4914,3666,8580
13,13062,2005-12-31,4900,3676,8576
13,13062,2006-12-31,4867,3670,8537
13,13062,2007-12-31,4858,3688,8546
13,13062,2008-12-31,4899,3690,8589
13,13062,2009-12-31,4864,3622,8486
13,13062,2010-12-31,4922,3609,8531
13,13062,2011-12-31,4838,3597,8435
13,13062,2012-12-31,4774,3590,8364
13,13062,2013-12-31,4761,3597,8358
13,13062,2014-12-31,4706,3577,8283
13,13062,2015-12-31,4654,3516,8170
13,13062,2016-12-31,4648,3491,8139
13,13062,2017-12-31,4674,3547,8221
13,13062,2018-12-31,4719,3535,8254
13,13062,2019-12-31,4835,3669,8504
13,13062,2020-12-31,4929,3781,8710
13,13062,2021-12-31,4960,3879,8839
13,13062,2022-12-31,4971,3962,8933
13,13062,2023-12-31,4981,4041,9022
13,13062,2024-12-31,5007,4127,9134
13,13062,2025-12-31,5029,4207,9236
13,13062,2026-12-31,5060,4262,9322
13,13062,2027-12-31,5084,4330,9414
13,13062,2028-12-31,5127,4384,9511
13,13062,2029-12-31,5158,4465,9623
13,13062,2030-12-31,5187,4508,9695
13,13062,2031-12-31,5219,4569,9788
13,13062,2032-12-31,5243,4639,9882
13,13062,2033-12-31,5269,4686,9955
13,13062,2034-12-31,5299,4735,10034
13,13062,2035-12-31,5327,4808,10135
13,13074,1985-12-31,2116,16127,18243
13,13074,1986-12-31,2259,16281,18540
13,13074,1987-12-31,2346,16395,18741
13,13074,1988-12-31,2481,16464,18945
13,13074,1989-12-31,2608,16484,19092
13,13074,1990-12-31,2731,16461,19192
13,13074,1991-12-31,2890,16446,19336
13,13074,1992-12-31,3029,16386,19415
13,13074,1993-12-31,3204,16366,19570
13,13074,1994-12-31,3358,16350,19708
13,13074,1995-12-31,3466,9888,13354
13,13074,1996-12-31,3591,9316,12907
13,13074,1997-12-31,3725,9108,12833
13,13074,1998-12-31,3868,8931,12799
13,13074,1999-12-31,4026,8769,12795
13,13074,2000-12-31,4131,8767,12898
13,13074,2001-12-31,4237,8790,13027
13,13074,2002-12-31,4337,8809,13146
13,13074,2003-12-31,4442,8843,13285
13,13074,2004-12-31,4544,8871,13415
13,13074,2005-12-31,4643,8894,13537
13,13074,2006-12-31,4732,8922,13654
13,13074,2007-12-31,4813,8958,13771
13,13074,2008-12-31,4905,9016,13921
13,13074,2009-12-31,5013,8905,13918
13,13074,2010-12-31,5082,8910,13992
13,13074,2011-12-31,5154,8938,14092
13,13074,2012-12-31,5245,8954,14199
13,13074,2013-12-31,5315,8969,14284
13,13074,2014-12-31,5390,8965,14355
13,13074,2015-12-31,5450,8960,14410
13,13074,2016-12-31,5520,8999,14519
13,13074,2017-12-31,5643,9023,14666
13,13074,2018-12-31,5722,9114,14836
13,13074,2019-12-31,5866,9130,14996
13,13074,2020-12-31,5980,9201,15181
13,13074,2021-12-31,5962,9440,15402
13,13074,2022-12-31,5925,9641,15566
13,13074,2023-12-31,5887,9834,15721
13,13074,2024-12-31,5895,10026,15921
13,13074,2025-12-31,5928,10204,16132
13,13074,2026-12-31,5971,10383,16354
13,13074,2027-12-31,5994,10543,16537
13,13074,2028-12-31,6032,10687,16719
13,13074,2029-12-31,6075,10841,16916
13,13074,2030-12-31,6108,10985,17093
13,13074,2031-12-31,6143,11130,17273
13,13074,2032-12-31,6180,11251,17431
13,13074,2033-12-31,6216,11384,17600
13,13074,2034-12-31,6232,11522,17754
13,13074,2035-12-31,6260,11659,17919
13,13140,1985-12-31,6223,17705,23928
13,13140,1986-12-31,6474,17538,24012
13,13140,1987-12-31,6712,17306,24018
13,13140,1988-12-31,7017,17059,24076
13,13140,1989-12-31,7253,16753,24006
13,13140,1990-12-31,7550,16415,23965
13,13140,1991-12-31,7868,16061,23929
13,13140,1992-12-31,8159,15741,23900
13,13140,1993-12-31,8456,15434,23890
13,13140,1994-12-31,8741,15194,23935
13,13140,1995-12-31,8899,15007,23906
13,13140,1996-12-31,9144,14150,23294
13,13140,1997-12-31,9428,13906,23334
13,13140,1998-12-31,9696,8075,17771
13,13140,1999-12-31,9972,7966,17938
13,13140,2000-12-31,10175,8062,18237
13,13140,2001-12-31,10364,8144,18508
13,13140,2002-12-31,10553,8245,18798
13,13140,2003-12-31,10720,8330,19050
13,13140,2004-12-31,10873,8431,19304
13,13140,2005-12-31,11027,8515,19542
13,13140,2006-12-31,11189,8623,19812
13,13140,2007-12-31,11318,8731,20049
13,13140,2008-12-31,11457,8857,20314
13,13140,2009-12-31,11633,8831,20464
13,13140,2010-12-31,11750,8919,20669
13,13140,2011-12-31,11864,9016,20880
13,13140,2012-12-31,11968,9106,21074
13,13140,2013-12-31,12072,9189,21261
13,13140,2014-12-31,12172,9272,21444
13,13140,2015-12-31,12268,9343,21611
13,13140,2016-12-31,12407,9448,21855
13,13140,2017-12-31,12521,9596,22117
13,13140,2018-12-31,12718,9756,22474
13,13140,2019-12-31,12994,9800,22794
13,13140,2020-12-31,13218,9879,23097
13,13140,2021-12-31,13297,10136,23433
13,13140,2022-12-31,13332,10351,23683
13,13140,2023-12-31,13360,10559,23919
13,13140,2024-12-31,13396,10755,24151
13,13140,2025-12-31,13448,10942,24390
13,13140,2026-12-31,13507,11125,24632
13,13140,2027-12-31,13582,11307,24889
13,13140,2028-12-31,13646,11475,25121
13,13140,2029-12-31,13733,11627,25360
13,13140,2030-12-31,13809,11787,25596
13,13140,2031-12-31,13890,11930,25820
13,13140,2032-12-31,13967,12079,26046
13,13140,2033-12-31,14018,12227,26245
13,13140,2034-12-31,14096,12383,26479
13,13140,2035-12-31,14165,12514,26679
13,13160,1985-12-31,0,0,0
13,13160,1986-12-31,0,0,0
13,13160,1987-12-31,0,0,0
13,13160,1988-12-31,0,0,0
13,13160,1989-12-31,0,0,0
13,13160,1990-12-31,0,0,0
13,13160,1991-12-31,0,0,0
13,13160,1992-12-31,0,0,0
13,13160,1993-12-31,0,0,0
13,13160,1994-12-31,0,0,0
13,13160,1995-12-31,1471,3027,4498
13,13160,1996-12-31,1603,2845,4448
13,13160,1997-12-31,1752,2849,4601
13,13160,1998-12-31,1928,2838,4766
13,13160,1999-12-31,2081,2811,4892
13,13160,2000-12-31,2258,2847,5105
13,13160,2001-12-31,2416,2894,5310
13,13160,2002-12-31,2558,2940,5498
13,13160,2003-12-31,2692,2988,5680
13,13160,2004-12-31,2809,3049,5858
13,13160,2005-12-31,2964,3084,6048
13,13160,2006-12-31,3072,3135,6207
13,13160,2007-12-31,3211,3181,6392
13,13160,2008-12-31,3342,3250,6592
13,13160,2009-12-31,3479,3252,6731
13,13160,2010-12-31,3588,3319,6907
13,13160,2011-12-31,3696,3346,7042
13,13160,2012-12-31,3820,3411,7231
13,13160,2013-12-31,3955,3443,7398
13,13160,2014-12-31,4047,3473,7520
13,13160,2015-12-31,4115,3560,7675
13,13160,2016-12-31,4254,3567,7821
13,13160,2017-12-31,4409,3626,8035
13,13160,2018-12-31,4520,3714,8234
13,13160,2019-12-31,4666,3822,8488
13,13160,2020-12-31,4801,3895,8696
13,13160,2021-12-31,4828,3996,8824
13,13160,2022-12-31,4837,4081,8918
13,13160,2023-12-31,4844,4163,9007
13,13160,2024-12-31,4874,4239,9113
13,13160,2025-12-31,4907,4312,9219
13,13160,2026-12-31,4923,4383,9306
13,13160,2027-12-31,4961,4455,9416
13,13160,2028-12-31,4994,4520,9514
13,13160,2029-12-31,5027,4595,9622
13,13160,2030-12-31,5055,4641,9696
13,13160,2031-12-31,5084,4691,9775
13,13160,2032-12-31,5113,4768,9881
13,13160,2033-12-31,5137,4810,9947
13,13160,2034-12-31,5164,4872,10036
13,13160,2035-12-31,5187,4936,10123
13,13188,1985-12-31,0,0,0
13,13188,1986-12-31,0,0,0
13,13188,1987-12-31,0,0,0
13,13188,1988-12-31,0,0,0
13,13188,1989-12-31,0,0,0
13,13188,1990-12-31,0,0,0
13,13188,1991-12-31,0,0,0
13,13188,1992-12-31,0,0,0
13,13188,1993-12-31,0,0,0
13,13188,1994-12-31,0,0,0
13,13188,1995-12-31,2754,4174,6928
13,13188,1996-12-31,3060,3959,7019
13,13188,1997-12-31,3378,3894,7272
13,13188,1998-12-31,3679,3851,7530
13,13188,1999-12-31,4032,3797,7829
13,13188,2000-12-31,4304,3883,8187
13,13188,2001-12-31,4596,3916,8512
13,13188,2002-12-31,4871,3940,8811
13,13188,2003-12-31,5141,3981,9122
13,13188,2004-12-31,5406,4035,9441
13,13188,2005-12-31,5677,4076,9753
13,13188,2006-12-31,5930,4140,10070
13,13188,2007-12-31,6190,4187,10377
13,13188,2008-12-31,6422,4249,10671
13,13188,2009-12-31,6697,4240,10937
13,13188,2010-12-31,6931,4281,11212
13,13188,2011-12-31,7179,4335,11514
13,13188,2012-12-31,7403,4376,11779
13,13188,2013-12-31,7604,4413,12017
13,13188,2014-12-31,7807,4450,12257
13,13188,2015-12-31,8048,4487,12535
13,13188,2016-12-31,8208,4532,12740
13,13188,2017-12-31,8500,4607,13107
13,13188,2018-12-31,8758,4684,13442
13,13188,2019-12-31,9016,4887,13903
13,13188,2020-12-31,9241,5061,14302
13,13188,2021-12-31,9319,5194,14513
13,13188,2022-12-31,9364,5304,14668
13,13188,2023-12-31,9404,5410,14814
13,13188,2024-12-31,9467,5507,14974
13,13188,2025-12-31,9526,5607,15133
13,13188,2026-12-31,9579,5711,15290
13,13188,2027-12-31,9643,5791,15434
13,13188,2028-12-31,9698,5884,15582
13,13188,2029-12-31,9758,5964,15722
13,13188,2030-12-31,9820,6033,15853
13,13188,2031-12-31,9886,6115,16001
13,13188,2032-12-31,9920,6196,16116
13,13188,2033-12-31,9981,6271,16252
13,13188,2034-12-31,10032,6344,16376
13,13188,2035-12-31,10069,6407,16476
13,13212,1985-12-31,3929,11985,15914
13,13212,1986-12-31,3952,11931,15883
13,13212,1987-12-31,4016,11828,15844
13,13212,1988-12-31,4054,11691,15745
13,13212,1989-12-31,4088,11555,15643
13,13212,1990-12-31,4186,11372,15558
13,13212,1991-12-31,4238,11199,15437
13,13212,1992-12-31,4287,11011,15298
13,13212,1993-12-31,4347,10855,15202
13,13212,1994-12-31,4404,10687,15091
13,13212,1995-12-31,4385,10584,14969
13,13212,1996-12-31,4389,10028,14417
13,13212,1997-12-31,4449,9887,14336
13,13212,1998-12-31,4493,9771,14264
13,13212,1999-12-31,4512,9638,14150
13,13212,2000-12-31,4516,9729,14245
13,13212,2001-12-31,4532,9828,14360
13,13212,2002-12-31,4509,9928,14437
13,13212,2003-12-31,4499,10042,14541
13,13212,2004-12-31,4495,10159,14654
13,13212,2005-12-31,4477,10296,14773
13,13212,2006-12-31,4461,10433,14894
13,13212,2007-12-31,4440,10558,14998
13,13212,2008-12-31,4393,10680,15073
13,13212,2009-12-31,4389,10665,15054
13,13212,2010-12-31,4351,10784,15135
13,13212,2011-12-31,4346,10891,15237
13,13212,2012-12-31,4315,10995,15310
13,13212,2013-12-31,4300,11084,15384
13,13212,2014-12-31,4238,11191,15429
13,13212,2015-12-31,4191,11277,15468
13,13212,2016-12-31,4211,11394,15605
13,13212,2017-12-31,4169,11530,15699
13,13212,2018-12-31,4206,11754,15960
13,13212,2019-12-31,4131,12094,16225
13,13212,2020-12-31,4091,12383,16474
13,13212,2021-12-31,4009,12705,16714
13,13212,2022-12-31,3917,12975,16892
13,13212,2023-12-31,3825,13235,17060
13,13212,2024-12-31,3751,13477,17228
13,13212,2025-12-31,3672,13725,17397
13,13212,2026-12-31,3591,13956,17547
13,13212,2027-12-31,3526,14170,17696
13,13212,2028-12-31,3468,14377,17845
13,13212,2029-12-31,3413,14583,17996
13,13212,2030-12-31,3357,14774,18131
13,13212,2031-12-31,3311,14959,18270
13,13212,2032-12-31,3263,15138,18401
13,13212,2033-12-31,3227,15321,18548
13,13212,2034-12-31,3189,15478,18667
13,13212,2035-12-31,3152,15682,18834
13,13222,1985-12-31,0,0,0
13,13222,1986-12-31,0,0,0
13,13222,1987-12-31,0,0,0
13,13222,1988-12-31,0,0,0
13,13222,1989-12-31,0,0,0
13,13222,1990-12-31,0,0,0
13,13222,1991-12-31,0,0,0
13,13222,1992-12-31,0,0,0
13,13222,1993-12-31,0,0,0
13,13222,1994-12-31,0,0,0
13,13222,1995-12-31,0,0,0
13,13222,1996-12-31,4529,5975,10504
13,13222,1997-12-31,4933,5713,10646
13,13222,1998-12-31,5379,5457,10836
13,13222,1999-12-31,5784,5216,11000
13,13222,2000-12-31,6191,5053,11244
13,13222,2001-12-31,6557,4941,11498
13,13222,2002-12-31,6960,4817,11777
13,13222,2003-12-31,7329,4690,12019
13,13222,2004-12-31,7686,4577,12263
13,13222,2005-12-31,8039,4420,12459
13,13222,2006-12-31,8378,4296,12674
13,13222,2007-12-31,8727,4159,12886
13,13222,2008-12-31,9049,4000,13049
13,13222,2009-12-31,9406,3809,13215
13,13222,2010-12-31,9733,3660,13393
13,13222,2011-12-31,10039,3527,13566
13,13222,2012-12-31,10344,3327,13671
13,13222,2013-12-31,10626,3170,13796
13,13222,2014-12-31,10916,2995,13911
13,13222,2015-12-31,11207,2829,14036
13,13222,2016-12-31,11472,2671,14143
13,13222,2017-12-31,11825,2522,14347
13,13222,2018-12-31,12169,2342,14511
13,13222,2019-12-31,12553,2461,15014
13,13222,2020-12-31,12904,2549,15453
13,13222,2021-12-31,13065,2616,15681
13,13222,2022-12-31,13177,2671,15848
13,13222,2023-12-31,13281,2725,16006
13,13222,2024-12-31,13370,2779,16149
13,13222,2025-12-31,13459,2828,16287
13,13222,2026-12-31,13553,2871,16424
13,13222,2027-12-31,13644,2922,16566
13,13222,2028-12-31,13720,2948,16668
13,13222,2029-12-31,13806,2996,16802
13,13222,2030-12-31,13879,3047,16926
13,13222,2031-12-31,13968,3080,17048
13,13222,2032-12-31,14047,3122,17169
13,13222,2033-12-31,14120,3156,17276
13,13222,2034-12-31,14175,3191,17366
13,13222,2035-12-31,14260,3221,17481
13,13244,1985-12-31,28310,37499,65809
13,13244,1986-12-31,29175,36721,65896
13,13244,1987-12-31,30127,35843,65970
13,13244,1988-12-31,31134,34915,66049
13,13244,1989-12-31,32221,33887,66108
13,13244,1990-12-31,33302,32832,66134
13,13244,1991-12-31,34396,31741,66137
13,13244,1992-12-31,35524,30721,66245
13,13244,1993-12-31,36630,29765,66395
13,13244,1994-12-31,37669,28847,66516
13,13244,1995-12-31,38198,28096,66294
13,13244,1996-12-31,39076,26145,65221
13,13244,1997-12-31,40106,25329,65435
13,13244,1998-12-31,41085,24601,65686
13,13244,1999-12-31,42101,23827,65928
13,13244,2000-12-31,42780,23595,66375
13,13244,2001-12-31,43417,23375,66792
13,13244,2002-12-31,44033,23185,67218
13,13244,2003-12-31,44591,23005,67596
13,13244,2004-12-31,45118,22815,67933
13,13244,2005-12-31,45599,22669,68268
13,13244,2006-12-31,46086,22478,68564
13,13244,2007-12-31,46530,22285,68815
13,13244,2008-12-31,46911,22101,69012
13,13244,2009-12-31,47506,21599,69105
13,13244,2010-12-31,47858,21352,69210
13,13244,2011-12-31,48195,21110,69305
13,13244,2012-12-31,48497,20825,69322
13,13244,2013-12-31,48799,20549,69348
13,13244,2014-12-31,49067,20255,69322
13,13244,2015-12-31,49337,19954,69291
13,13244,2016-12-31,49725,19678,69403
13,13244,2017-12-31,50046,19432,69478
13,13244,2018-12-31,50844,19287,70131
13,13244,2019-12-31,51907,19521,71428
13,13244,2020-12-31,52792,19803,72595
13,13244,2021-12-31,53335,20318,73653
13,13244,2022-12-31,53686,20750,74436
13,13244,2023-12-31,54013,21166,75179
13,13244,2024-12-31,54405,21567,75972
13,13244,2025-12-31,54745,21943,76688
13,13244,2026-12-31,55077,22321,77398
13,13244,2027-12-31,55405,22664,78069
13,13244,2028-12-31,55737,23013,78750
13,13244,2029-12-31,56067,23313,79380
13,13244,2030-12-31,56411,23602,80013
13,13244,2031-12-31,56735,23923,80658
13,13244,2032-12-31,57040,24200,81240
13,13244,2033-12-31,57336,24501,81837
13,13244,2034-12-31,57608,24793,82401
13,13244,2035-12-31,57847,25076,82923
13,13248,1985-12-31,3090,4044,7134
13,13248,1986-12-31,3149,4005,7154
13,13248,1987-12-31,3230,3964,7194
13,13248,1988-12-31,3348,3926,7274
13,13248,1989-12-31,3383,3863,7246
13,13248,1990-12-31,3484,3805,7289
13,13248,1991-12-31,3565,3760,7325
13,13248,1992-12-31,3717,3724,7441
13,13248,1993-12-31,3775,3652,7427
13,13248,1994-12-31,3900,3570,7470
13,13248,1995-12-31,3882,3573,7455
13,13248,1996-12-31,3966,3362,7328
13,13248,1997-12-31,4061,3301,7362
13,13248,1998-12-31,4139,3258,7397
13,13248,1999-12-31,4212,3224,7436
13,13248,2000-12-31,4263,3246,7509
13,13248,2001-12-31,4305,3277,7582
13,13248,2002-12-31,4322,3300,7622
13,13248,2003-12-31,4360,3349,7709
13,13248,2004-12-31,4402,3407,7809
13,13248,2005-12-31,4451,3426,7877
13,13248,2006-12-31,4504,3523,8027
13,13248,2007-12-31,4507,3510,8017
13,13248,2008-12-31,4521,3543,8064
13,13248,2009-12-31,4525,3552,8077
13,13248,2010-12-31,4553,3587,8140
13,13248,2011-12-31,4550,3625,8175
13,13248,2012-12-31,4571,3662,8233
13,13248,2013-12-31,4614,3705,8319
13,13248,2014-12-31,4614,3746,8360
13,13248,2015-12-31,4558,3759,8317
13,13248,2016-12-31,4618,3776,8394
13,13248,2017-12-31,4668,3819,8487
13,13248,2018-12-31,4748,3899,8647
13,13248,2019-12-31,4797,4028,8825
13,13248,2020-12-31,4841,4143,8984
13,13248,2021-12-31,4864,4251,9115
13,13248,2022-12-31,4871,4341,9212
13,13248,2023-12-31,4876,4428,9304
13,13248,2024-12-31,4888,4511,9399
13,13248,2025-12-31,4900,4594,9494
13,13248,2026-12-31,4924,4665,9589
13,13248,2027-12-31,4942,4736,9678
13,13248,2028-12-31,4967,4811,9778
13,13248,2029-12-31,4982,4874,9856
13,13248,2030-12-31,5015,4945,9960
13,13248,2031-12-31,5045,5018,10063
13,13248,2032-12-31,5070,5069,10139
13,13248,2033-12-31,5074,5124,10198
13,13248,2034-12-31,5115,5191,10306
13,13248,2035-12-31,5121,5242,10363
13,13268,1985-12-31,0,0,0
13,13268,1986-12-31,0,0,0
13,13268,1987-12-31,0,0,0
13,13268,1988-12-31,0,0,0
13,13268,1989-12-31,0,0,0
13,13268,1990-12-31,0,0,0
13,13268,1991-12-31,0,0,0
13,13268,1992-12-31,0,0,0
13,13268,1993-12-31,0,0,0
13,13268,1994-12-31,0,0,0
13,13268,1995-12-31,0,0,0
13,13268,1996-12-31,3639,9013,12652
13,13268,1997-12-31,3677,8660,12337
13,13268,1998-12-31,3653,8336,11989
13,13268,1999-12-31,3637,8017,11654
13,13268,2000-12-31,3620,7861,11481
13,13268,2001-12-31,3578,7709,11287
13,13268,2002-12-31,3565,7561,11126
13,13268,2003-12-31,3523,7408,10931
13,13268,2004-12-31,3489,7273,10762
13,13268,2005-12-31,3430,7105,10535
13,13268,2006-12-31,3390,6948,10338
13,13268,2007-12-31,3337,6791,10128
13,13268,2008-12-31,3278,6648,9926
13,13268,2009-12-31,3259,6388,9647
13,13268,2010-12-31,3216,6229,9445
13,13268,2011-12-31,3156,6061,9217
13,13268,2012-12-31,3123,5873,8996
13,13268,2013-12-31,3052,5702,8754
13,13268,2014-12-31,2973,5497,8470
13,13268,2015-12-31,2963,5304,8267
13,13268,2016-12-31,2932,5095,8027
13,13268,2017-12-31,2889,4950,7839
13,13268,2018-12-31,2886,4765,7651
13,13268,2019-12-31,2959,4925,7884
13,13268,2020-12-31,3018,5057,8075
13,13268,2021-12-31,3005,5189,8194
13,13268,2022-12-31,2982,5299,8281
13,13268,2023-12-31,2959,5405,8364
13,13268,2024-12-31,2968,5511,8479
13,13268,2025-12-31,2976,5613,8589
13,13268,2026-12-31,2997,5698,8695
13,13268,2027-12-31,3011,5792,8803
13,13268,2028-12-31,3030,5874,8904
13,13268,2029-12-31,3047,5953,9000
13,13268,2030-12-31,3074,6040,9114
13,13268,2031-12-31,3085,6114,9199
13,13268,2032-12-31,3102,6183,9285
13,13268,2033-12-31,3125,6249,9374
13,13268,2034-12-31,3131,6325,9456
13,13268,2035-12-31,3144,6401,9545
13,13300,1985-12-31,0,0,0
13,13300,1986-12-31,0,0,0
13,13300,1987-12-31,0,0,0
13,13300,1988-12-31,0,0,0
13,13300,1989-12-31,0,0,0
13,13300,1990-12-31,0,0,0
13,13300,1991-12-31,0,0,0
13,13300,1992-12-31,0,0,0
13,13300,1993-12-31,0,0,0
13,13300,1994-12-31,0,0,0
13,13300,1995-12-31,2428,13117,15545
13,13300,1996-12-31,2480,12227,14707
13,13300,1997-12-31,2557,11866,14423
13,13300,1998-12-31,2636,11538,14174
13,13300,1999-12-31,2678,11200,13878
13,13300,2000-12-31,2722,11089,13811
13,13300,2001-12-31,2765,11001,13766
13,13300,2002-12-31,2798,10915,13713
13,13300,2003-12-31,2818,10831,13649
13,13300,2004-12-31,2845,10754,13599
13,13300,2005-12-31,2816,10638,13454
13,13300,2006-12-31,2857,10564,13421
13,13300,2007-12-31,2912,10475,13387
13,13300,2008-12-31,2944,10379,13323
13,13300,2009-12-31,2994,10156,13150
13,13300,2010-12-31,3029,10049,13078
13,13300,2011-12-31,3031,9949,12980
13,13300,2012-12-31,3044,9833,12877
13,13300,2013-12-31,3050,9698,12748
13,13300,2014-12-31,3056,9564,12620
13,13300,2015-12-31,3051,9433,12484
13,13300,2016-12-31,3085,9325,12410
13,13300,2017-12-31,3118,9200,12318
13,13300,2018-12-31,3166,9151,12317
13,13300,2019-12-31,3253,9446,12699
13,13300,2020-12-31,3326,9686,13012
13,13300,2021-12-31,3266,9938,13204
13,13300,2022-12-31,3196,10149,13345
13,13300,2023-12-31,3125,10353,13478
13,13300,2024-12-31,3116,10554,13670
13,13300,2025-12-31,3126,10737,13863
13,13300,2026-12-31,3145,10929,14074
13,13300,2027-12-31,3157,11097,14254
13,13300,2028-12-31,3182,11250,14432
13,13300,2029-12-31,3207,11429,14636
13,13300,2030-12-31,3226,11577,14803
13,13300,2031-12-31,3241,11701,14942
13,13300,2032-12-31,3253,11847,15100
13,13300,2033-12-31,3272,11997,15269
13,13300,2034-12-31,3294,12136,15430
13,13300,2035-12-31,3311,12286,15597
13,13430,1985-12-31,45080,46930,92010
13,13430,1986-12-31,46809,46507,93316
13,13430,1987-12-31,48660,45946,94606
13,13430,1988-12-31,50593,45295,95888
13,13430,1989-12-31,52708,44527,97235
13,13430,1990-12-31,54794,43662,98456
13,13430,1991-12-31,56928,42794,99722
13,13430,1992-12-31,59083,41957,101040
13,13430,1993-12-31,61249,41198,102447
13,13430,1994-12-31,63306,40475,103781
13,13430,1995-12-31,64481,39964,104445
13,13430,1996-12-31,66284,37710,103994
13,13430,1997-12-31,68322,37070,105392
13,13430,1998-12-31,70287,36516,106803
13,13430,1999-12-31,72323,35945,108268
13,13430,2000-12-31,73764,36122,109886
13,13430,2001-12-31,75147,36360,111507
13,13430,2002-12-31,76477,36631,113108
13,13430,2003-12-31,77718,36919,114637
13,13430,2004-12-31,78912,37232,116144
13,13430,2005-12-31,80020,37573,117593
13,13430,2006-12-31,81107,37902,119009
13,13430,2007-12-31,82146,38242,120388
13,13430,2008-12-31,83053,38563,121616
13,13430,2009-12-31,84340,38370,122710
13,13430,2010-12-31,85219,38626,123845
13,13430,2011-12-31,86046,38891,124937
13,13430,2012-12-31,86828,39109,125937
13,13430,2013-12-31,87577,39336,126913
13,13430,2014-12-31,88277,39561,127838
13,13430,2015-12-31,89009,39772,128781
13,13430,2016-12-31,89843,40035,129878
13,13430,2017-12-31,90790,40393,131183
13,13430,2018-12-31,92316,40954,133270
13,13430,2019-12-31,94586,42444,137030
13,13430,2020-12-31,96380,43776,140156
13,13430,2021-12-31,97284,44915,142199
13,13430,2022-12-31,97840,45870,143710
13,13430,2023-12-31,98356,46789,145145
13,13430,2024-12-31,98917,47703,146620
13,13430,2025-12-31,99508,48558,148066
13,13430,2026-12-31,100106,49364,149470
13,13430,2027-12-31,100718,50129,150847
13,13430,2028-12-31,101328,50885,152213
13,13430,2029-12-31,101925,51589,153514
13,13430,2030-12-31,102547,52253,154800
13,13430,2031-12-31,103142,52904,156046
13,13430,2032-12-31,103719,53561,157280
13,13430,2033-12-31,104245,54190,158435
13,13430,2034-12-31,104728,54839,159567
13,13430,2035-12-31,105189,55467,160656
13,13433,1985-12-31,5954,15187,21141
13,13433,1986-12-31,6138,15435,21573
13,13433,1987-12-31,6314,15604,21918
13,13433,1988-12-31,6540,15744,22284
13,13433,1989-12-31,6728,15843,22571
13,13433,1990-12-31,6952,15912,22864
13,13433,1991-12-31,7201,15945,23146
13,13433,1992-12-31,7408,15971,23379
13,13433,1993-12-31,7619,16018,23637
13,13433,1994-12-31,7831,16071,23902
13,13433,1995-12-31,7941,16209,24150
13,13433,1996-12-31,8114,15619,23733
13,13433,1997-12-31,8329,15671,24000
13,13433,1998-12-31,8526,13700,22226
13,13433,1999-12-31,8722,13577,22299
13,13433,2000-12-31,8860,13731,22591
13,13433,2001-12-31,8971,13896,22867
13,13433,2002-12-31,9088,14082,23170
13,13433,2003-12-31,9218,14276,23494
13,13433,2004-12-31,9320,14499,23819
13,13433,2005-12-31,9410,14687,24097
13,13433,2006-12-31,9495,14900,24395
13,13433,2007-12-31,9566,15129,24695
13,13433,2008-12-31,9629,15353,24982
13,13433,2009-12-31,9742,15365,25107
13,13433,2010-12-31,9814,15551,25365
13,13433,2011-12-31,9906,15760,25666
13,13433,2012-12-31,9965,15953,25918
13,13433,2013-12-31,9987,16140,26127
13,13433,2014-12-31,10026,16315,26341
13,13433,2015-12-31,10111,16493,26604
13,13433,2016-12-31,10108,16696,26804
13,13433,2017-12-31,10230,16928,27158
13,13433,2018-12-31,10402,17290,27692
13,13433,2019-12-31,10563,18039,28602
13,13433,2020-12-31,10664,18691,29355
13,13433,2021-12-31,10608,19181,29789
13,13433,2022-12-31,10516,19589,30105
13,13433,2023-12-31,10425,19981,30406
13,13433,2024-12-31,10371,20346,30717
13,13433,2025-12-31,10354,20689,31043
13,13433,2026-12-31,10363,21054,31417
13,13433,2027-12-31,10399,21389,31788
13,13433,2028-12-31,10448,21703,32151
13,13433,2029-12-31,10497,22002,32499
13,13433,2030-12-31,10556,22303,32859
13,13433,2031-12-31,10615,22563,33178
13,13433,2032-12-31,10661,22847,33508
13,13433,2033-12-31,10714,23155,33869
13,13433,2034-12-31,10780,23403,34183
13,13433,2035-12-31,10817,23675,34492
13,13440,1985-12-31,1395,8631,10026
13,13440,1986-12-31,1468,8584,10052
13,13440,1987-12-31,1507,8562,10069
13,13440,1988-12-31,1528,8427,9955
13,13440,1989-12-31,1546,8334,9880
13,13440,1990-12-31,1551,8200,9751
13,13440,1991-12-31,1583,8096,9679
13,13440,1992-12-31,1566,7968,9534
13,13440,1993-12-31,1591,7887,9478
13,13440,1994-12-31,1618,7783,9401
13,13440,1995-12-31,1696,7710,9406
13,13440,1996-12-31,1674,7315,8989
13,13440,1997-12-31,1774,7227,9001
13,13440,1998-12-31,1789,7136,8925
13,13440,1999-12-31,1803,7088,8891
13,13440,2000-12-31,1805,7155,8960
13,13440,2001-12-31,1853,7223,9076
13,13440,2002-12-31,1843,7324,9167
13,13440,2003-12-31,1829,7413,9242
13,13440,2004-12-31,1848,7524,9372
13,13440,2005-12-31,1829,7627,9456
13,13440,2006-12-31,1838,7680,9518
13,13440,2007-12-31,1827,7780,9607
13,13440,2008-12-31,1846,7888,9734
13,13440,2009-12-31,1814,7913,9727
13,13440,2010-12-31,1785,8006,9791
13,13440,2011-12-31,1782,8093,9875
13,13440,2012-12-31,1760,8185,9945
13,13440,2013-12-31,1757,8254,10011
13,13440,2014-12-31,1772,8321,10093
13,13440,2015-12-31,1797,8428,10225
13,13440,2016-12-31,1807,8540,10347
13,13440,2017-12-31,1832,8644,10476
13,13440,2018-12-31,1860,8813,10673
13,13440,2019-12-31,1870,9043,10913
13,13440,2020-12-31,1880,9230,11110
13,13440,2021-12-31,1802,9470,11272
13,13440,2022-12-31,1721,9671,11392
13,13440,2023-12-31,1640,9865,11505
13,13440,2024-12-31,1587,10051,11638
13,13440,2025-12-31,1581,10233,11814
13,13440,2026-12-31,1580,10398,11978
13,13440,2027-12-31,1587,10558,12145
13,13440,2028-12-31,1592,10720,12312
13,13440,2029-12-31,1593,10860,12453
13,13440,2030-12-31,1610,11005,12615
13,13440,2031-12-31,1619,11131,12750
13,13440,2032-12-31,1630,11275,12905
13,13440,2033-12-31,1635,11410,13045
13,13440,2034-12-31,1645,11547,13192
13,13440,2035-12-31,1649,11673,13322
13,13442,1985-12-31,10196,24159,34355
13,13442,1986-12-31,10572,24080,34652
13,13442,1987-12-31,10977,23950,34927
13,13442,1988-12-31,11388,23765,35153
13,13442,1989-12-31,11864,23502,35366
13,13442,1990-12-31,12368,23190,35558
13,13442,1991-12-31,12812,22865,35677
13,13442,1992-12-31,13286,22571,35857
13,13442,1993-12-31,13754,22300,36054
13,13442,1994-12-31,14194,22035,36229
13,13442,1995-12-31,14458,21906,36364
13,13442,1996-12-31,14848,20793,35641
13,13442,1997-12-31,15293,20565,35858
13,13442,1998-12-31,15726,20383,36109
13,13442,1999-12-31,16163,20193,36356
13,13442,2000-12-31,16478,20415,36893
13,13442,2001-12-31,16773,20667,37440
13,13442,2002-12-31,17061,20932,37993
13,13442,2003-12-31,17332,21226,38558
13,13442,2004-12-31,17584,21525,39109
13,13442,2005-12-31,17826,21849,39675
13,13442,2006-12-31,18053,22164,40217
13,13442,2007-12-31,18281,22494,40775
13,13442,2008-12-31,18480,22819,41299
13,13442,2009-12-31,18750,22848,41598
13,13442,2010-12-31,18937,23123,42060
13,13442,2011-12-31,19125,23420,42545
13,13442,2012-12-31,19302,23696,42998
13,13442,2013-12-31,19450,23963,43413
13,13442,2014-12-31,19597,24241,43838
13,13442,2015-12-31,19765,24492,44257
13,13442,2016-12-31,19925,24805,44730
13,13442,2017-12-31,20081,25161,45242
13,13442,2018-12-31,20451,25661,46112
13,13442,2019-12-31,20954,26435,47389
13,13442,2020-12-31,21352,27105,48457
13,13442,2021-12-31,21353,27810,49163
13,13442,2022-12-31,21285,28401,49686
13,13442,2023-12-31,21211,28971,50182
13,13442,2024-12-31,21276,29521,50797
13,13442,2025-12-31,21384,30062,51446
13,13442,2026-12-31,21515,30546,52061
13,13442,2027-12-31,21627,31037,52664
13,13442,2028-12-31,21766,31516,53282
13,13442,2029-12-31,21883,31956,53839
13,13442,2030-12-31,22029,32379,54408
13,13442,2031-12-31,22161,32786,54947
13,13442,2032-12-31,22289,33189,55478
13,13442,2033-12-31,22393,33604,55997
13,13442,2034-12-31,22508,33991,56499
13,13442,2035-12-31,22596,34382,56978
13,13458,1985-12-31,0,0,0
13,13458,1986-12-31,0,0,0
13,13458,1987-12-31,0,0,0
13,13458,1988-12-31,0,0,0
13,13458,1989-12-31,0,0,0
13,13458,1990-12-31,0,0,0
13,13458,1991-12-31,0,0,0
13,13458,1992-12-31,0,0,0
13,13458,1993-12-31,0,0,0
13,13458,1994-12-31,0,0,0
13,13458,1995-12-31,1314,6922,8236
13,13458,1996-12-31,1421,6725,8146
13,13458,1997-12-31,1591,6839,8430
13,13458,1998-12-31,1764,6921,8685
13,13458,1999-12-31,1886,7010,8896
13,13458,2000-12-31,2011,7256,9267
13,13458,2001-12-31,2159,7513,9672
13,13458,2002-12-31,2292,7779,10071
13,13458,2003-12-31,2421,8029,10450
13,13458,2004-12-31,2537,8312,10849
13,13458,2005-12-31,2654,8558,11212
13,13458,2006-12-31,2772,8851,11623
13,13458,2007-12-31,2890,9171,12061
13,13458,2008-12-31,3021,9422,12443
13,13458,2009-12-31,3141,9584,12725
13,13458,2010-12-31,3239,9863,13102
13,13458,2011-12-31,3333,10159,13492
13,13458,2012-12-31,3454,10427,13881
13,13458,2013-12-31,3539,10713,14252
13,13458,2014-12-31,3634,11004,14638
13,13458,2015-12-31,3710,11280,14990
13,13458,2016-12-31,3831,11584,15415
13,13458,2017-12-31,3962,11915,15877
13,13458,2018-12-31,4076,12313,16389
13,13458,2019-12-31,4171,12846,17017
13,13458,2020-12-31,4247,13357,17604
13,13458,2021-12-31,4157,13707,17864
13,13458,2022-12-31,4055,13999,18054
13,13458,2023-12-31,3955,14279,18234
13,13458,2024-12-31,3941,14555,18496
13,13458,2025-12-31,3949,14822,18771
13,13458,2026-12-31,3971,15063,19034
13,13458,2027-12-31,3998,15302,19300
13,13458,2028-12-31,4018,15520,19538
13,13458,2029-12-31,4043,15743,19786
13,13458,2030-12-31,4065,15953,20018
13,13458,2031-12-31,4094,16160,20254
13,13458,2032-12-31,4116,16353,20469
13,13458,2033-12-31,4142,16550,20692
13,13458,2034-12-31,4163,16753,20916
13,13458,2035-12-31,4182,16941,21123
13,13468,1985-12-31,15754,18787,34541
13,13468,1986-12-31,16079,18782,34861
13,13468,1987-12-31,16452,18722,35174
13,13468,1988-12-31,16819,18608,35427
13,13468,1989-12-31,17303,18448,35751
13,13468,1990-12-31,17726,18261,35987
13,13468,1991-12-31,18171,18056,36227
13,13468,1992-12-31,18609,17836,36445
13,13468,1993-12-31,19056,17671,36727
13,13468,1994-12-31,19451,17506,36957
13,13468,1995-12-31,19580,17445,37025
13,13468,1996-12-31,19890,16572,36462
13,13468,1997-12-31,20282,16424,36706
13,13468,1998-12-31,20649,16314,36963
13,13468,1999-12-31,21021,16181,37202
13,13468,2000-12-31,21221,16406,37627
13,13468,2001-12-31,21412,16646,38058
13,13468,2002-12-31,21584,16908,38492
13,13468,2003-12-31,21734,17185,38919
13,13468,2004-12-31,21879,17490,39369
13,13468,2005-12-31,21989,17747,39736
13,13468,2006-12-31,22107,18043,40150
13,13468,2007-12-31,22212,18361,40573
13,13468,2008-12-31,22271,18666,40937
13,13468,2009-12-31,22448,18686,41134
13,13468,2010-12-31,22512,18975,41487
13,13468,2011-12-31,22562,19224,41786
13,13468,2012-12-31,22611,19474,42085
13,13468,2013-12-31,22669,19755,42424
13,13468,2014-12-31,22653,20014,42667
13,13468,2015-12-31,22690,20270,42960
13,13468,2016-12-31,22793,20548,43341
13,13468,2017-12-31,22814,20895,43709
13,13468,2018-12-31,23090,21352,44442
13,13468,2019-12-31,23379,22119,45498
13,13468,2020-12-31,23649,22759,46408
13,13468,2021-12-31,23733,23351,47084
13,13468,2022-12-31,23737,23848,47585
13,13468,2023-12-31,23735,24325,48060
13,13468,2024-12-31,23758,24790,48548
13,13468,2025-12-31,23784,25236,49020
13,13468,2026-12-31,23815,25664,49479
13,13468,2027-12-31,23872,26074,49946
13,13468,2028-12-31,23940,26463,50403
13,13468,2029-12-31,24006,26827,50833
13,13468,2030-12-31,24085,27166,51251
13,13468,2031-12-31,24168,27527,51695
13,13468,2032-12-31,24254,27860,52114
13,13468,2033-12-31,24329,28195,52524
13,13468,2034-12-31,24398,28515,52913
13,13468,2035-12-31,24463,28859,53322
13,13473,1985-12-31,2766,15091,17857
13,13473,1986-12-31,2927,15618,18545
13,13473,1987-12-31,3088,16107,19195
13,13473,1988-12-31,3289,16521,19810
13,13473,1989-12-31,3432,16891,20323
13,13473,1990-12-31,3609,17210,20819
13,13473,1991-12-31,3789,17517,21306
13,13473,1992-12-31,3992,17763,21755
13,13473,1993-12-31,4177,18057,22234
13,13473,1994-12-31,4364,18317,22681
13,13473,1995-12-31,4480,18658,23138
13,13473,1996-12-31,4649,9014,13663
13,13473,1997-12-31,4822,9058,13880
13,13473,1998-12-31,5018,9132,14150
13,13473,1999-12-31,5190,9189,14379
13,13473,2000-12-31,5332,9451,14783
13,13473,2001-12-31,5465,9715,15180
13,13473,2002-12-31,5604,10002,15606
13,13473,2003-12-31,5730,10282,16012
13,13473,2004-12-31,5843,10588,16431
13,13473,2005-12-31,5967,10872,16839
13,13473,2006-12-31,6091,11195,17286
13,13473,2007-12-31,6204,11509,17713
13,13473,2008-12-31,6301,11829,18130
13,13473,2009-12-31,6412,11996,18408
13,13473,2010-12-31,6505,12301,18806
13,13473,2011-12-31,6609,12610,19219
13,13473,2012-12-31,6680,12910,19590
13,13473,2013-12-31,6806,13213,20019
13,13473,2014-12-31,6887,13508,20395
13,13473,2015-12-31,6990,13825,20815
13,13473,2016-12-31,7027,14152,21179
13,13473,2017-12-31,7147,14529,21676
13,13473,2018-12-31,7293,14966,22259
13,13473,2019-12-31,7485,15361,22846
13,13473,2020-12-31,7638,15710,23348
13,13473,2021-12-31,7569,16119,23688
13,13473,2022-12-31,7479,16461,23940
13,13473,2023-12-31,7388,16791,24179
13,13473,2024-12-31,7396,17114,24510
13,13473,2025-12-31,7437,17428,24865
13,13473,2026-12-31,7476,17716,25192
13,13473,2027-12-31,7516,18003,25519
13,13473,2028-12-31,7571,18267,25838
13,13473,2029-12-31,7617,18523,26140
13,13473,2030-12-31,7651,18775,26426
13,13473,2031-12-31,7696,19003,26699
13,13473,2032-12-31,7731,19234,26965
13,13473,2033-12-31,7783,19466,27249
13,13473,2034-12-31,7813,19704,27517
13,13473,2035-12-31,7849,19929,27778
13,13490,1985-12-31,0,0,0
13,13490,1986-12-31,0,0,0
13,13490,1987-12-31,0,0,0
13,13490,1988-12-31,0,0,0
13,13490,1989-12-31,0,0,0
13,13490,1990-12-31,0,0,0
13,13490,1991-12-31,0,0,0
13,13490,1992-12-31,0,0,0
13,13490,1993-12-31,0,0,0
13,13490,1994-12-31,0,0,0
13,13490,1995-12-31,0,0,0
13,13490,1996-12-31,0,0,0
13,13490,1997-12-31,0,0,0
13,13490,1998-12-31,0,0,0
13,13490,1999-12-31,0,0,0
13,13490,2000-12-31,0,0,0
13,13490,2001-12-31,0,0,0
13,13490,2002-12-31,0,0,0
13,13490,2003-12-31,0,0,0
13,13490,2004-12-31,0,0,0
13,13490,2005-12-31,0,0,0
13,13490,2006-12-31,0,0,0
13,13490,2007-12-31,0,0,0
13,13490,2008-12-31,1141,2960,4101
13,13490,2009-12-31,1263,3283,4546
13,13490,2010-12-31,1377,3661,5038
13,13490,2011-12-31,1498,4036,5534
13,13490,2012-12-31,1614,4422,6036
13,13490,2013-12-31,1720,4801,6521
13,13490,2014-12-31,1837,5216,7053
13,13490,2015-12-31,1954,5615,7569
13,13490,2016-12-31,2077,6020,8097
13,13490,2017-12-31,2206,6432,8638
13,13490,2018-12-31,2314,6898,9212
13,13490,2019-12-31,2393,7194,9587
13,13490,2020-12-31,2470,7483,9953
13,13490,2021-12-31,2421,7679,10100
13,13490,2022-12-31,2365,7842,10207
13,13490,2023-12-31,2309,8000,10309
13,13490,2024-12-31,2302,8139,10441
13,13490,2025-12-31,2314,8286,10600
13,13490,2026-12-31,2328,8428,10756
13,13490,2027-12-31,2344,8566,10910
13,13490,2028-12-31,2358,8698,11056
13,13490,2029-12-31,2374,8819,11193
13,13490,2030-12-31,2386,8937,11323
13,13490,2031-12-31,2398,9045,11443
13,13490,2032-12-31,2412,9152,11564
13,13490,2033-12-31,2421,9273,11694
13,13490,2034-12-31,2435,9379,11814
13,13490,2035-12-31,2446,9492,11938
13,13549,1985-12-31,1218,30580,31798
13,13549,1986-12-31,1316,31068,32384
13,13549,1987-12-31,1461,31471,32932
13,13549,1988-12-31,1530,31769,33299
13,13549,1989-12-31,1583,31971,33554
13,13549,1990-12-31,1665,32098,33763
13,13549,1991-12-31,1792,32162,33954
13,13549,1992-12-31,1895,32245,34140
13,13549,1993-12-31,1982,32336,34318
13,13549,1994-12-31,2070,32464,34534
13,13549,1995-12-31,2155,19894,22049
13,13549,1996-12-31,2244,18794,21038
13,13549,1997-12-31,2296,18497,20793
13,13549,1998-12-31,2405,18215,20620
13,13549,1999-12-31,2506,17983,20489
13,13549,2000-12-31,2609,18059,20668
13,13549,2001-12-31,2667,18183,20850
13,13549,2002-12-31,2754,18317,21071
13,13549,2003-12-31,2824,18472,21296
13,13549,2004-12-31,2877,18625,21502
13,13549,2005-12-31,2964,18749,21713
13,13549,2006-12-31,3007,18914,21921
13,13549,2007-12-31,3076,19082,22158
13,13549,2008-12-31,3140,19265,22405
13,13549,2009-12-31,3188,19157,22345
13,13549,2010-12-31,3280,19277,22557
13,13549,2011-12-31,3355,19431,22786
13,13549,2012-12-31,3417,19555,22972
13,13549,2013-12-31,3467,19668,23135
13,13549,2014-12-31,3498,19791,23289
13,13549,2015-12-31,3524,19891,23415
13,13549,2016-12-31,3588,20025,23613
13,13549,2017-12-31,3645,20191,23836
13,13549,2018-12-31,3718,20500,24218
13,13549,2019-12-31,3814,20619,24433
13,13549,2020-12-31,3892,20814,24706
13,13549,2021-12-31,3710,21356,25066
13,13549,2022-12-31,3523,21810,25333
13,13549,2023-12-31,3338,22247,25585
13,13549,2024-12-31,3291,22692,25983
13,13549,2025-12-31,3300,23093,26393
13,13549,2026-12-31,3305,23457,26762
13,13549,2027-12-31,3333,23838,27171
13,13549,2028-12-31,3353,24196,27549
13,13549,2029-12-31,3366,24522,27888
13,13549,2030-12-31,3390,24854,28244
13,13549,2031-12-31,3416,25154,28570
13,13549,2032-12-31,3422,25479,28901
13,13549,2033-12-31,3442,25782,29224
13,13549,2034-12-31,3454,26093,29547
13,13549,2035-12-31,3477,26395,29872
13,13580,1985-12-31,0,0,0
13,13580,1986-12-31,0,0,0
13,13580,1987-12-31,0,0,0
13,13580,1988-12-31,0,0,0
13,13580,1989-12-31,0,0,0
13,13580,1990-12-31,0,0,0
13,13580,1991-12-31,0,0,0
13,13580,1992-12-31,0,0,0
13,13580,1993-12-31,0,0,0
13,13580,1994-12-31,0,0,0
13,13580,1995-12-31,0,0,0
13,13580,1996-12-31,1255,3184,4439
13,13580,1997-12-31,1379,3074,4453
13,13580,1998-12-31,1547,2993,4540
13,13580,1999-12-31,1730,2905,4635
13,13580,2000-12-31,1874,2882,4756
13,13580,2001-12-31,2054,2869,4923
13,13580,2002-12-31,2172,2856,5028
13,13580,2003-12-31,2298,2847,5145
13,13580,2004-12-31,2462,2831,5293
13,13580,2005-12-31,2608,2797,5405
13,13580,2006-12-31,2725,2792,5517
13,13580,2007-12-31,2869,2789,5658
13,13580,2008-12-31,2988,2763,5751
13,13580,2009-12-31,3148,2701,5849
13,13580,2010-12-31,3258,2693,5951
13,13580,2011-12-31,3386,2650,6036
13,13580,2012-12-31,3498,2637,6135
13,13580,2013-12-31,3608,2606,6214
13,13580,2014-12-31,3733,2593,6326
13,13580,2015-12-31,3822,2545,6367
13,13580,2016-12-31,3956,2555,6511
13,13580,2017-12-31,4119,2536,6655
13,13580,2018-12-31,4223,2500,6723
13,13580,2019-12-31,4381,2602,6983
13,13580,2020-12-31,4544,2683,7227
13,13580,2021-12-31,4581,2753,7334
13,13580,2022-12-31,4601,2811,7412
13,13580,2023-12-31,4618,2868,7486
13,13580,2024-12-31,4648,2921,7569
13,13580,2025-12-31,4688,2979,7667
13,13580,2026-12-31,4707,3030,7737
13,13580,2027-12-31,4737,3072,7809
13,13580,2028-12-31,4767,3124,7891
13,13580,2029-12-31,4797,3172,7969
13,13580,2030-12-31,4825,3218,8043
13,13580,2031-12-31,4857,3246,8103
13,13580,2032-12-31,4874,3291,8165
13,13580,2033-12-31,4905,3326,8231
13,13580,2034-12-31,4932,3357,8289
13,13580,2035-12-31,4948,3395,8343
13,13600,1985-12-31,2587,17878,20465
13,13600,1986-12-31,2694,18191,20885
13,13600,1987-12-31,2766,18439,21205
13,13600,1988-12-31,2889,18628,21517
13,13600,1989-12-31,2961,18769,21730
13,13600,1990-12-31,3097,18864,21961
13,13600,1991-12-31,3198,18964,22162
13,13600,1992-12-31,3307,18992,22299
13,13600,1993-12-31,3439,19091,22530
13,13600,1994-12-31,3541,19143,22684
13,13600,1995-12-31,3599,19307,22906
13,13600,1996-12-31,3699,12033,15732
13,13600,1997-12-31,3806,11648,15454
13,13600,1998-12-31,3930,11305,15235
13,13600,1999-12-31,4028,10946,14974
13,13600,2000-12-31,4107,10825,14932
13,13600,2001-12-31,4190,10722,14912
13,13600,2002-12-31,4251,10628,14879
13,13600,2003-12-31,4316,10532,14848
13,13600,2004-12-31,4369,10432,14801
13,13600,2005-12-31,4426,10309,14735
13,13600,2006-12-31,4485,10219,14704
13,13600,2007-12-31,4546,10117,14663
13,13600,2008-12-31,4593,6791,11384
13,13600,2009-12-31,4646,6592,11238
13,13600,2010-12-31,4723,6496,11219
13,13600,2011-12-31,4742,6374,11116
13,13600,2012-12-31,4777,6249,11026
13,13600,2013-12-31,4821,6140,10961
13,13600,2014-12-31,4865,5966,10831
13,13600,2015-12-31,4869,5878,10747
13,13600,2016-12-31,4913,5734,10647
13,13600,2017-12-31,5038,5606,10644
13,13600,2018-12-31,5071,5527,10598
13,13600,2019-12-31,5202,5436,10638
13,13600,2020-12-31,5307,5429,10736
13,13600,2021-12-31,5322,5570,10892
13,13600,2022-12-31,5319,5689,11008
13,13600,2023-12-31,5315,5803,11118
13,13600,2024-12-31,5342,5912,11254
13,13600,2025-12-31,5373,6019,11392
13,13600,2026-12-31,5408,6126,11534
13,13600,2027-12-31,5428,6220,11648
13,13600,2028-12-31,5464,6313,11777
13,13600,2029-12-31,5503,6387,11890
13,13600,2030-12-31,5532,6479,12011
13,13600,2031-12-31,5566,6556,12122
13,13600,2032-12-31,5597,6638,12235
13,13600,2033-12-31,5628,6717,12345
13,13600,2034-12-31,5653,6794,12447
13,13600,2035-12-31,5670,6873,12543
13,13620,1985-12-31,0,0,0
13,13620,1986-12-31,0,0,0
13,13620,1987-12-31,0,0,0
13,13620,1988-12-31,0,0,0
13,13620,1989-12-31,0,0,0
13,13620,1990-12-31,0,0,0
13,13620,1991-12-31,0,0,0
13,13620,1992-12-31,0,0,0
13,13620,1993-12-31,0,0,0
13,13620,1994-12-31,0,0,0
13,13620,1995-12-31,0,0,0
13,13620,1996-12-31,3895,2583,6478
13,13620,1997-12-31,4058,2508,6566
13,13620,1998-12-31,4212,2439,6651
13,13620,1999-12-31,4359,2361,6720
13,13620,2000-12-31,4480,2315,6795
13,13620,2001-12-31,4618,2316,6934
13,13620,2002-12-31,4723,2278,7001
13,13620,2003-12-31,4835,2288,7123
13,13620,2004-12-31,4970,2234,7204
13,13620,2005-12-31,5051,2212,7263
13,13620,2006-12-31,5140,2189,7329
13,13620,2007-12-31,5259,2189,7448
13,13620,2008-12-31,5346,2169,7515
13,13620,2009-12-31,5447,2117,7564
13,13620,2010-12-31,5541,2085,7626
13,13620,2011-12-31,5637,2044,7681
13,13620,2012-12-31,5706,1999,7705
13,13620,2013-12-31,5768,1973,7741
13,13620,2014-12-31,5870,1950,7820
13,13620,2015-12-31,5928,1923,7851
13,13620,2016-12-31,6032,1927,7959
13,13620,2017-12-31,6116,1856,7972
13,13620,2018-12-31,6221,1833,8054
13,13620,2019-12-31,6409,1921,8330
13,13620,2020-12-31,6575,1994,8569
13,13620,2021-12-31,6650,2046,8696
13,13620,2022-12-31,6698,2090,8788
13,13620,2023-12-31,6744,2132,8876
13,13620,2024-12-31,6793,2179,8972
13,13620,2025-12-31,6839,2210,9049
13,13620,2026-12-31,6871,2243,9114
13,13620,2027-12-31,6923,2283,9206
13,13620,2028-12-31,6954,2318,9272
13,13620,2029-12-31,6995,2353,9348
13,13620,2030-12-31,7042,2377,9419
13,13620,2031-12-31,7076,2424,9500
13,13620,2032-12-31,7121,2441,9562
13,13620,2033-12-31,7163,2473,9636
13,13620,2034-12-31,7190,2507,9697
13,13620,2035-12-31,7215,2530,9745
13,13647,1985-12-31,7721,4740,12461
13,13647,1986-12-31,7946,4756,12702
13,13647,1987-12-31,8135,4747,12882
13,13647,1988-12-31,8372,4708,13080
13,13647,1989-12-31,8632,4673,13305
13,13647,1990-12-31,8914,4643,13557
13,13647,1991-12-31,9162,4601,13763
13,13647,1992-12-31,9418,4583,14001
13,13647,1993-12-31,9672,4562,14234
13,13647,1994-12-31,9903,4514,14417
13,13647,1995-12-31,10011,4488,14499
13,13647,1996-12-31,10213,4293,14506
13,13647,1997-12-31,10433,4252,14685
13,13647,1998-12-31,10645,4221,14866
13,13647,1999-12-31,10877,4203,15080
13,13647,2000-12-31,11000,4277,15277
13,13647,2001-12-31,11150,4346,15496
13,13647,2002-12-31,11265,4407,15672
13,13647,2003-12-31,11387,4480,15867
13,13647,2004-12-31,11473,4570,16043
13,13647,2005-12-31,11567,4658,16225
13,13647,2006-12-31,11669,4739,16408
13,13647,2007-12-31,11753,4814,16567
13,13647,2008-12-31,11787,4925,16712
13,13647,2009-12-31,11931,4931,16862
13,13647,2010-12-31,11991,5029,17020
13,13647,2011-12-31,12032,5086,17118
13,13647,2012-12-31,12083,5176,17259
13,13647,2013-12-31,12128,5258,17386
13,13647,2014-12-31,12188,5345,17533
13,13647,2015-12-31,12266,5408,17674
13,13647,2016-12-31,12270,5507,17777
13,13647,2017-12-31,12382,5592,17974
13,13647,2018-12-31,12528,5723,18251
13,13647,2019-12-31,12664,6065,18729
13,13647,2020-12-31,12791,6337,19128
13,13647,2021-12-31,12904,6503,19407
13,13647,2022-12-31,12972,6641,19613
13,13647,2023-12-31,13034,6775,19809
13,13647,2024-12-31,13104,6902,20006
13,13647,2025-12-31,13181,7004,20185
13,13647,2026-12-31,13257,7134,20391
13,13647,2027-12-31,13337,7247,20584
13,13647,2028-12-31,13414,7355,20769
13,13647,2029-12-31,13501,7462,20963
13,13647,2030-12-31,13567,7556,21123
13,13647,2031-12-31,13647,7650,21297
13,13647,2032-12-31,13729,7748,21477
13,13647,2033-12-31,13794,7856,21650
13,13647,2034-12-31,13862,7937,21799
13,13647,2035-12-31,13932,8035,21967
13,13650,1985-12-31,1535,8841,10376
13,13650,1986-12-31,1612,8936,10548
13,13650,1987-12-31,1642,8970,10612
13,13650,1988-12-31,1662,9012,10674
13,13650,1989-12-31,1679,8978,10657
13,13650,1990-12-31,1682,8963,10645
13,13650,1991-12-31,1734,8955,10689
13,13650,1992-12-31,1770,8917,10687
13,13650,1993-12-31,1806,8893,10699
13,13650,1994-12-31,1890,8899,10789
13,13650,1995-12-31,1851,8468,10319
13,13650,1996-12-31,1940,8061,10001
13,13650,1997-12-31,1931,7991,9922
13,13650,1998-12-31,1990,7945,9935
13,13650,1999-12-31,2023,7898,9921
13,13650,2000-12-31,2040,7991,10031
13,13650,2001-12-31,2055,8121,10176
13,13650,2002-12-31,2051,8228,10279
13,13650,2003-12-31,2075,8355,10430
13,13650,2004-12-31,2098,8513,10611
13,13650,2005-12-31,2073,8623,10696
13,13650,2006-12-31,2084,8777,10861
13,13650,2007-12-31,2094,8920,11014
13,13650,2008-12-31,2117,9061,11178
13,13650,2009-12-31,2128,9097,11225
13,13650,2010-12-31,2128,9238,11366
13,13650,2011-12-31,2129,9364,11493
13,13650,2012-12-31,2100,9509,11609
13,13650,2013-12-31,2055,9615,11670
13,13650,2014-12-31,2132,9720,11852
13,13650,2015-12-31,2136,9815,11951
13,13650,2016-12-31,2118,9989,12107
13,13650,2017-12-31,2124,10126,12250
13,13650,2018-12-31,2147,10389,12536
13,13650,2019-12-31,2202,10611,12813
13,13650,2020-12-31,2245,10780,13025
13,13650,2021-12-31,2155,11060,13215
13,13650,2022-12-31,2059,11296,13355
13,13650,2023-12-31,1967,11522,13489
13,13650,2024-12-31,1943,11739,13682
13,13650,2025-12-31,1951,11951,13902
13,13650,2026-12-31,1955,12154,14109
13,13650,2027-12-31,1966,12348,14314
13,13650,2028-12-31,1984,12527,14511
13,13650,2029-12-31,1990,12705,14695
13,13650,2030-12-31,2002,12866,14868
13,13650,2031-12-31,2017,13040,15057
13,13650,2032-12-31,2028,13190,15218
13,13650,2033-12-31,2043,13342,15385
13,13650,2034-12-31,2049,13500,15549
13,13650,2035-12-31,2052,13656,15708
13,13654,1985-12-31,14692,8821,23513
13,13654,1986-12-31,14975,8599,23574
13,13654,1987-12-31,15302,8336,23638
13,13654,1988-12-31,15625,8081,23706
13,13654,1989-12-31,16038,7798,23836
13,13654,1990-12-31,16392,7514,23906
13,13654,1991-12-31,16787,7234,24021
13,13654,1992-12-31,17168,6966,24134
13,13654,1993-12-31,17548,6689,24237
13,13654,1994-12-31,17883,6440,24323
13,13654,1995-12-31,17997,6233,24230
13,13654,1996-12-31,18259,5745,24004
13,13654,1997-12-31,18593,5541,24134
13,13654,1998-12-31,18880,5354,24234
13,13654,1999-12-31,19216,5097,24313
13,13654,2000-12-31,19397,5030,24427
13,13654,2001-12-31,19542,4943,24485
13,13654,2002-12-31,19660,4842,24502
13,13654,2003-12-31,19781,4792,24573
13,13654,2004-12-31,19871,4687,24558
13,13654,2005-12-31,19974,4593,24567
13,13654,2006-12-31,20046,4517,24563
13,13654,2007-12-31,20103,4412,24515
13,13654,2008-12-31,20136,4345,24481
13,13654,2009-12-31,20284,4184,24468
13,13654,2010-12-31,20345,4078,24423
13,13654,2011-12-31,20369,3989,24358
13,13654,2012-12-31,20379,3878,24257
13,13654,2013-12-31,20371,3761,24132
13,13654,2014-12-31,20388,3640,24028
13,13654,2015-12-31,20422,3525,23947
13,13654,2016-12-31,20477,3411,23888
13,13654,2017-12-31,20538,3314,23852
13,13654,2018-12-31,20711,3202,23913
13,13654,2019-12-31,20924,3308,24232
13,13654,2020-12-31,21121,3431,24552
13,13654,2021-12-31,21395,3515,24910
13,13654,2022-12-31,21586,3589,25175
13,13654,2023-12-31,21765,3661,25426
13,13654,2024-12-31,21894,3719,25613
13,13654,2025-12-31,22029,3792,25821
13,13654,2026-12-31,22172,3846,26018
13,13654,2027-12-31,22303,3911,26214
13,13654,2028-12-31,22451,3977,26428
13,13654,2029-12-31,22569,4030,26599
13,13654,2030-12-31,22709,4079,26788
13,13654,2031-12-31,22841,4128,26969
13,13654,2032-12-31,22978,4176,27154
13,13654,2033-12-31,23084,4226,27310
13,13654,2034-12-31,23179,4280,27459
13,13654,2035-12-31,23288,4329,27617
13,13655,1985-12-31,0,0,0
13,13655,1986-12-31,0,0,0
13,13655,1987-12-31,0,0,0
13,13655,1988-12-31,0,0,0
13,13655,1989-12-31,0,0,0
13,13655,1990-12-31,0,0,0
13,13655,1991-12-31,0,0,0
13,13655,1992-12-31,0,0,0
13,13655,1993-12-31,0,0,0
13,13655,1994-12-31,0,0,0
13,13655,1995-12-31,0,0,0
13,13655,1996-12-31,0,0,0
13,13655,1997-12-31,844,4779,5623
13,13655,1998-12-31,929,4770,5699
13,13655,1999-12-31,1030,4808,5838
13,13655,2000-12-31,1127,4924,6051
13,13655,2001-12-31,1223,5041,6264
13,13655,2002-12-31,1307,5151,6458
13,13655,2003-12-31,1411,5280,6691
13,13655,2004-12-31,1484,5429,6913
13,13655,2005-12-31,1567,5543,7110
13,13655,2006-12-31,1652,5691,7343
13,13655,2007-12-31,1736,5832,7568
13,13655,2008-12-31,1824,5971,7795
13,13655,2009-12-31,1909,6038,7947
13,13655,2010-12-31,1983,6170,8153
13,13655,2011-12-31,2067,6302,8369
13,13655,2012-12-31,2131,6428,8559
13,13655,2013-12-31,2202,6560,8762
13,13655,2014-12-31,2227,6677,8904
13,13655,2015-12-31,2314,6852,9166
13,13655,2016-12-31,2398,6981,9379
13,13655,2017-12-31,2512,7140,9652
13,13655,2018-12-31,2566,7369,9935
13,13655,2019-12-31,2651,7654,10305
13,13655,2020-12-31,2732,7911,10643
13,13655,2021-12-31,2683,8117,10800
13,13655,2022-12-31,2626,8289,10915
13,13655,2023-12-31,2569,8455,11024
13,13655,2024-12-31,2568,8607,11175
13,13655,2025-12-31,2579,8768,11347
13,13655,2026-12-31,2592,8914,11506
13,13655,2027-12-31,2607,9053,11660
13,13655,2028-12-31,2621,9188,11809
13,13655,2029-12-31,2644,9312,11956
13,13655,2030-12-31,2651,9432,12083
13,13655,2031-12-31,2658,9559,12217
13,13655,2032-12-31,2687,9673,12360
13,13655,2033-12-31,2699,9778,12477
13,13655,2034-12-31,2703,9907,12610
13,13655,2035-12-31,2725,10011,12736
13,13657,1985-12-31,14392,13934,28326
13,13657,1986-12-31,14894,13734,28628
13,13657,1987-12-31,15373,13475,28848
13,13657,1988-12-31,15940,13205,29145
13,13657,1989-12-31,16590,12888,29478
13,13657,1990-12-31,17187,12556,29743
13,13657,1991-12-31,17790,12249,30039
13,13657,1992-12-31,18400,11921,30321
13,13657,1993-12-31,19023,11627,30650
13,13657,1994-12-31,19605,11323,30928
13,13657,1995-12-31,19916,11093,31009
13,13657,1996-12-31,20416,10400,30816
13,13657,1997-12-31,21001,10146,31147
13,13657,1998-12-31,21553,9937,31490
13,13657,1999-12-31,22126,9707,31833
13,13657,2000-12-31,22514,9676,32190
13,13657,2001-12-31,22898,9671,32569
13,13657,2002-12-31,23257,9667,32924
13,13657,2003-12-31,23585,9682,33267
13,13657,2004-12-31,23858,9648,33506
13,13657,2005-12-31,24198,9701,33899
13,13657,2006-12-31,24477,9711,34188
13,13657,2007-12-31,24745,9717,34462
13,13657,2008-12-31,24986,9718,34704
13,13657,2009-12-31,25317,9592,34909
13,13657,2010-12-31,25549,9589,35138
13,13657,2011-12-31,25756,9555,35311
13,13657,2012-12-31,25954,9554,35508
13,13657,2013-12-31,26157,9514,35671
13,13657,2014-12-31,26314,9491,35805
13,13657,2015-12-31,26475,9436,35911
13,13657,2016-12-31,26768,9450,36218
13,13657,2017-12-31,26882,9442,36324
13,13657,2018-12-31,27379,9495,36874
13,13657,2019-12-31,28016,9749,37765
13,13657,2020-12-31,28513,10016,38529
13,13657,2021-12-31,28813,10277,39090
13,13657,2022-12-31,29011,10495,39506
13,13657,2023-12-31,29195,10705,39900
13,13657,2024-12-31,29378,10928,40306
13,13657,2025-12-31,29547,11108,40655
13,13657,2026-12-31,29743,11304,41047
13,13657,2027-12-31,29912,11473,41385
13,13657,2028-12-31,30095,11644,41739
13,13657,2029-12-31,30287,11802,42089
13,13657,2030-12-31,30466,11965,42431
13,13657,2031-12-31,30637,12094,42731
13,13657,2032-12-31,30806,12254,43060
13,13657,2033-12-31,30946,12389,43335
13,13657,2034-12-31,31112,12534,43646
13,13657,2035-12-31,31249,12674,43923
13,13667,1985-12-31,3059,23686,26745
13,13667,1986-12-31,3235,23969,27204
13,13667,1987-12-31,3381,24184,27565
13,13667,1988-12-31,3521,24331,27852
13,13667,1989-12-31,3665,24395,28060
13,13667,1990-12-31,3857,24391,28248
13,13667,1991-12-31,3996,24349,28345
13,13667,1992-12-31,4187,24330,28517
13,13667,1993-12-31,4363,24320,28683
13,13667,1994-12-31,4533,24362,28895
13,13667,1995-12-31,4652,12196,16848
13,13667,1996-12-31,4797,23917,28714
13,13667,1997-12-31,4957,22794,27751
13,13667,1998-12-31,5115,21744,26859
13,13667,1999-12-31,5279,20698,25977
13,13667,2000-12-31,5414,20087,25501
13,13667,2001-12-31,5526,19495,25021
13,13667,2002-12-31,5636,18892,24528
13,13667,2003-12-31,5764,18304,24068
13,13667,2004-12-31,5849,17712,23561
13,13667,2005-12-31,5968,17071,23039
13,13667,2006-12-31,6054,16431,22485
13,13667,2007-12-31,6149,15829,21978
13,13667,2008-12-31,6231,15197,21428
13,13667,2009-12-31,6343,14330,20673
13,13667,2010-12-31,6425,13643,20068
13,13667,2011-12-31,6488,12938,19426
13,13667,2012-12-31,6556,12223,18779
13,13667,2013-12-31,6639,11478,18117
13,13667,2014-12-31,6715,10730,17445
13,13667,2015-12-31,6784,9967,16751
13,13667,2016-12-31,6853,9223,16076
13,13667,2017-12-31,6943,8450,15393
13,13667,2018-12-31,7051,7723,14774
13,13667,2019-12-31,7206,7586,14792
13,13667,2020-12-31,7327,7570,14897
13,13667,2021-12-31,7347,7767,15114
13,13667,2022-12-31,7343,7932,15275
13,13667,2023-12-31,7336,8091,15427
13,13667,2024-12-31,7359,8249,15608
13,13667,2025-12-31,7385,8388,15773
13,13667,2026-12-31,7432,8536,15968
13,13667,2027-12-31,7473,8665,16138
13,13667,2028-12-31,7518,8791,16309
13,13667,2029-12-31,7559,8918,16477
13,13667,2030-12-31,7601,9017,16618
13,13667,2031-12-31,7651,9143,16794
13,13667,2032-12-31,7685,9255,16940
13,13667,2033-12-31,7716,9369,17085
13,13667,2034-12-31,7764,9481,17245
13,13667,2035-12-31,7807,9584,17391
13,13670,1985-12-31,5314,12056,17370
13,13670,1986-12-31,5809,12198,18007
13,13670,1987-12-31,6314,12311,18625
13,13670,1988-12-31,6890,12378,19268
13,13670,1989-12-31,7423,12420,19843
13,13670,1990-12-31,7990,12428,20418
13,13670,1991-12-31,8587,12445,21032
13,13670,1992-12-31,9133,12443,21576
13,13670,1993-12-31,9747,12420,22167
13,13670,1994-12-31,10356,12424,22780
13,13670,1995-12-31,10802,8757,19559
13,13670,1996-12-31,11359,8164,19523
13,13670,1997-12-31,11958,7926,19884
13,13670,1998-12-31,12535,7715,20250
13,13670,1999-12-31,13140,7483,20623
13,13670,2000-12-31,13642,7416,21058
13,13670,2001-12-31,14124,7364,21488
13,13670,2002-12-31,14591,7320,21911
13,13670,2003-12-31,15049,7281,22330
13,13670,2004-12-31,15493,7228,22721
13,13670,2005-12-31,15919,7194,23113
13,13670,2006-12-31,16324,7156,23480
13,13670,2007-12-31,16744,7109,23853
13,13670,2008-12-31,17129,7064,24193
13,13670,2009-12-31,17576,6927,24503
13,13670,2010-12-31,17942,6867,24809
13,13670,2011-12-31,18298,6818,25116
13,13670,2012-12-31,18656,6742,25398
13,13670,2013-12-31,18979,6670,25649
13,13670,2014-12-31,19295,6593,25888
13,13670,2015-12-31,19622,6524,26146
13,13670,2016-12-31,19993,6443,26436
13,13670,2017-12-31,20320,6377,26697
13,13670,2018-12-31,20829,6361,27190
13,13670,2019-12-31,22052,5991,28043
13,13670,2020-12-31,23062,5679,28741
13,13670,2021-12-31,23338,5827,29165
13,13670,2022-12-31,23525,5951,29476
13,13670,2023-12-31,23700,6070,29770
13,13670,2024-12-31,23863,6179,30042
13,13670,2025-12-31,24011,6291,30302
13,13670,2026-12-31,24160,6400,30560
13,13670,2027-12-31,24310,6510,30820
13,13670,2028-12-31,24449,6603,31052
13,13670,2029-12-31,24598,6694,31292
13,13670,2030-12-31,24760,6792,31552
13,13670,2031-12-31,24900,6876,31776
13,13670,2032-12-31,25049,6956,32005
13,13670,2033-12-31,25172,7036,32208
13,13670,2034-12-31,25293,7110,32403
13,13670,2035-12-31,25398,7196,32594
13,13673,1985-12-31,3263,13883,17146
13,13673,1986-12-31,3359,14412,17771
13,13673,1987-12-31,3444,14898,18342
13,13673,1988-12-31,3587,15297,18884
13,13673,1989-12-31,3661,15659,19320
13,13673,1990-12-31,3776,15995,19771
13,13673,1991-12-31,3878,16265,20143
13,13673,1992-12-31,4040,16542,20582
13,13673,1993-12-31,4168,16826,20994
13,13673,1994-12-31,4270,17096,21366
13,13673,1995-12-31,4311,17465,21776
13,13673,1996-12-31,4416,6729,11145
13,13673,1997-12-31,4536,6686,11222
13,13673,1998-12-31,4643,6656,11299
13,13673,1999-12-31,4747,6601,11348
13,13673,2000-12-31,4812,6705,11517
13,13673,2001-12-31,4889,6797,11686
13,13673,2002-12-31,4949,6920,11869
13,13673,2003-12-31,5013,7041,12054
13,13673,2004-12-31,5088,7152,12240
13,13673,2005-12-31,5129,7300,12429
13,13673,2006-12-31,5173,7408,12581
13,13673,2007-12-31,5218,7552,12770
13,13673,2008-12-31,5268,7682,12950
13,13673,2009-12-31,5320,7687,13007
13,13673,2010-12-31,5336,7821,13157
13,13673,2011-12-31,5390,7958,13348
13,13673,2012-12-31,5426,8067,13493
13,13673,2013-12-31,5440,8188,13628
13,13673,2014-12-31,5462,8297,13759
13,13673,2015-12-31,5422,8408,13830
13,13673,2016-12-31,5491,8570,14061
13,13673,2017-12-31,5560,8707,14267
13,13673,2018-12-31,5666,8897,14563
13,13673,2019-12-31,5792,8955,14747
13,13673,2020-12-31,5888,9060,14948
13,13673,2021-12-31,5870,9296,15166
13,13673,2022-12-31,5834,9493,15327
13,13673,2023-12-31,5796,9684,15480
13,13673,2024-12-31,5804,9867,15671
13,13673,2025-12-31,5817,10053,15870
13,13673,2026-12-31,5854,10213,16067
13,13673,2027-12-31,5883,10395,16278
13,13673,2028-12-31,5924,10542,16466
13,13673,2029-12-31,5961,10672,16633
13,13673,2030-12-31,5998,10814,16812
13,13673,2031-12-31,6031,10961,16992
13,13673,2032-12-31,6060,11094,17154
13,13673,2033-12-31,6100,11223,17323
13,13673,2034-12-31,6117,11367,17484
13,13673,2035-12-31,6142,11491,17633
13,13683,1985-12-31,6886,1862,8748
13,13683,1986-12-31,7283,1863,9146
13,13683,1987-12-31,7728,1810,9538
13,13683,1988-12-31,8191,1791,9982
13,13683,1989-12-31,8695,1767,10462
13,13683,1990-12-31,9180,1732,10912
13,13683,1991-12-31,9676,1680,11356
13,13683,1992-12-31,10170,1670,11840
13,13683,1993-12-31,10700,1659,12359
13,13683,1994-12-31,11186,1618,12804
13,13683,1995-12-31,11548,1593,13141
13,13683,1996-12-31,11985,1508,13493
13,13683,1997-12-31,12496,1476,13972
13,13683,1998-12-31,12972,1457,14429
13,13683,1999-12-31,13474,1452,14926
13,13683,2000-12-31,13863,1434,15297
13,13683,2001-12-31,14258,1445,15703
13,13683,2002-12-31,14622,1440,16062
13,13683,2003-12-31,14974,1443,16417
13,13683,2004-12-31,15317,1467,16784
13,13683,2005-12-31,15629,1497,17126
13,13683,2006-12-31,15976,1512,17488
13,13683,2007-12-31,16270,1507,17777
13,13683,2008-12-31,16554,1526,18080
13,13683,2009-12-31,16915,1507,18422
13,13683,2010-12-31,17174,1542,18716
13,13683,2011-12-31,17465,1524,18989
13,13683,2012-12-31,17744,1537,19281
13,13683,2013-12-31,17943,1550,19493
13,13683,2014-12-31,18194,1575,19769
13,13683,2015-12-31,18454,1603,20057
13,13683,2016-12-31,18665,1626,20291
13,13683,2017-12-31,18940,1635,20575
13,13683,2018-12-31,19356,1607,20963
13,13683,2019-12-31,19863,1903,21766
13,13683,2020-12-31,20268,2141,22409
13,13683,2021-12-31,20543,2197,22740
13,13683,2022-12-31,20738,2244,22982
13,13683,2023-12-31,20922,2289,23211
13,13683,2024-12-31,21100,2335,23435
13,13683,2025-12-31,21280,2375,23655
13,13683,2026-12-31,21452,2412,23864
13,13683,2027-12-31,21602,2447,24049
13,13683,2028-12-31,21750,2489,24239
13,13683,2029-12-31,21900,2521,24421
13,13683,2030-12-31,22032,2540,24572
13,13683,2031-12-31,22162,2588,24750
13,13683,2032-12-31,22303,2615,24918
13,13683,2033-12-31,22418,2646,25064
13,13683,2034-12-31,22522,2682,25204
13,13683,2035-12-31,22626,2711,25337
13,13688,1985-12-31,2212,9956,12168
13,13688,1986-12-31,2723,10012,12735
13,13688,1987-12-31,3265,10043,13308
13,13688,1988-12-31,3806,10071,13877
13,13688,1989-12-31,4335,10057,14392
13,13688,1990-12-31,4933,10042,14975
13,13688,1991-12-31,5519,10010,15529
13,13688,1992-12-31,6139,9967,16106
13,13688,1993-12-31,6748,9901,16649
13,13688,1994-12-31,7362,9873,17235
13,13688,1995-12-31,7871,9881,17752
13,13688,1996-12-31,8484,9459,17943
13,13688,1997-12-31,9091,9407,18498
13,13688,1998-12-31,9717,9382,19099
13,13688,1999-12-31,10355,9367,19722
13,13688,2000-12-31,10897,9529,20426
13,13688,2001-12-31,11440,9715,21155
13,13688,2002-12-31,11977,9913,21890
13,13688,2003-12-31,12483,10125,22608
13,13688,2004-12-31,13002,10323,23325
13,13688,2005-12-31,13484,10566,24050
13,13688,2006-12-31,13971,10799,24770
13,13688,2007-12-31,14442,11036,25478
13,13688,2008-12-31,14898,11264,26162
13,13688,2009-12-31,15413,11341,26754
13,13688,2010-12-31,15837,11564,27401
13,13688,2011-12-31,16268,11777,28045
13,13688,2012-12-31,16675,11996,28671
13,13688,2013-12-31,17070,12198,29268
13,13688,2014-12-31,17450,12413,29863
13,13688,2015-12-31,17849,12649,30498
13,13688,2016-12-31,18261,12819,31080
13,13688,2017-12-31,18690,13066,31756
13,13688,2018-12-31,19214,13432,32646
13,13688,2019-12-31,20230,13471,33701
13,13688,2020-12-31,20993,13575,34568
13,13688,2021-12-31,21151,13928,35079
13,13688,2022-12-31,21228,14224,35452
13,13688,2023-12-31,21297,14509,35806
13,13688,2024-12-31,21418,14777,36195
13,13688,2025-12-31,21574,15039,36613
13,13688,2026-12-31,21694,15299,36993
13,13688,2027-12-31,21830,15532,37362
13,13688,2028-12-31,21963,15771,37734
13,13688,2029-12-31,22094,15994,38088
13,13688,2030-12-31,22220,16197,38417
13,13688,2031-12-31,22356,16404,38760
13,13688,2032-12-31,22477,16603,39080
13,13688,2033-12-31,22606,16813,39419
13,13688,2034-12-31,22701,17009,39710
13,13688,2035-12-31,22788,17214,40002
13,13744,1985-12-31,3163,5294,8457
13,13744,1986-12-31,3264,5471,8735
13,13744,1987-12-31,3387,5700,9087
13,13744,1988-12-31,3535,5810,9345
13,13744,1989-12-31,3623,5961,9584
13,13744,1990-12-31,3786,6078,9864
13,13744,1991-12-31,3891,6204,10095
13,13744,1992-12-31,4048,6308,10356
13,13744,1993-12-31,4184,6414,10598
13,13744,1994-12-31,4333,6511,10844
13,13744,1995-12-31,4393,6695,11088
13,13744,1996-12-31,4508,6486,10994
13,13744,1997-12-31,4636,6567,11203
13,13744,1998-12-31,4756,6670,11426
13,13744,1999-12-31,4876,6770,11646
13,13744,2000-12-31,4970,6998,11968
13,13744,2001-12-31,5051,7231,12282
13,13744,2002-12-31,5135,7497,12632
13,13744,2003-12-31,5207,7758,12965
13,13744,2004-12-31,5288,8018,13306
13,13744,2005-12-31,5352,8302,13654
13,13744,2006-12-31,5406,8581,13987
13,13744,2007-12-31,5474,8878,14352
13,13744,2008-12-31,5528,9171,14699
13,13744,2009-12-31,5604,9346,14950
13,13744,2010-12-31,5654,9623,15277
13,13744,2011-12-31,5701,9915,15616
13,13744,2012-12-31,5753,10188,15941
13,13744,2013-12-31,5770,10462,16232
13,13744,2014-12-31,5859,10749,16608
13,13744,2015-12-31,5852,11043,16895
13,13744,2016-12-31,5919,11341,17260
13,13744,2017-12-31,5996,11660,17656
13,13744,2018-12-31,6063,12047,18110
13,13744,2019-12-31,6219,12459,18678
13,13744,2020-12-31,6345,12798,19143
13,13744,2021-12-31,6295,13131,19426
13,13744,2022-12-31,6222,13410,19632
13,13744,2023-12-31,6149,13679,19828
13,13744,2024-12-31,6146,13943,20089
13,13744,2025-12-31,6188,14186,20374
13,13744,2026-12-31,6215,14408,20623
13,13744,2027-12-31,6252,14644,20896
13,13744,2028-12-31,6289,14862,21151
13,13744,2029-12-31,6331,15077,21408
13,13744,2030-12-31,6364,15295,21659
13,13744,2031-12-31,6391,15464,21855
13,13744,2032-12-31,6448,15651,22099
13,13744,2033-12-31,6464,15829,22293
13,13744,2034-12-31,6498,16028,22526
13,13744,2035-12-31,6531,16221,22752
13,13760,1985-12-31,5842,6036,11878
13,13760,1986-12-31,6025,6136,12161
13,13760,1987-12-31,6230,6170,12400
13,13760,1988-12-31,6433,6257,12690
13,13760,1989-12-31,6623,6289,12912
13,13760,1990-12-31,6891,6326,13217
13,13760,1991-12-31,7122,6340,13462
13,13760,1992-12-31,7340,6350,13690
13,13760,1993-12-31,7563,6378,13941
13,13760,1994-12-31,7760,6391,14151
13,13760,1995-12-31,7878,6450,14328
13,13760,1996-12-31,8042,414,8456
13,13760,1997-12-31,8269,404,8673
13,13760,1998-12-31,8468,400,8868
13,13760,1999-12-31,8660,381,9041
13,13760,2000-12-31,8807,361,9168
13,13760,2001-12-31,8942,351,9293
13,13760,2002-12-31,9055,347,9402
13,13760,2003-12-31,9185,325,9510
13,13760,2004-12-31,9286,313,9599
13,13760,2005-12-31,9386,315,9701
13,13760,2006-12-31,9486,305,9791
13,13760,2007-12-31,9572,291,9863
13,13760,2008-12-31,9641,286,9927
13,13760,2009-12-31,9773,270,10043
13,13760,2010-12-31,9852,258,10110
13,13760,2011-12-31,9882,255,10137
13,13760,2012-12-31,9998,244,10242
13,13760,2013-12-31,10056,233,10289
13,13760,2014-12-31,10090,225,10315
13,13760,2015-12-31,10199,223,10422
13,13760,2016-12-31,10208,214,10422
13,13760,2017-12-31,10265,187,10452
13,13760,2018-12-31,10455,195,10650
13,13760,2019-12-31,10534,199,10733
13,13760,2020-12-31,10635,204,10839
13,13760,2021-12-31,10788,209,10997
13,13760,2022-12-31,10900,214,11114
13,13760,2023-12-31,11007,218,11225
13,13760,2024-12-31,11082,190,11272
13,13760,2025-12-31,11139,193,11332
13,13760,2026-12-31,11207,200,11407
13,13760,2027-12-31,11281,205,11486
13,13760,2028-12-31,11340,215,11555
13,13760,2029-12-31,11408,226,11634
13,13760,2030-12-31,11483,229,11712
13,13760,2031-12-31,11550,231,11781
13,13760,2032-12-31,11610,234,11844
13,13760,2033-12-31,11677,238,11915
13,13760,2034-12-31,11724,240,11964
13,13760,2035-12-31,11778,243,12021
13,13780,1985-12-31,4845,16516,21361
13,13780,1986-12-31,4893,16801,21694
13,13780,1987-12-31,5023,17035,22058
13,13780,1988-12-31,5093,17196,22289
13,13780,1989-12-31,5198,17333,22531
13,13780,1990-12-31,5303,17409,22712
13,13780,1991-12-31,5421,17477,22898
13,13780,1992-12-31,5522,17521,23043
13,13780,1993-12-31,5639,17614,23253
13,13780,1994-12-31,5713,17671,23384
13,13780,1995-12-31,5736,11626,17362
13,13780,1996-12-31,5797,10781,16578
13,13780,1997-12-31,5911,10405,16316
13,13780,1998-12-31,5975,10025,16000
13,13780,1999-12-31,6079,9708,15787
13,13780,2000-12-31,6109,9584,15693
13,13780,2001-12-31,6140,9432,15572
13,13780,2002-12-31,6173,9314,15487
13,13780,2003-12-31,6183,9202,15385
13,13780,2004-12-31,6205,9062,15267
13,13780,2005-12-31,6211,8944,15155
13,13780,2006-12-31,6233,8802,15035
13,13780,2007-12-31,6237,8670,14907
13,13780,2008-12-31,6246,8525,14771
13,13780,2009-12-31,6263,8294,14557
13,13780,2010-12-31,6242,8145,14387
13,13780,2011-12-31,6254,7979,14233
13,13780,2012-12-31,6247,7821,14068
13,13780,2013-12-31,6229,7636,13865
13,13780,2014-12-31,6237,7469,13706
13,13780,2015-12-31,6236,7296,13532
13,13780,2016-12-31,6203,7124,13327
13,13780,2017-12-31,6229,6966,13195
13,13780,2018-12-31,6278,6830,13108
13,13780,2019-12-31,6328,6778,13106
13,13780,2020-12-31,6343,6838,13181
13,13780,2021-12-31,6357,7016,13373
13,13780,2022-12-31,6350,7165,13515
13,13780,2023-12-31,6341,7309,13650
13,13780,2024-12-31,6354,7451,13805
13,13780,2025-12-31,6360,7581,13941
13,13780,2026-12-31,6377,7712,14089
13,13780,2027-12-31,6390,7816,14206
13,13780,2028-12-31,6422,7941,14363
13,13780,2029-12-31,6454,8055,14509
13,13780,2030-12-31,6482,8156,14638
13,13780,2031-12-31,6510,8270,14780
13,13780,2032-12-31,6539,8375,14914
13,13780,2033-12-31,6566,8470,15036
13,13780,2034-12-31,6609,8560,15169
13,13780,2035-12-31,6627,8671,15298
13,13810,1985-12-31,0,0,0
13,13810,1986-12-31,0,0,0
13,13810,1987-12-31,0,0,0
13,13810,1988-12-31,0,0,0
13,13810,1989-12-31,0,0,0
13,13810,1990-12-31,0,0,0
13,13810,1991-12-31,0,0,0
13,13810,1992-12-31,0,0,0
13,13810,1993-12-31,0,0,0
13,13810,1994-12-31,0,0,0
13,13810,1995-12-31,1633,13188,14821
13,13810,1996-12-31,1848,12386,14234
13,13810,1997-12-31,2083,12134,14217
13,13810,1998-12-31,2330,11897,14227
13,13810,1999-12-31,2530,11660,14190
13,13810,2000-12-31,2795,11660,14455
13,13810,2001-12-31,2989,11668,14657
13,13810,2002-12-31,3193,11695,14888
13,13810,2003-12-31,3411,11711,15122
13,13810,2004-12-31,3615,11748,15363
13,13810,2005-12-31,3825,11750,15575
13,13810,2006-12-31,4023,11789,15812
13,13810,2007-12-31,4215,11824,16039
13,13810,2008-12-31,4404,11857,16261
13,13810,2009-12-31,4598,11735,16333
13,13810,2010-12-31,4773,11755,16528
13,13810,2011-12-31,4947,11753,16700
13,13810,2012-12-31,5113,11735,16848
13,13810,2013-12-31,5304,11745,17049
13,13810,2014-12-31,5464,11737,17201
13,13810,2015-12-31,5625,11736,17361
13,13810,2016-12-31,5776,11739,17515
13,13810,2017-12-31,5973,11775,17748
13,13810,2018-12-31,6167,11868,18035
13,13810,2019-12-31,6363,12221,18584
13,13810,2020-12-31,6543,12491,19034
13,13810,2021-12-31,6499,12816,19315
13,13810,2022-12-31,6433,13088,19521
13,13810,2023-12-31,6364,13351,19715
13,13810,2024-12-31,6382,13612,19994
13,13810,2025-12-31,6416,13852,20268
13,13810,2026-12-31,6455,14087,20542
13,13810,2027-12-31,6495,14314,20809
13,13810,2028-12-31,6528,14516,21044
13,13810,2029-12-31,6568,14714,21282
13,13810,2030-12-31,6619,14902,21521
13,13810,2031-12-31,6652,15090,21742
13,13810,2032-12-31,6682,15278,21960
13,13810,2033-12-31,6722,15468,22190
13,13810,2034-12-31,6758,15653,22411
13,13810,2035-12-31,6790,15838,22628
13,13836,1985-12-31,25823,7287,33110
13,13836,1986-12-31,28114,7257,35371
13,13836,1987-12-31,30509,7231,37740
13,13836,1988-12-31,32992,7173,40165
13,13836,1989-12-31,35601,7059,42660
13,13836,1990-12-31,38231,7023,45254
13,13836,1991-12-31,40936,6948,47884
13,13836,1992-12-31,43694,6872,50566
13,13836,1993-12-31,46461,6768,53229
13,13836,1994-12-31,49198,6685,55883
13,13836,1995-12-31,51232,6661,57893
13,13836,1996-12-31,53779,6316,60095
13,13836,1997-12-31,56546,6228,62774
13,13836,1998-12-31,59245,6173,65418
13,13836,1999-12-31,62031,6115,68146
13,13836,2000-12-31,64301,6208,70509
13,13836,2001-12-31,66515,6268,72783
13,13836,2002-12-31,68686,6374,75060
13,13836,2003-12-31,70780,6458,77238
13,13836,2004-12-31,72806,6557,79363
13,13836,2005-12-31,74778,6657,81435
13,13836,2006-12-31,76703,6745,83448
13,13836,2007-12-31,78552,6849,85401
13,13836,2008-12-31,80295,6962,87257
13,13836,2009-12-31,82392,6967,89359
13,13836,2010-12-31,84069,7067,91136
13,13836,2011-12-31,85710,7152,92862
13,13836,2012-12-31,87272,7243,94515
13,13836,2013-12-31,88798,7347,96145
13,13836,2014-12-31,90264,7404,97668
13,13836,2015-12-31,91726,7511,99237
13,13836,2016-12-31,93328,7601,100929
13,13836,2017-12-31,94990,7698,102688
13,13836,2018-12-31,97294,7872,105166
13,13836,2019-12-31,100954,8859,109813
13,13836,2020-12-31,103755,9685,113440
13,13836,2021-12-31,105177,9939,115116
13,13836,2022-12-31,106190,10150,116340
13,13836,2023-12-31,107147,10354,117501
13,13836,2024-12-31,107997,10543,118540
13,13836,2025-12-31,108752,10731,119483
13,13836,2026-12-31,109502,10914,120416
13,13836,2027-12-31,110216,11092,121308
13,13836,2028-12-31,110909,11266,122175
13,13836,2029-12-31,111601,11413,123014
13,13836,2030-12-31,112286,11553,123839
13,13836,2031-12-31,112949,11704,124653
13,13836,2032-12-31,113576,11834,125410
13,13836,2033-12-31,114163,11967,126130
13,13836,2034-12-31,114696,12124,126820
13,13836,2035-12-31,115208,12256,127464
13,13838,1985-12-31,6949,2220,9169
13,13838,1986-12-31,7146,2283,9429
13,13838,1987-12-31,7375,2337,9712
13,13838,1988-12-31,7624,2310,9934
13,13838,1989-12-31,7869,2338,10207
13,13838,1990-12-31,8147,2376,10523
13,13838,1991-12-31,8447,2398,10845
13,13838,1992-12-31,8718,2428,11146
13,13838,1993-12-31,8977,2434,11411
13,13838,1994-12-31,9207,2465,11672
13,13838,1995-12-31,9353,2480,11833
13,13838,1996-12-31,9568,2395,11963
13,13838,1997-12-31,9822,2430,12252
13,13838,1998-12-31,10070,2406,12476
13,13838,1999-12-31,10318,2440,12758
13,13838,2000-12-31,10479,2494,12973
13,13838,2001-12-31,10626,2576,13202
13,13838,2002-12-31,10782,2626,13408
13,13838,2003-12-31,10919,2758,13677
13,13838,2004-12-31,11048,2818,13866
13,13838,2005-12-31,11163,2902,14065
13,13838,2006-12-31,11272,2984,14256
13,13838,2007-12-31,11393,3063,14456
13,13838,2008-12-31,11471,3163,14634
13,13838,2009-12-31,11621,3202,14823
13,13838,2010-12-31,11712,3288,15000
13,13838,2011-12-31,11798,3350,15148
13,13838,2012-12-31,11882,3440,15322
13,13838,2013-12-31,11956,3533,15489
13,13838,2014-12-31,12016,3580,15596
13,13838,2015-12-31,12061,3667,15728
13,13838,2016-12-31,12129,3754,15883
13,13838,2017-12-31,12254,3862,16116
13,13838,2018-12-31,12428,3975,16403
13,13838,2019-12-31,12742,4212,16954
13,13838,2020-12-31,12992,4420,17412
13,13838,2021-12-31,13133,4536,17669
13,13838,2022-12-31,13225,4632,17857
13,13838,2023-12-31,13310,4725,18035
13,13838,2024-12-31,13397,4814,18211
13,13838,2025-12-31,13489,4892,18381
13,13838,2026-12-31,13583,4978,18561
13,13838,2027-12-31,13671,5066,18737
13,13838,2028-12-31,13756,5131,18887
13,13838,2029-12-31,13828,5220,19048
13,13838,2030-12-31,13922,5297,19219
13,13838,2031-12-31,14023,5355,19378
13,13838,2032-12-31,14097,5419,19516
13,13838,2033-12-31,14181,5478,19659
13,13838,2034-12-31,14242,5542,19784
13,13838,2035-12-31,14305,5604,19909
13,13873,1985-12-31,9110,3083,12193
13,13873,1986-12-31,9518,3072,12590
13,13873,1987-12-31,9951,3061,13012
13,13873,1988-12-31,10414,2986,13400
13,13873,1989-12-31,10934,2943,13877
13,13873,1990-12-31,11402,2920,14322
13,13873,1991-12-31,11908,2870,14778
13,13873,1992-12-31,12405,2839,15244
13,13873,1993-12-31,12922,2799,15721
13,13873,1994-12-31,13403,2747,16150
13,13873,1995-12-31,13722,2732,16454
13,13873,1996-12-31,14147,2560,16707
13,13873,1997-12-31,14632,2546,17178
13,13873,1998-12-31,15110,2517,17627
13,13873,1999-12-31,15598,2477,18075
13,13873,2000-12-31,15948,2492,18440
13,13873,2001-12-31,16301,2508,18809
13,13873,2002-12-31,16643,2572,19215
13,13873,2003-12-31,16948,2591,19539
13,13873,2004-12-31,17262,2604,19866
13,13873,2005-12-31,17544,2644,20188
13,13873,2006-12-31,17833,2687,20520
13,13873,2007-12-31,18108,2709,20817
13,13873,2008-12-31,18354,2762,21116
13,13873,2009-12-31,18673,2770,21443
13,13873,2010-12-31,18946,2784,21730
13,13873,2011-12-31,19152,2774,21926
13,13873,2012-12-31,19335,2812,22147
13,13873,2013-12-31,19551,2837,22388
13,13873,2014-12-31,19737,2861,22598
13,13873,2015-12-31,19965,2872,22837
13,13873,2016-12-31,20136,2919,23055
13,13873,2017-12-31,20399,2977,23376
13,13873,2018-12-31,20769,3008,23777
13,13873,2019-12-31,21316,3265,24581
13,13873,2020-12-31,21753,3478,25231
13,13873,2021-12-31,22035,3569,25604
13,13873,2022-12-31,22231,3645,25876
13,13873,2023-12-31,22416,3718,26134
13,13873,2024-12-31,22594,3789,26383
13,13873,2025-12-31,22765,3854,26619
13,13873,2026-12-31,22924,3921,26845
13,13873,2027-12-31,23094,3976,27070
13,13873,2028-12-31,23250,4037,27287
13,13873,2029-12-31,23403,4089,27492
13,13873,2030-12-31,23541,4147,27688
13,13873,2031-12-31,23691,4197,27888
13,13873,2032-12-31,23822,4254,28076
13,13873,2033-12-31,23949,4310,28259
13,13873,2034-12-31,24061,4360,28421
13,13873,2035-12-31,24164,4409,28573
13,13894,1985-12-31,7574,1767,9341
13,13894,1986-12-31,7718,1751,9469
13,13894,1987-12-31,7867,1722,9589
13,13894,1988-12-31,8050,1683,9733
13,13894,1989-12-31,8218,1676,9894
13,13894,1990-12-31,8451,1608,10059
13,13894,1991-12-31,8642,1563,10205
13,13894,1992-12-31,8827,1543,10370
13,13894,1993-12-31,9023,1522,10545
13,13894,1994-12-31,9198,1490,10688
13,13894,1995-12-31,9241,1452,10693
13,13894,1996-12-31,9383,1400,10783
13,13894,1997-12-31,9534,1358,10892
13,13894,1998-12-31,9696,1307,11003
13,13894,1999-12-31,9838,1321,11159
13,13894,2000-12-31,9924,1293,11217
13,13894,2001-12-31,9981,1270,11251
13,13894,2002-12-31,10026,1299,11325
13,13894,2003-12-31,10094,1311,11405
13,13894,2004-12-31,10140,1316,11456
13,13894,2005-12-31,10179,1330,11509
13,13894,2006-12-31,10219,1345,11564
13,13894,2007-12-31,10257,1323,11580
13,13894,2008-12-31,10261,1339,11600
13,13894,2009-12-31,10316,1292,11608
13,13894,2010-12-31,10338,1325,11663
13,13894,2011-12-31,10335,1324,11659
13,13894,2012-12-31,10357,1315,11672
13,13894,2013-12-31,10356,1339,11695
13,13894,2014-12-31,10376,1367,11743
13,13894,2015-12-31,10386,1385,11771
13,13894,2016-12-31,10357,1388,11745
13,13894,2017-12-31,10418,1341,11759
13,13894,2018-12-31,10507,1373,11880
13,13894,2019-12-31,10599,1514,12113
13,13894,2020-12-31,10694,1628,12322
13,13894,2021-12-31,10831,1671,12502
13,13894,2022-12-31,10928,1706,12634
13,13894,2023-12-31,11021,1740,12761
13,13894,2024-12-31,11101,1762,12863
13,13894,2025-12-31,11169,1800,12969
13,13894,2026-12-31,11240,1832,13072
13,13894,2027-12-31,11307,1852,13159
13,13894,2028-12-31,11372,1882,13254
13,13894,2029-12-31,11447,1907,13354
13,13894,2030-12-31,11509,1933,13442
13,13894,2031-12-31,11580,1949,13529
13,13894,2032-12-31,11636,1975,13611
13,13894,2033-12-31,11699,2010,13709
13,13894,2034-12-31,11760,2029,13789
13,13894,2035-12-31,11806,2040,13846
15,15001,1985-12-31,76943,5857,82800
15,15001,1986-12-31,79242,5923,85165
15,15001,1987-12-31,81608,6037,87645
15,15001,1988-12-31,84022,6125,90147
15,15001,1989-12-31,86452,6213,92665
15,15001,1990-12-31,89088,6299,95387
15,15001,1991-12-31,91354,6346,97700
15,15001,1992-12-31,94041,6402,100443
15,15001,1993-12-31,96661,6451,103112
15,15001,1994-12-31,99460,6535,105995
15,15001,1995-12-31,102381,6612,108993
15,15001,1996-12-31,105298,6687,111985
15,15001,1997-12-31,108207,6736,114943
15,15001,1998-12-31,111184,6792,117976
15,15001,1999-12-31,114100,6907,121007
15,15001,2000-12-31,116984,6991,123975
15,15001,2001-12-31,119839,7047,126886
15,15001,2002-12-31,122671,7073,129744
15,15001,2003-12-31,125490,7171,132661
15,15001,2004-12-31,128207,7275,135482
15,15001,2005-12-31,130796,7335,138131
15,15001,2006-12-31,133517,7419,140936
15,15001,2007-12-31,136193,7484,143677
15,15001,2008-12-31,138895,7568,146463
15,15001,2009-12-31,141536,7647,149183
15,15001,2010-12-31,144225,7746,151971
15,15001,2011-12-31,146785,7845,154630
15,15001,2012-12-31,149256,7935,157191
15,15001,2013-12-31,151668,8014,159682
15,15001,2014-12-31,154063,8113,162176
15,15001,2015-12-31,156480,8213,164693
15,15001,2016-12-31,158858,8349,167207
15,15001,2017-12-31,161339,8544,169883
15,15001,2018-12-31,163894,8654,172548
15,15001,2019-12-31,167883,8464,176347
15,15001,2020-12-31,171461,7802,179263
15,15001,2021-12-31,172804,7764,180568
15,15001,2022-12-31,173991,7719,181710
15,15001,2023-12-31,175150,7678,182828
15,15001,2024-12-31,177130,7655,184785
15,15001,2025-12-31,179214,7636,186850
15,15001,2026-12-31,181218,7629,188847
15,15001,2027-12-31,183106,7637,190743
15,15001,2028-12-31,184887,7667,192554
15,15001,2029-12-31,186515,7703,194218
15,15001,2030-12-31,188027,7760,195787
15,15001,2031-12-31,189431,7829,197260
15,15001,2032-12-31,190808,7899,198707
15,15001,2033-12-31,192118,7963,200081
15,15001,2034-12-31,193372,8024,201396
15,15001,2035-12-31,194573,8085,202658
15,15022,1985-12-31,221,5142,5363
15,15022,1986-12-31,228,5630,5858
15,15022,1987-12-31,232,6124,6356
15,15022,1988-12-31,244,6621,6865
15,15022,1989-12-31,213,7141,7354
15,15022,1990-12-31,211,7606,7817
15,15022,1991-12-31,276,7622,7898
15,15022,1992-12-31,220,7387,7607
15,15022,1993-12-31,245,7115,7360
15,15022,1994-12-31,232,6859,7091
15,15022,1995-12-31,278,6638,6916
15,15022,1996-12-31,270,6417,6687
15,15022,1997-12-31,288,6169,6457
15,15022,1998-12-31,282,5921,6203
15,15022,1999-12-31,290,5686,5976
15,15022,2000-12-31,284,5489,5773
15,15022,2001-12-31,275,5247,5522
15,15022,2002-12-31,272,5016,5288
15,15022,2003-12-31,272,4794,5066
15,15022,2004-12-31,275,4579,4854
15,15022,2005-12-31,295,4377,4672
15,15022,2006-12-31,294,4121,4415
15,15022,2007-12-31,292,3905,4197
15,15022,2008-12-31,291,3671,3962
15,15022,2009-12-31,295,3452,3747
15,15022,2010-12-31,295,3223,3518
15,15022,2011-12-31,314,3003,3317
15,15022,2012-12-31,306,2837,3143
15,15022,2013-12-31,303,2624,2927
15,15022,2014-12-31,305,2405,2710
15,15022,2015-12-31,310,2254,2564
15,15022,2016-12-31,312,2021,2333
15,15022,2017-12-31,313,1802,2115
15,15022,2018-12-31,321,1589,1910
15,15022,2019-12-31,327,1518,1845
15,15022,2020-12-31,333,1474,1807
15,15022,2021-12-31,354,1466,1820
15,15022,2022-12-31,373,1458,1831
15,15022,2023-12-31,393,1450,1843
15,15022,2024-12-31,400,1439,1839
15,15022,2025-12-31,409,1441,1850
15,15022,2026-12-31,415,1441,1856
15,15022,2027-12-31,418,1449,1867
15,15022,2028-12-31,419,1455,1874
15,15022,2029-12-31,423,1460,1883
15,15022,2030-12-31,427,1469,1896
15,15022,2031-12-31,430,1472,1902
15,15022,2032-12-31,432,1485,1917
15,15022,2033-12-31,438,1506,1944
15,15022,2034-12-31,444,1512,1956
15,15022,2035-12-31,446,1508,1954
15,15047,1985-12-31,3422,13799,17221
15,15047,1986-12-31,3481,13611,17092
15,15047,1987-12-31,3545,13482,17027
15,15047,1988-12-31,3619,13311,16930
15,15047,1989-12-31,3679,13143,16822
15,15047,1990-12-31,3741,12990,16731
15,15047,1991-12-31,3791,12810,16601
15,15047,1992-12-31,3869,12681,16550
15,15047,1993-12-31,3934,12522,16456
15,15047,1994-12-31,4018,12385,16403
15,15047,1995-12-31,4074,12251,16325
15,15047,1996-12-31,4145,12098,16243
15,15047,1997-12-31,4281,11977,16258
15,15047,1998-12-31,4335,11856,16191
15,15047,1999-12-31,4411,11724,16135
15,15047,2000-12-31,4480,11547,16027
15,15047,2001-12-31,4578,11411,15989
15,15047,2002-12-31,4723,11262,15985
15,15047,2003-12-31,4796,11117,15913
15,15047,2004-12-31,4869,10982,15851
15,15047,2005-12-31,4926,10832,15758
15,15047,2006-12-31,4989,10705,15694
15,15047,2007-12-31,5085,10561,15646
15,15047,2008-12-31,5125,10438,15563
15,15047,2009-12-31,5228,10335,15563
15,15047,2010-12-31,5282,10220,15502
15,15047,2011-12-31,5328,10098,15426
15,15047,2012-12-31,5403,10003,15406
15,15047,2013-12-31,5491,9898,15389
15,15047,2014-12-31,5540,9835,15375
15,15047,2015-12-31,5586,9755,15341
15,15047,2016-12-31,5652,9663,15315
15,15047,2017-12-31,5713,9622,15335
15,15047,2018-12-31,5777,9600,15377
15,15047,2019-12-31,5899,9561,15460
15,15047,2020-12-31,6011,9535,15546
15,15047,2021-12-31,6174,9482,15656
15,15047,2022-12-31,6328,9427,15755
15,15047,2023-12-31,6478,9374,15852
15,15047,2024-12-31,6590,9343,15933
15,15047,2025-12-31,6679,9300,15979
15,15047,2026-12-31,6749,9313,16062
15,15047,2027-12-31,6827,9333,16160
15,15047,2028-12-31,6890,9358,16248
15,15047,2029-12-31,6948,9400,16348
15,15047,2030-12-31,7010,9441,16451
15,15047,2031-12-31,7058,9505,16563
15,15047,2032-12-31,7106,9579,16685
15,15047,2033-12-31,7153,9647,16800
15,15047,2034-12-31,7208,9711,16919
15,15047,2035-12-31,7247,9786,17033
15,15051,1985-12-31,1012,3576,4588
15,15051,1986-12-31,1019,3520,4539
15,15051,1987-12-31,1035,3514,4549
15,15051,1988-12-31,1062,3549,4611
15,15051,1989-12-31,1127,3540,4667
15,15051,1990-12-31,1158,3524,4682
15,15051,1991-12-31,1202,3508,4710
15,15051,1992-12-31,1228,3501,4729
15,15051,1993-12-31,1268,3484,4752
15,15051,1994-12-31,1324,3482,4806
15,15051,1995-12-31,1374,3491,4865
15,15051,1996-12-31,1425,3494,4919
15,15051,1997-12-31,1484,3483,4967
15,15051,1998-12-31,1538,3487,5025
15,15051,1999-12-31,1588,3475,5063
15,15051,2000-12-31,1636,3425,5061
15,15051,2001-12-31,1686,3398,5084
15,15051,2002-12-31,1721,3384,5105
15,15051,2003-12-31,1779,3386,5165
15,15051,2004-12-31,1816,3381,5197
15,15051,2005-12-31,1851,3348,5199
15,15051,2006-12-31,1879,3351,5230
15,15051,2007-12-31,1907,3333,5240
15,15051,2008-12-31,1974,3318,5292
15,15051,2009-12-31,2000,3319,5319
15,15051,2010-12-31,2013,3292,5305
15,15051,2011-12-31,2071,3275,5346
15,15051,2012-12-31,2120,3287,5407
15,15051,2013-12-31,2170,3315,5485
15,15051,2014-12-31,2216,3326,5542
15,15051,2015-12-31,2250,3371,5621
15,15051,2016-12-31,2291,3424,5715
15,15051,2017-12-31,2337,3447,5784
15,15051,2018-12-31,2378,3453,5831
15,15051,2019-12-31,2430,3481,5911
15,15051,2020-12-31,2477,3501,5978
15,15051,2021-12-31,2538,3483,6021
15,15051,2022-12-31,2596,3464,6060
15,15051,2023-12-31,2651,3446,6097
15,15051,2024-12-31,2687,3432,6119
15,15051,2025-12-31,2722,3430,6152
15,15051,2026-12-31,2754,3430,6184
15,15051,2027-12-31,2776,3436,6212
15,15051,2028-12-31,2806,3446,6252
15,15051,2029-12-31,2836,3457,6293
15,15051,2030-12-31,2852,3473,6325
15,15051,2031-12-31,2882,3521,6403
15,15051,2032-12-31,2893,3543,6436
15,15051,2033-12-31,2919,3563,6482
15,15051,2034-12-31,2936,3592,6528
15,15051,2035-12-31,2961,3617,6578
15,15087,1985-12-31,2817,6323,9140
15,15087,1986-12-31,2862,6214,9076
15,15087,1987-12-31,2887,6111,8998
15,15087,1988-12-31,2936,6007,8943
15,15087,1989-12-31,2984,5905,8889
15,15087,1990-12-31,3026,5775,8801
15,15087,1991-12-31,3075,5618,8693
15,15087,1992-12-31,3114,5517,8631
15,15087,1993-12-31,3168,5419,8587
15,15087,1994-12-31,3215,5297,8512
15,15087,1995-12-31,3272,5205,8477
15,15087,1996-12-31,3343,5097,8440
15,15087,1997-12-31,3390,4980,8370
15,15087,1998-12-31,3439,4886,8325
15,15087,1999-12-31,3476,4780,8256
15,15087,2000-12-31,3565,4654,8219
15,15087,2001-12-31,3639,4578,8217
15,15087,2002-12-31,3719,4442,8161
15,15087,2003-12-31,3780,4351,8131
15,15087,2004-12-31,3846,4249,8095
15,15087,2005-12-31,3903,4135,8038
15,15087,2006-12-31,3950,4013,7963
15,15087,2007-12-31,3999,3919,7918
15,15087,2008-12-31,4046,3806,7852
15,15087,2009-12-31,4088,3711,7799
15,15087,2010-12-31,4121,3606,7727
15,15087,2011-12-31,4144,3503,7647
15,15087,2012-12-31,4170,3426,7596
15,15087,2013-12-31,4220,3346,7566
15,15087,2014-12-31,4277,3252,7529
15,15087,2015-12-31,4315,3211,7526
15,15087,2016-12-31,4375,3193,7568
15,15087,2017-12-31,4428,3055,7483
15,15087,2018-12-31,4495,2986,7481
15,15087,2019-12-31,4562,2938,7500
15,15087,2020-12-31,4630,2902,7532
15,15087,2021-12-31,4698,2887,7585
15,15087,2022-12-31,4762,2871,7633
15,15087,2023-12-31,4825,2855,7680
15,15087,2024-12-31,4884,2851,7735
15,15087,2025-12-31,4948,2841,7789
15,15087,2026-12-31,5002,2828,7830
15,15087,2027-12-31,5054,2841,7895
15,15087,2028-12-31,5098,2839,7937
15,15087,2029-12-31,5143,2862,8005
15,15087,2030-12-31,5197,2888,8085
15,15087,2031-12-31,5231,2910,8141
15,15087,2032-12-31,5264,2926,8190
15,15087,2033-12-31,5304,2955,8259
15,15087,2034-12-31,5333,2974,8307
15,15087,2035-12-31,5370,2997,8367
15,15090,1985-12-31,1122,922,2044
15,15090,1986-12-31,1092,985,2077
15,15090,1987-12-31,1100,972,2072
15,15090,1988-12-31,1035,963,1998
15,15090,1989-12-31,1034,976,2010
15,15090,1990-12-31,1010,987,1997
15,15090,1991-12-31,1025,1010,2035
15,15090,1992-12-31,1029,1023,2052
15,15090,1993-12-31,1000,1021,2021
15,15090,1994-12-31,910,1029,1939
15,15090,1995-12-31,924,1030,1954
15,15090,1996-12-31,899,1022,1921
15,15090,1997-12-31,924,1022,1946
15,15090,1998-12-31,866,1064,1930
15,15090,1999-12-31,879,1062,1941
15,15090,2000-12-31,799,1069,1868
15,15090,2001-12-31,790,1050,1840
15,15090,2002-12-31,782,1052,1834
15,15090,2003-12-31,788,1066,1854
15,15090,2004-12-31,767,1105,1872
15,15090,2005-12-31,721,1064,1785
15,15090,2006-12-31,709,1114,1823
15,15090,2007-12-31,700,1115,1815
15,15090,2008-12-31,655,1119,1774
15,15090,2009-12-31,648,1108,1756
15,15090,2010-12-31,550,1104,1654
15,15090,2011-12-31,538,1101,1639
15,15090,2012-12-31,537,1150,1687
15,15090,2013-12-31,519,1197,1716
15,15090,2014-12-31,517,1210,1727
15,15090,2015-12-31,482,1203,1685
15,15090,2016-12-31,428,1188,1616
15,15090,2017-12-31,403,1190,1593
15,15090,2018-12-31,406,1190,1596
15,15090,2019-12-31,418,1169,1587
15,15090,2020-12-31,429,1153,1582
15,15090,2021-12-31,446,1147,1593
15,15090,2022-12-31,462,1141,1603
15,15090,2023-12-31,479,1134,1613
15,15090,2024-12-31,494,1134,1628
15,15090,2025-12-31,503,1127,1630
15,15090,2026-12-31,505,1130,1635
15,15090,2027-12-31,512,1132,1644
15,15090,2028-12-31,515,1133,1648
15,15090,2029-12-31,517,1140,1657
15,15090,2030-12-31,525,1148,1673
15,15090,2031-12-31,532,1155,1687
15,15090,2032-12-31,538,1161,1699
15,15090,2033-12-31,542,1171,1713
15,15090,2034-12-31,541,1187,1728
15,15090,2035-12-31,543,1196,1739
15,15092,1985-12-31,181,2831,3012
15,15092,1986-12-31,174,2789,2963
15,15092,1987-12-31,191,2752,2943
15,15092,1988-12-31,180,2721,2901
15,15092,1989-12-31,203,2693,2896
15,15092,1990-12-31,184,2656,2840
15,15092,1991-12-31,186,2633,2819
15,15092,1992-12-31,185,2594,2779
15,15092,1993-12-31,196,2531,2727
15,15092,1994-12-31,223,2512,2735
15,15092,1995-12-31,238,2475,2713
15,15092,1996-12-31,252,2422,2674
15,15092,1997-12-31,274,2389,2663
15,15092,1998-12-31,259,2373,2632
15,15092,1999-12-31,264,2316,2580
15,15092,2000-12-31,278,2282,2560
15,15092,2001-12-31,263,2212,2475
15,15092,2002-12-31,266,2173,2439
15,15092,2003-12-31,269,2135,2404
15,15092,2004-12-31,272,2093,2365
15,15092,2005-12-31,269,2058,2327
15,15092,2006-12-31,266,2021,2287
15,15092,2007-12-31,309,1993,2302
15,15092,2008-12-31,301,1951,2252
15,15092,2009-12-31,318,1925,2243
15,15092,2010-12-31,330,1892,2222
15,15092,2011-12-31,338,1888,2226
15,15092,2012-12-31,331,1872,2203
15,15092,2013-12-31,316,1824,2140
15,15092,2014-12-31,314,1785,2099
15,15092,2015-12-31,311,1729,2040
15,15092,2016-12-31,313,1654,1967
15,15092,2017-12-31,314,1641,1955
15,15092,2018-12-31,327,1636,1963
15,15092,2019-12-31,334,1609,1943
15,15092,2020-12-31,340,1595,1935
15,15092,2021-12-31,362,1587,1949
15,15092,2022-12-31,383,1578,1961
15,15092,2023-12-31,404,1569,1973
15,15092,2024-12-31,409,1561,1970
15,15092,2025-12-31,414,1555,1969
15,15092,2026-12-31,414,1557,1971
15,15092,2027-12-31,417,1561,1978
15,15092,2028-12-31,422,1566,1988
15,15092,2029-12-31,427,1577,2004
15,15092,2030-12-31,431,1587,2018
15,15092,2031-12-31,434,1589,2023
15,15092,2032-12-31,437,1609,2046
15,15092,2033-12-31,441,1613,2054
15,15092,2034-12-31,446,1625,2071
15,15092,2035-12-31,450,1643,2093
15,15097,1985-12-31,2475,11858,14333
15,15097,1986-12-31,2462,11542,14004
15,15097,1987-12-31,2455,11258,13713
15,15097,1988-12-31,2436,10958,13394
15,15097,1989-12-31,2433,10639,13072
15,15097,1990-12-31,2411,10373,12784
15,15097,1991-12-31,2404,10055,12459
15,15097,1992-12-31,2408,9780,12188
15,15097,1993-12-31,2382,9489,11871
15,15097,1994-12-31,2400,9175,11575
15,15097,1995-12-31,2397,8883,11280
15,15097,1996-12-31,2409,8582,10991
15,15097,1997-12-31,2410,8325,10735
15,15097,1998-12-31,2415,8029,10444
15,15097,1999-12-31,2428,7734,10162
15,15097,2000-12-31,2434,7442,9876
15,15097,2001-12-31,2456,7148,9604
15,15097,2002-12-31,2451,6873,9324
15,15097,2003-12-31,2450,6583,9033
15,15097,2004-12-31,2428,6316,8744
15,15097,2005-12-31,2435,6037,8472
15,15097,2006-12-31,2412,5773,8185
15,15097,2007-12-31,2399,5490,7889
15,15097,2008-12-31,2387,5223,7610
15,15097,2009-12-31,2379,5004,7383
15,15097,2010-12-31,2372,4741,7113
15,15097,2011-12-31,2364,4480,6844
15,15097,2012-12-31,2352,4217,6569
15,15097,2013-12-31,2347,3956,6303
15,15097,2014-12-31,2351,3683,6034
15,15097,2015-12-31,2346,3455,5801
15,15097,2016-12-31,2298,3289,5587
15,15097,2017-12-31,2283,3023,5306
15,15097,2018-12-31,2305,2754,5059
15,15097,2019-12-31,2288,2600,4888
15,15097,2020-12-31,2288,2509,4797
15,15097,2021-12-31,2335,2496,4831
15,15097,2022-12-31,2380,2482,4862
15,15097,2023-12-31,2423,2469,4892
15,15097,2024-12-31,2453,2467,4920
15,15097,2025-12-31,2482,2451,4933
15,15097,2026-12-31,2510,2447,4957
15,15097,2027-12-31,2530,2449,4979
15,15097,2028-12-31,2562,2463,5025
15,15097,2029-12-31,2589,2473,5062
15,15097,2030-12-31,2604,2490,5094
15,15097,2031-12-31,2618,2516,5134
15,15097,2032-12-31,2645,2520,5165
15,15097,2033-12-31,2657,2543,5200
15,15097,2034-12-31,2682,2556,5238
15,15097,2035-12-31,2707,2575,5282
15,15104,1985-12-31,413,5404,5817
15,15104,1986-12-31,439,5342,5781
15,15104,1987-12-31,478,5328,5806
15,15104,1988-12-31,487,5292,5779
15,15104,1989-12-31,490,5251,5741
15,15104,1990-12-31,448,5203,5651
15,15104,1991-12-31,488,5114,5602
15,15104,1992-12-31,541,5083,5624
15,15104,1993-12-31,537,5044,5581
15,15104,1994-12-31,542,4993,5535
15,15104,1995-12-31,550,4961,5511
15,15104,1996-12-31,559,4926,5485
15,15104,1997-12-31,545,4876,5421
15,15104,1998-12-31,545,4845,5390
15,15104,1999-12-31,579,4806,5385
15,15104,2000-12-31,559,4777,5336
15,15104,2001-12-31,634,4746,5380
15,15104,2002-12-31,638,4704,5342
15,15104,2003-12-31,644,4659,5303
15,15104,2004-12-31,651,4619,5270
15,15104,2005-12-31,642,4571,5213
15,15104,2006-12-31,634,4545,5179
15,15104,2007-12-31,665,4514,5179
15,15104,2008-12-31,679,4451,5130
15,15104,2009-12-31,706,4431,5137
15,15104,2010-12-31,646,4420,5066
15,15104,2011-12-31,647,4373,5020
15,15104,2012-12-31,651,4349,5000
15,15104,2013-12-31,672,4330,5002
15,15104,2014-12-31,687,4310,4997
15,15104,2015-12-31,704,4258,4962
15,15104,2016-12-31,720,4293,5013
15,15104,2017-12-31,739,4327,5066
15,15104,2018-12-31,761,4328,5089
15,15104,2019-12-31,777,4326,5103
15,15104,2020-12-31,792,4326,5118
15,15104,2021-12-31,850,4304,5154
15,15104,2022-12-31,907,4280,5187
15,15104,2023-12-31,962,4257,5219
15,15104,2024-12-31,984,4246,5230
15,15104,2025-12-31,1002,4245,5247
15,15104,2026-12-31,1014,4228,5242
15,15104,2027-12-31,1027,4228,5255
15,15104,2028-12-31,1039,4254,5293
15,15104,2029-12-31,1042,4278,5320
15,15104,2030-12-31,1047,4313,5360
15,15104,2031-12-31,1055,4321,5376
15,15104,2032-12-31,1070,4365,5435
15,15104,2033-12-31,1083,4402,5485
15,15104,2034-12-31,1092,4436,5528
15,15104,2035-12-31,1095,4462,5557
15,15106,1985-12-31,376,2957,3333
15,15106,1986-12-31,380,2942,3322
15,15106,1987-12-31,384,2895,3279
15,15106,1988-12-31,396,2864,3260
15,15106,1989-12-31,409,2808,3217
15,15106,1990-12-31,440,2783,3223
15,15106,1991-12-31,440,2739,3179
15,15106,1992-12-31,418,2726,3144
15,15106,1993-12-31,424,2660,3084
15,15106,1994-12-31,450,2591,3041
15,15106,1995-12-31,458,2575,3033
15,15106,1996-12-31,447,2534,2981
15,15106,1997-12-31,451,2519,2970
15,15106,1998-12-31,465,2488,2953
15,15106,1999-12-31,472,2413,2885
15,15106,2000-12-31,422,2383,2805
15,15106,2001-12-31,457,2338,2795
15,15106,2002-12-31,459,2306,2765
15,15106,2003-12-31,434,2263,2697
15,15106,2004-12-31,467,2219,2686
15,15106,2005-12-31,451,2169,2620
15,15106,2006-12-31,446,2133,2579
15,15106,2007-12-31,467,2094,2561
15,15106,2008-12-31,496,2047,2543
15,15106,2009-12-31,494,2016,2510
15,15106,2010-12-31,486,1989,2475
15,15106,2011-12-31,486,1960,2446
15,15106,2012-12-31,484,1939,2423
15,15106,2013-12-31,469,1912,2381
15,15106,2014-12-31,472,1887,2359
15,15106,2015-12-31,484,1837,2321
15,15106,2016-12-31,485,1739,2224
15,15106,2017-12-31,486,1714,2200
15,15106,2018-12-31,487,1711,2198
15,15106,2019-12-31,492,1683,2175
15,15106,2020-12-31,498,1665,2163
15,15106,2021-12-31,522,1656,2178
15,15106,2022-12-31,545,1647,2192
15,15106,2023-12-31,568,1638,2206
15,15106,2024-12-31,573,1630,2203
15,15106,2025-12-31,578,1625,2203
15,15106,2026-12-31,589,1634,2223
15,15106,2027-12-31,596,1627,2223
15,15106,2028-12-31,605,1634,2239
15,15106,2029-12-31,607,1639,2246
15,15106,2030-12-31,615,1653,2268
15,15106,2031-12-31,620,1661,2281
15,15106,2032-12-31,621,1670,2291
15,15106,2033-12-31,622,1692,2314
15,15106,2034-12-31,630,1697,2327
15,15106,2035-12-31,640,1718,2358
15,15109,1985-12-31,449,5620,6069
15,15109,1986-12-31,444,5578,6022
15,15109,1987-12-31,469,5525,5994
15,15109,1988-12-31,510,5456,5966
15,15109,1989-12-31,529,5385,5914
15,15109,1990-12-31,527,5338,5865
15,15109,1991-12-31,527,5225,5752
15,15109,1992-12-31,537,5158,5695
15,15109,1993-12-31,547,5075,5622
15,15109,1994-12-31,545,5024,5569
15,15109,1995-12-31,557,4943,5500
15,15109,1996-12-31,558,4915,5473
15,15109,1997-12-31,547,4815,5362
15,15109,1998-12-31,551,4782,5333
15,15109,1999-12-31,573,4674,5247
15,15109,2000-12-31,614,4611,5225
15,15109,2001-12-31,629,4554,5183
15,15109,2002-12-31,639,4493,5132
15,15109,2003-12-31,653,4412,5065
15,15109,2004-12-31,662,4338,5000
15,15109,2005-12-31,675,4266,4941
15,15109,2006-12-31,677,4208,4885
15,15109,2007-12-31,677,4141,4818
15,15109,2008-12-31,682,4113,4795
15,15109,2009-12-31,693,4017,4710
15,15109,2010-12-31,692,3934,4626
15,15109,2011-12-31,700,3902,4602
15,15109,2012-12-31,710,3872,4582
15,15109,2013-12-31,710,3822,4532
15,15109,2014-12-31,720,3775,4495
15,15109,2015-12-31,725,3722,4447
15,15109,2016-12-31,734,3676,4410
15,15109,2017-12-31,745,3666,4411
15,15109,2018-12-31,757,3652,4409
15,15109,2019-12-31,775,3621,4396
15,15109,2020-12-31,791,3605,4396
15,15109,2021-12-31,841,3586,4427
15,15109,2022-12-31,889,3566,4455
15,15109,2023-12-31,936,3547,4483
15,15109,2024-12-31,962,3535,4497
15,15109,2025-12-31,973,3522,4495
15,15109,2026-12-31,986,3520,4506
15,15109,2027-12-31,993,3515,4508
15,15109,2028-12-31,999,3536,4535
15,15109,2029-12-31,1016,3542,4558
15,15109,2030-12-31,1022,3566,4588
15,15109,2031-12-31,1023,3594,4617
15,15109,2032-12-31,1023,3627,4650
15,15109,2033-12-31,1040,3656,4696
15,15109,2034-12-31,1058,3685,4743
15,15109,2035-12-31,1050,3718,4768
15,15114,1985-12-31,151,502,653
15,15114,1986-12-31,133,496,629
15,15114,1987-12-31,128,534,662
15,15114,1988-12-31,221,537,758
15,15114,1989-12-31,208,551,759
15,15114,1990-12-31,240,536,776
15,15114,1991-12-31,180,524,704
15,15114,1992-12-31,252,581,833
15,15114,1993-12-31,200,588,788
15,15114,1994-12-31,316,556,872
15,15114,1995-12-31,188,556,744
15,15114,1996-12-31,218,561,779
15,15114,1997-12-31,211,596,807
15,15114,1998-12-31,236,601,837
15,15114,1999-12-31,273,614,887
15,15114,2000-12-31,287,554,841
15,15114,2001-12-31,306,558,864
15,15114,2002-12-31,314,559,873
15,15114,2003-12-31,319,565,884
15,15114,2004-12-31,323,610,933
15,15114,2005-12-31,312,572,884
15,15114,2006-12-31,319,602,921
15,15114,2007-12-31,331,631,962
15,15114,2008-12-31,354,645,999
15,15114,2009-12-31,372,654,1026
15,15114,2010-12-31,377,664,1041
15,15114,2011-12-31,381,670,1051
15,15114,2012-12-31,392,681,1073
15,15114,2013-12-31,394,688,1082
15,15114,2014-12-31,407,689,1096
15,15114,2015-12-31,413,683,1096
15,15114,2016-12-31,416,689,1105
15,15114,2017-12-31,420,691,1111
15,15114,2018-12-31,432,686,1118
15,15114,2019-12-31,445,693,1138
15,15114,2020-12-31,456,697,1153
15,15114,2021-12-31,468,693,1161
15,15114,2022-12-31,479,690,1169
15,15114,2023-12-31,490,686,1176
15,15114,2024-12-31,499,684,1183
15,15114,2025-12-31,509,682,1191
15,15114,2026-12-31,511,687,1198
15,15114,2027-12-31,528,692,1220
15,15114,2028-12-31,539,694,1233
15,15114,2029-12-31,558,697,1255
15,15114,2030-12-31,571,699,1270
15,15114,2031-12-31,597,701,1298
15,15114,2032-12-31,614,711,1325
15,15114,2033-12-31,642,717,1359
15,15114,2034-12-31,681,715,1396
15,15114,2035-12-31,717,718,1435
15,15131,1985-12-31,210,4616,4826
15,15131,1986-12-31,180,4591,4771
15,15131,1987-12-31,167,4552,4719
15,15131,1988-12-31,154,4471,4625
15,15131,1989-12-31,158,4424,4582
15,15131,1990-12-31,244,4375,4619
15,15131,1991-12-31,186,4285,4471
15,15131,1992-12-31,222,4225,4447
15,15131,1993-12-31,210,4168,4378
15,15131,1994-12-31,243,4107,4350
15,15131,1995-12-31,160,4065,4225
15,15131,1996-12-31,164,4002,4166
15,15131,1997-12-31,176,3938,4114
15,15131,1998-12-31,191,3899,4090
15,15131,1999-12-31,200,3844,4044
15,15131,2000-12-31,208,3738,3946
15,15131,2001-12-31,218,3667,3885
15,15131,2002-12-31,230,3631,3861
15,15131,2003-12-31,231,3559,3790
15,15131,2004-12-31,236,3503,3739
15,15131,2005-12-31,248,3441,3689
15,15131,2006-12-31,243,3374,3617
15,15131,2007-12-31,239,3319,3558
15,15131,2008-12-31,238,3265,3503
15,15131,2009-12-31,233,3208,3441
15,15131,2010-12-31,234,3160,3394
15,15131,2011-12-31,235,3114,3349
15,15131,2012-12-31,237,3068,3305
15,15131,2013-12-31,239,3027,3266
15,15131,2014-12-31,240,3007,3247
15,15131,2015-12-31,240,3030,3270
15,15131,2016-12-31,240,3005,3245
15,15131,2017-12-31,240,2905,3145
15,15131,2018-12-31,245,2898,3143
15,15131,2019-12-31,251,2876,3127
15,15131,2020-12-31,257,2869,3126
15,15131,2021-12-31,298,2850,3148
15,15131,2022-12-31,334,2834,3168
15,15131,2023-12-31,369,2819,3188
15,15131,2024-12-31,381,2801,3182
15,15131,2025-12-31,384,2804,3188
15,15131,2026-12-31,390,2797,3187
15,15131,2027-12-31,390,2802,3192
15,15131,2028-12-31,394,2812,3206
15,15131,2029-12-31,399,2813,3212
15,15131,2030-12-31,400,2843,3243
15,15131,2031-12-31,408,2865,3273
15,15131,2032-12-31,411,2890,3301
15,15131,2033-12-31,414,2909,3323
15,15131,2034-12-31,418,2926,3344
15,15131,2035-12-31,421,2940,3361
15,15135,1985-12-31,476,4664,5140
15,15135,1986-12-31,482,4591,5073
15,15135,1987-12-31,527,4515,5042
15,15135,1988-12-31,547,4447,4994
15,15135,1989-12-31,510,4378,4888
15,15135,1990-12-31,514,4286,4800
15,15135,1991-12-31,517,4212,4729
15,15135,1992-12-31,526,4137,4663
15,15135,1993-12-31,541,4044,4585
15,15135,1994-12-31,555,3989,4544
15,15135,1995-12-31,578,3933,4511
15,15135,1996-12-31,598,3860,4458
15,15135,1997-12-31,614,3781,4395
15,15135,1998-12-31,652,3676,4328
15,15135,1999-12-31,623,3598,4221
15,15135,2000-12-31,640,3532,4172
15,15135,2001-12-31,652,3465,4117
15,15135,2002-12-31,655,3394,4049
15,15135,2003-12-31,654,3301,3955
15,15135,2004-12-31,660,3197,3857
15,15135,2005-12-31,660,3126,3786
15,15135,2006-12-31,670,3083,3753
15,15135,2007-12-31,684,3013,3697
15,15135,2008-12-31,710,2933,3643
15,15135,2009-12-31,733,2874,3607
15,15135,2010-12-31,752,2819,3571
15,15135,2011-12-31,753,2747,3500
15,15135,2012-12-31,756,2675,3431
15,15135,2013-12-31,742,2610,3352
15,15135,2014-12-31,737,2585,3322
15,15135,2015-12-31,739,2547,3286
15,15135,2016-12-31,740,2512,3252
15,15135,2017-12-31,748,2389,3137
15,15135,2018-12-31,767,2354,3121
15,15135,2019-12-31,783,2299,3082
15,15135,2020-12-31,798,2263,3061
15,15135,2021-12-31,832,2251,3083
15,15135,2022-12-31,863,2239,3102
15,15135,2023-12-31,894,2227,3121
15,15135,2024-12-31,905,2212,3117
15,15135,2025-12-31,919,2200,3119
15,15135,2026-12-31,939,2203,3142
15,15135,2027-12-31,947,2210,3157
15,15135,2028-12-31,956,2225,3181
15,15135,2029-12-31,966,2233,3199
15,15135,2030-12-31,973,2242,3215
15,15135,2031-12-31,981,2259,3240
15,15135,2032-12-31,981,2277,3258
15,15135,2033-12-31,992,2294,3286
15,15135,2034-12-31,1000,2328,3328
15,15135,2035-12-31,999,2333,3332
15,15162,1985-12-31,1152,3989,5141
15,15162,1986-12-31,1160,3927,5087
15,15162,1987-12-31,1166,3856,5022
15,15162,1988-12-31,1160,3799,4959
15,15162,1989-12-31,1179,3759,4938
15,15162,1990-12-31,1206,3710,4916
15,15162,1991-12-31,1220,3637,4857
15,15162,1992-12-31,1256,3579,4835
15,15162,1993-12-31,1256,3494,4750
15,15162,1994-12-31,1271,3450,4721
15,15162,1995-12-31,1298,3371,4669
15,15162,1996-12-31,1319,3325,4644
15,15162,1997-12-31,1355,3258,4613
15,15162,1998-12-31,1376,3180,4556
15,15162,1999-12-31,1388,3112,4500
15,15162,2000-12-31,1425,3035,4460
15,15162,2001-12-31,1426,2972,4398
15,15162,2002-12-31,1451,2908,4359
15,15162,2003-12-31,1463,2840,4303
15,15162,2004-12-31,1471,2772,4243
15,15162,2005-12-31,1483,2692,4175
15,15162,2006-12-31,1508,2646,4154
15,15162,2007-12-31,1513,2575,4088
15,15162,2008-12-31,1519,2521,4040
15,15162,2009-12-31,1534,2472,4006
15,15162,2010-12-31,1530,2428,3958
15,15162,2011-12-31,1521,2391,3912
15,15162,2012-12-31,1531,2345,3876
15,15162,2013-12-31,1552,2295,3847
15,15162,2014-12-31,1567,2268,3835
15,15162,2015-12-31,1588,2260,3848
15,15162,2016-12-31,1603,2205,3808
15,15162,2017-12-31,1630,2061,3691
15,15162,2018-12-31,1653,2060,3713
15,15162,2019-12-31,1671,2032,3703
15,15162,2020-12-31,1691,2015,3706
15,15162,2021-12-31,1728,2004,3732
15,15162,2022-12-31,1763,1993,3756
15,15162,2023-12-31,1796,1983,3779
15,15162,2024-12-31,1821,1977,3798
15,15162,2025-12-31,1836,1968,3804
15,15162,2026-12-31,1857,1974,3831
15,15162,2027-12-31,1880,1975,3855
15,15162,2028-12-31,1896,1972,3868
15,15162,2029-12-31,1906,1980,3886
15,15162,2030-12-31,1926,1997,3923
15,15162,2031-12-31,1938,2018,3956
15,15162,2032-12-31,1952,2034,3986
15,15162,2033-12-31,1968,2051,4019
15,15162,2034-12-31,1974,2056,4030
15,15162,2035-12-31,1998,2081,4079
15,15172,1985-12-31,1029,3156,4185
15,15172,1986-12-31,1028,3130,4158
15,15172,1987-12-31,1053,3101,4154
15,15172,1988-12-31,1067,3087,4154
15,15172,1989-12-31,1063,3031,4094
15,15172,1990-12-31,1067,2984,4051
15,15172,1991-12-31,1067,2928,3995
15,15172,1992-12-31,1087,2881,3968
15,15172,1993-12-31,1095,2835,3930
15,15172,1994-12-31,1104,2826,3930
15,15172,1995-12-31,1108,2803,3911
15,15172,1996-12-31,1126,2762,3888
15,15172,1997-12-31,1140,2707,3847
15,15172,1998-12-31,1138,2658,3796
15,15172,1999-12-31,1167,2615,3782
15,15172,2000-12-31,1178,2567,3745
15,15172,2001-12-31,1180,2518,3698
15,15172,2002-12-31,1172,2480,3652
15,15172,2003-12-31,1186,2441,3627
15,15172,2004-12-31,1168,2401,3569
15,15172,2005-12-31,1183,2309,3492
15,15172,2006-12-31,1186,2325,3511
15,15172,2007-12-31,1177,2295,3472
15,15172,2008-12-31,1184,2254,3438
15,15172,2009-12-31,1194,2219,3413
15,15172,2010-12-31,1185,2207,3392
15,15172,2011-12-31,1159,2181,3340
15,15172,2012-12-31,1156,2170,3326
15,15172,2013-12-31,1163,2150,3313
15,15172,2014-12-31,1165,2122,3287
15,15172,2015-12-31,1184,2092,3276
15,15172,2016-12-31,1202,2000,3202
15,15172,2017-12-31,1218,1984,3202
15,15172,2018-12-31,1231,1978,3209
15,15172,2019-12-31,1234,1964,3198
15,15172,2020-12-31,1242,1952,3194
15,15172,2021-12-31,1275,1942,3217
15,15172,2022-12-31,1306,1931,3237
15,15172,2023-12-31,1336,1921,3257
15,15172,2024-12-31,1357,1911,3268
15,15172,2025-12-31,1372,1901,3273
15,15172,2026-12-31,1385,1904,3289
15,15172,2027-12-31,1401,1903,3304
15,15172,2028-12-31,1415,1905,3320
15,15172,2029-12-31,1425,1918,3343
15,15172,2030-12-31,1436,1924,3360
15,15172,2031-12-31,1457,1949,3406
15,15172,2032-12-31,1454,1965,3419
15,15172,2033-12-31,1474,1990,3464
15,15172,2034-12-31,1480,2000,3480
15,15172,2035-12-31,1488,2009,3497
15,15176,1985-12-31,24805,7684,32489
15,15176,1986-12-31,25442,7668,33110
15,15176,1987-12-31,26074,7663,33737
15,15176,1988-12-31,26764,7639,34403
15,15176,1989-12-31,27403,7607,35010
15,15176,1990-12-31,28189,7564,35753
15,15176,1991-12-31,28816,7494,36310
15,15176,1992-12-31,29562,7445,37007
15,15176,1993-12-31,30292,7410,37702
15,15176,1994-12-31,31066,7384,38450
15,15176,1995-12-31,31899,7370,39269
15,15176,1996-12-31,32718,7314,40032
15,15176,1997-12-31,33533,7277,40810
15,15176,1998-12-31,34364,7258,41622
15,15176,1999-12-31,35166,7244,42410
15,15176,2000-12-31,35987,7235,43222
15,15176,2001-12-31,36791,7196,43987
15,15176,2002-12-31,37573,7162,44735
15,15176,2003-12-31,38366,7121,45487
15,15176,2004-12-31,39104,7078,46182
15,15176,2005-12-31,39852,7053,46905
15,15176,2006-12-31,40622,7040,47662
15,15176,2007-12-31,41366,7013,48379
15,15176,2008-12-31,42111,6984,49095
15,15176,2009-12-31,42867,6977,49844
15,15176,2010-12-31,43622,6963,50585
15,15176,2011-12-31,44329,6968,51297
15,15176,2012-12-31,45013,6928,51941
15,15176,2013-12-31,45657,6957,52614
15,15176,2014-12-31,46344,6978,53322
15,15176,2015-12-31,46991,6927,53918
15,15176,2016-12-31,47640,6922,54562
15,15176,2017-12-31,48352,7014,55366
15,15176,2018-12-31,49016,7038,56054
15,15176,2019-12-31,50054,7047,57101
15,15176,2020-12-31,51008,6927,57935
15,15176,2021-12-31,51465,6891,58356
15,15176,2022-12-31,51873,6853,58726
15,15176,2023-12-31,52273,6816,59089
15,15176,2024-12-31,52863,6788,59651
15,15176,2025-12-31,53464,6786,60250
15,15176,2026-12-31,54055,6769,60824
15,15176,2027-12-31,54612,6792,61404
15,15176,2028-12-31,55143,6811,61954
15,15176,2029-12-31,55632,6854,62486
15,15176,2030-12-31,56089,6886,62975
15,15176,2031-12-31,56512,6937,63449
15,15176,2032-12-31,56921,6986,63907
15,15176,2033-12-31,57311,7040,64351
15,15176,2034-12-31,57677,7092,64769
15,15176,2035-12-31,58039,7150,65189
15,15180,1985-12-31,982,6310,7292
15,15180,1986-12-31,985,6192,7177
15,15180,1987-12-31,977,6105,7082
15,15180,1988-12-31,964,6016,6980
15,15180,1989-12-31,976,5900,6876
15,15180,1990-12-31,973,5784,6757
15,15180,1991-12-31,977,5649,6626
15,15180,1992-12-31,1000,5531,6531
15,15180,1993-12-31,1006,5420,6426
15,15180,1994-12-31,985,5319,6304
15,15180,1995-12-31,969,5227,6196
15,15180,1996-12-31,964,5125,6089
15,15180,1997-12-31,965,5020,5985
15,15180,1998-12-31,965,4924,5889
15,15180,1999-12-31,961,4813,5774
15,15180,2000-12-31,941,4724,5665
15,15180,2001-12-31,948,4638,5586
15,15180,2002-12-31,920,4515,5435
15,15180,2003-12-31,927,4398,5325
15,15180,2004-12-31,939,4315,5254
15,15180,2005-12-31,955,4215,5170
15,15180,2006-12-31,933,4114,5047
15,15180,2007-12-31,918,4007,4925
15,15180,2008-12-31,899,3912,4811
15,15180,2009-12-31,888,3816,4704
15,15180,2010-12-31,872,3728,4600
15,15180,2011-12-31,864,3604,4468
15,15180,2012-12-31,862,3512,4374
15,15180,2013-12-31,865,3457,4322
15,15180,2014-12-31,861,3352,4213
15,15180,2015-12-31,865,3315,4180
15,15180,2016-12-31,863,3312,4175
15,15180,2017-12-31,864,3177,4041
15,15180,2018-12-31,879,3115,3994
15,15180,2019-12-31,872,3052,3924
15,15180,2020-12-31,873,3014,3887
15,15180,2021-12-31,916,2998,3914
15,15180,2022-12-31,957,2982,3939
15,15180,2023-12-31,998,2966,3964
15,15180,2024-12-31,1026,2957,3983
15,15180,2025-12-31,1034,2942,3976
15,15180,2026-12-31,1047,2954,4001
15,15180,2027-12-31,1053,2947,4000
15,15180,2028-12-31,1064,2954,4018
15,15180,2029-12-31,1074,2965,4039
15,15180,2030-12-31,1078,2993,4071
15,15180,2031-12-31,1089,3018,4107
15,15180,2032-12-31,1100,3034,4134
15,15180,2033-12-31,1108,3059,4167
15,15180,2034-12-31,1115,3084,4199
15,15180,2035-12-31,1120,3107,4227
15,15183,1985-12-31,1693,14891,16584
15,15183,1986-12-31,1681,14570,16251
15,15183,1987-12-31,1692,14270,15962
15,15183,1988-12-31,1698,13968,15666
15,15183,1989-12-31,1709,13639,15348
15,15183,1990-12-31,1727,13354,15081
15,15183,1991-12-31,1726,13045,14771
15,15183,1992-12-31,1713,12775,14488
15,15183,1993-12-31,1738,12454,14192
15,15183,1994-12-31,1762,12196,13958
15,15183,1995-12-31,1767,11927,13694
15,15183,1996-12-31,1787,11652,13439
15,15183,1997-12-31,1811,11376,13187
15,15183,1998-12-31,1827,11102,12929
15,15183,1999-12-31,1854,10807,12661
15,15183,2000-12-31,1868,10525,12393
15,15183,2001-12-31,1880,10258,12138
15,15183,2002-12-31,1887,9981,11868
15,15183,2003-12-31,1876,9699,11575
15,15183,2004-12-31,1893,9436,11329
15,15183,2005-12-31,1895,9151,11046
15,15183,2006-12-31,1907,8888,10795
15,15183,2007-12-31,1903,8611,10514
15,15183,2008-12-31,1912,8360,10272
15,15183,2009-12-31,1917,8104,10021
15,15183,2010-12-31,1924,7867,9791
15,15183,2011-12-31,1934,7646,9580
15,15183,2012-12-31,1943,7407,9350
15,15183,2013-12-31,1937,7154,9091
15,15183,2014-12-31,1928,6899,8827
15,15183,2015-12-31,1925,6651,8576
15,15183,2016-12-31,1931,6431,8362
15,15183,2017-12-31,1949,6288,8237
15,15183,2018-12-31,1976,6069,8045
15,15183,2019-12-31,1981,5900,7881
15,15183,2020-12-31,1993,5800,7793
15,15183,2021-12-31,2079,5769,7848
15,15183,2022-12-31,2160,5738,7898
15,15183,2023-12-31,2240,5707,7947
15,15183,2024-12-31,2278,5689,7967
15,15183,2025-12-31,2309,5678,7987
15,15183,2026-12-31,2332,5679,8011
15,15183,2027-12-31,2356,5674,8030
15,15183,2028-12-31,2386,5699,8085
15,15183,2029-12-31,2398,5728,8126
15,15183,2030-12-31,2424,5755,8179
15,15183,2031-12-31,2435,5803,8238
15,15183,2032-12-31,2462,5843,8305
15,15183,2033-12-31,2473,5887,8360
15,15183,2034-12-31,2494,5924,8418
15,15183,2035-12-31,2510,5981,8491
15,15185,1985-12-31,629,5941,6570
15,15185,1986-12-31,634,5931,6565
15,15185,1987-12-31,643,5888,6531
15,15185,1988-12-31,667,5839,6506
15,15185,1989-12-31,686,5812,6498
15,15185,1990-12-31,690,5766,6456
15,15185,1991-12-31,702,5687,6389
15,15185,1992-12-31,726,5637,6363
15,15185,1993-12-31,735,5593,6328
15,15185,1994-12-31,758,5553,6311
15,15185,1995-12-31,778,5504,6282
15,15185,1996-12-31,810,5451,6261
15,15185,1997-12-31,853,5403,6256
15,15185,1998-12-31,882,5348,6230
15,15185,1999-12-31,905,5285,6190
15,15185,2000-12-31,917,5228,6145
15,15185,2001-12-31,891,5194,6085
15,15185,2002-12-31,908,5130,6038
15,15185,2003-12-31,920,5103,6023
15,15185,2004-12-31,956,5046,6002
15,15185,2005-12-31,972,4999,5971
15,15185,2006-12-31,988,4930,5918
15,15185,2007-12-31,1003,4887,5890
15,15185,2008-12-31,1019,4868,5887
15,15185,2009-12-31,1034,4838,5872
15,15185,2010-12-31,1049,4824,5873
15,15185,2011-12-31,1057,4789,5846
15,15185,2012-12-31,1073,4750,5823
15,15185,2013-12-31,1092,4700,5792
15,15185,2014-12-31,1099,4676,5775
15,15185,2015-12-31,1109,4625,5734
15,15185,2016-12-31,1121,4615,5736
15,15185,2017-12-31,1139,4683,5822
15,15185,2018-12-31,1158,4672,5830
15,15185,2019-12-31,1183,4660,5843
15,15185,2020-12-31,1207,4658,5865
15,15185,2021-12-31,1272,4634,5906
15,15185,2022-12-31,1335,4609,5944
15,15185,2023-12-31,1397,4584,5981
15,15185,2024-12-31,1427,4577,6004
15,15185,2025-12-31,1448,4558,6006
15,15185,2026-12-31,1465,4552,6017
15,15185,2027-12-31,1481,4555,6036
15,15185,2028-12-31,1497,4568,6065
15,15185,2029-12-31,1511,4598,6109
15,15185,2030-12-31,1526,4631,6157
15,15185,2031-12-31,1538,4660,6198
15,15185,2032-12-31,1537,4697,6234
15,15185,2033-12-31,1552,4739,6291
15,15185,2034-12-31,1566,4780,6346
15,15185,2035-12-31,1568,4797,6365
15,15187,1985-12-31,185,2723,2908
15,15187,1986-12-31,236,2690,2926
15,15187,1987-12-31,238,2697,2935
15,15187,1988-12-31,243,2676,2919
15,15187,1989-12-31,253,2672,2925
15,15187,1990-12-31,245,2661,2906
15,15187,1991-12-31,249,2644,2893
15,15187,1992-12-31,253,2637,2890
15,15187,1993-12-31,276,2614,2890
15,15187,1994-12-31,269,2595,2864
15,15187,1995-12-31,243,2595,2838
15,15187,1996-12-31,284,2589,2873
15,15187,1997-12-31,286,2576,2862
15,15187,1998-12-31,290,2548,2838
15,15187,1999-12-31,320,2536,2856
15,15187,2000-12-31,322,2527,2849
15,15187,2001-12-31,299,2508,2807
15,15187,2002-12-31,331,2484,2815
15,15187,2003-12-31,343,2461,2804
15,15187,2004-12-31,347,2436,2783
15,15187,2005-12-31,368,2420,2788
15,15187,2006-12-31,367,2407,2774
15,15187,2007-12-31,370,2404,2774
15,15187,2008-12-31,393,2389,2782
15,15187,2009-12-31,406,2387,2793
15,15187,2010-12-31,380,2347,2727
15,15187,2011-12-31,422,2357,2779
15,15187,2012-12-31,416,2357,2773
15,15187,2013-12-31,426,2368,2794
15,15187,2014-12-31,459,2373,2832
15,15187,2015-12-31,445,2345,2790
15,15187,2016-12-31,444,2349,2793
15,15187,2017-12-31,489,2330,2819
15,15187,2018-12-31,470,2318,2788
15,15187,2019-12-31,480,2332,2812
15,15187,2020-12-31,489,2345,2834
15,15187,2021-12-31,521,2333,2854
15,15187,2022-12-31,552,2320,2872
15,15187,2023-12-31,582,2308,2890
15,15187,2024-12-31,583,2302,2885
15,15187,2025-12-31,601,2296,2897
15,15187,2026-12-31,617,2295,2912
15,15187,2027-12-31,620,2305,2925
15,15187,2028-12-31,625,2306,2931
15,15187,2029-12-31,627,2308,2935
15,15187,2030-12-31,631,2330,2961
15,15187,2031-12-31,640,2348,2988
15,15187,2032-12-31,642,2374,3016
15,15187,2033-12-31,645,2387,3032
15,15187,2034-12-31,648,2400,3048
15,15187,2035-12-31,654,2425,3079
15,15189,1985-12-31,739,4943,5682
15,15189,1986-12-31,738,4898,5636
15,15189,1987-12-31,753,4872,5625
15,15189,1988-12-31,767,4822,5589
15,15189,1989-12-31,779,4772,5551
15,15189,1990-12-31,790,4732,5522
15,15189,1991-12-31,821,4673,5494
15,15189,1992-12-31,819,4612,5431
15,15189,1993-12-31,864,4551,5415
15,15189,1994-12-31,893,4495,5388
15,15189,1995-12-31,945,4453,5398
15,15189,1996-12-31,937,4393,5330
15,15189,1997-12-31,952,4347,5299
15,15189,1998-12-31,942,4270,5212
15,15189,1999-12-31,952,4200,5152
15,15189,2000-12-31,979,4151,5130
15,15189,2001-12-31,979,4097,5076
15,15189,2002-12-31,1004,4041,5045
15,15189,2003-12-31,1003,3980,4983
15,15189,2004-12-31,1025,3924,4949
15,15189,2005-12-31,1036,3869,4905
15,15189,2006-12-31,1041,3829,4870
15,15189,2007-12-31,1058,3784,4842
15,15189,2008-12-31,1097,3750,4847
15,15189,2009-12-31,1134,3687,4821
15,15189,2010-12-31,1141,3630,4771
15,15189,2011-12-31,1144,3577,4721
15,15189,2012-12-31,1147,3555,4702
15,15189,2013-12-31,1153,3518,4671
15,15189,2014-12-31,1159,3479,4638
15,15189,2015-12-31,1168,3491,4659
15,15189,2016-12-31,1181,3469,4650
15,15189,2017-12-31,1194,3435,4629
15,15189,2018-12-31,1207,3428,4635
15,15189,2019-12-31,1233,3409,4642
15,15189,2020-12-31,1256,3399,4655
15,15189,2021-12-31,1309,3379,4688
15,15189,2022-12-31,1358,3360,4718
15,15189,2023-12-31,1406,3341,4747
15,15189,2024-12-31,1432,3332,4764
15,15189,2025-12-31,1445,3328,4773
15,15189,2026-12-31,1458,3325,4783
15,15189,2027-12-31,1481,3324,4805
15,15189,2028-12-31,1505,3337,4842
15,15189,2029-12-31,1514,3354,4868
15,15189,2030-12-31,1528,3365,4893
15,15189,2031-12-31,1539,3407,4946
15,15189,2032-12-31,1542,3426,4968
15,15189,2033-12-31,1556,3460,5016
15,15189,2034-12-31,1570,3463,5033
15,15189,2035-12-31,1579,3506,5085
15,15204,1985-12-31,435,9458,9893
15,15204,1986-12-31,461,9531,9992
15,15204,1987-12-31,501,9623,10124
15,15204,1988-12-31,583,9688,10271
15,15204,1989-12-31,597,9735,10332
15,15204,1990-12-31,578,9714,10292
15,15204,1991-12-31,633,9741,10374
15,15204,1992-12-31,672,9800,10472
15,15204,1993-12-31,672,9840,10512
15,15204,1994-12-31,679,9915,10594
15,15204,1995-12-31,707,9950,10657
15,15204,1996-12-31,767,9984,10751
15,15204,1997-12-31,734,10058,10792
15,15204,1998-12-31,777,10117,10894
15,15204,1999-12-31,813,10185,10998
15,15204,2000-12-31,856,10256,11112
15,15204,2001-12-31,852,10308,11160
15,15204,2002-12-31,885,10348,11233
15,15204,2003-12-31,898,10388,11286
15,15204,2004-12-31,936,10429,11365
15,15204,2005-12-31,953,10477,11430
15,15204,2006-12-31,955,10534,11489
15,15204,2007-12-31,999,10579,11578
15,15204,2008-12-31,1041,10641,11682
15,15204,2009-12-31,1042,10716,11758
15,15204,2010-12-31,1053,10783,11836
15,15204,2011-12-31,1090,10863,11953
15,15204,2012-12-31,1126,10938,12064
15,15204,2013-12-31,1154,11017,12171
15,15204,2014-12-31,1185,11138,12323
15,15204,2015-12-31,1211,11253,12464
15,15204,2016-12-31,1241,11344,12585
15,15204,2017-12-31,1259,11541,12800
15,15204,2018-12-31,1286,11684,12970
15,15204,2019-12-31,1327,11813,13140
15,15204,2020-12-31,1360,11920,13280
15,15204,2021-12-31,1517,11860,13377
15,15204,2022-12-31,1667,11794,13461
15,15204,2023-12-31,1813,11731,13544
15,15204,2024-12-31,1873,11692,13565
15,15204,2025-12-31,1911,11671,13582
15,15204,2026-12-31,1939,11660,13599
15,15204,2027-12-31,1961,11690,13651
15,15204,2028-12-31,1976,11716,13692
15,15204,2029-12-31,1992,11779,13771
15,15204,2030-12-31,2014,11866,13880
15,15204,2031-12-31,2035,11958,13993
15,15204,2032-12-31,2044,12046,14090
15,15204,2033-12-31,2051,12133,14184
15,15204,2034-12-31,2070,12239,14309
15,15204,2035-12-31,2085,12315,14400
15,15212,1985-12-31,390,5118,5508
15,15212,1986-12-31,399,5042,5441
15,15212,1987-12-31,410,4974,5384
15,15212,1988-12-31,423,4899,5322
15,15212,1989-12-31,436,4823,5259
15,15212,1990-12-31,444,4751,5195
15,15212,1991-12-31,464,4646,5110
15,15212,1992-12-31,476,4574,5050
15,15212,1993-12-31,515,4508,5023
15,15212,1994-12-31,509,4435,4944
15,15212,1995-12-31,527,4363,4890
15,15212,1996-12-31,544,4271,4815
15,15212,1997-12-31,576,4205,4781
15,15212,1998-12-31,599,4126,4725
15,15212,1999-12-31,630,4037,4667
15,15212,2000-12-31,645,3937,4582
15,15212,2001-12-31,632,3864,4496
15,15212,2002-12-31,638,3796,4434
15,15212,2003-12-31,645,3716,4361
15,15212,2004-12-31,656,3632,4288
15,15212,2005-12-31,665,3541,4206
15,15212,2006-12-31,687,3485,4172
15,15212,2007-12-31,704,3401,4105
15,15212,2008-12-31,726,3325,4051
15,15212,2009-12-31,743,3264,4007
15,15212,2010-12-31,757,3200,3957
15,15212,2011-12-31,766,3130,3896
15,15212,2012-12-31,778,3085,3863
15,15212,2013-12-31,797,2996,3793
15,15212,2014-12-31,809,2931,3740
15,15212,2015-12-31,817,2923,3740
15,15212,2016-12-31,834,2926,3760
15,15212,2017-12-31,846,2781,3627
15,15212,2018-12-31,862,2757,3619
15,15212,2019-12-31,881,2704,3585
15,15212,2020-12-31,898,2673,3571
15,15212,2021-12-31,937,2659,3596
15,15212,2022-12-31,975,2644,3619
15,15212,2023-12-31,1011,2630,3641
15,15212,2024-12-31,1021,2621,3642
15,15212,2025-12-31,1045,2610,3655
15,15212,2026-12-31,1057,2614,3671
15,15212,2027-12-31,1064,2613,3677
15,15212,2028-12-31,1073,2629,3702
15,15212,2029-12-31,1084,2640,3724
15,15212,2030-12-31,1093,2652,3745
15,15212,2031-12-31,1101,2687,3788
15,15212,2032-12-31,1108,2693,3801
15,15212,2033-12-31,1117,2711,3828
15,15212,2034-12-31,1128,2744,3872
15,15212,2035-12-31,1138,2761,3899
15,15215,1985-12-31,1218,1223,2441
15,15215,1986-12-31,1235,1190,2425
15,15215,1987-12-31,1236,1198,2434
15,15215,1988-12-31,1243,1194,2437
15,15215,1989-12-31,1241,1174,2415
15,15215,1990-12-31,1264,1165,2429
15,15215,1991-12-31,1274,1154,2428
15,15215,1992-12-31,1272,1140,2412
15,15215,1993-12-31,1297,1133,2430
15,15215,1994-12-31,1312,1136,2448
15,15215,1995-12-31,1345,1122,2467
15,15215,1996-12-31,1357,1126,2483
15,15215,1997-12-31,1391,1116,2507
15,15215,1998-12-31,1410,1102,2512
15,15215,1999-12-31,1412,1098,2510
15,15215,2000-12-31,1422,1096,2518
15,15215,2001-12-31,1408,1071,2479
15,15215,2002-12-31,1399,1082,2481
15,15215,2003-12-31,1455,1069,2524
15,15215,2004-12-31,1460,1059,2519
15,15215,2005-12-31,1427,1068,2495
15,15215,2006-12-31,1434,1057,2491
15,15215,2007-12-31,1435,1040,2475
15,15215,2008-12-31,1435,1024,2459
15,15215,2009-12-31,1442,987,2429
15,15215,2010-12-31,1446,966,2412
15,15215,2011-12-31,1460,968,2428
15,15215,2012-12-31,1464,947,2411
15,15215,2013-12-31,1474,942,2416
15,15215,2014-12-31,1490,938,2428
15,15215,2015-12-31,1505,938,2443
15,15215,2016-12-31,1516,932,2448
15,15215,2017-12-31,1539,930,2469
15,15215,2018-12-31,1561,937,2498
15,15215,2019-12-31,1571,952,2523
15,15215,2020-12-31,1586,959,2545
15,15215,2021-12-31,1609,954,2563
15,15215,2022-12-31,1630,949,2579
15,15215,2023-12-31,1651,944,2595
15,15215,2024-12-31,1679,936,2615
15,15215,2025-12-31,1688,940,2628
15,15215,2026-12-31,1713,934,2647
15,15215,2027-12-31,1733,939,2672
15,15215,2028-12-31,1745,942,2687
15,15215,2029-12-31,1757,951,2708
15,15215,2030-12-31,1778,946,2724
15,15215,2031-12-31,1783,956,2739
15,15215,2032-12-31,1804,967,2771
15,15215,2033-12-31,1810,969,2779
15,15215,2034-12-31,1822,984,2806
15,15215,2035-12-31,1840,1004,2844
15,15218,1985-12-31,427,5067,5494
15,15218,1986-12-31,430,4970,5400
15,15218,1987-12-31,434,4889,5323
15,15218,1988-12-31,435,4815,5250
15,15218,1989-12-31,409,4726,5135
15,15218,1990-12-31,423,4627,5050
15,15218,1991-12-31,465,4537,5002
15,15218,1992-12-31,417,4455,4872
15,15218,1993-12-31,458,4358,4816
15,15218,1994-12-31,423,4275,4698
15,15218,1995-12-31,443,4181,4624
15,15218,1996-12-31,458,4090,4548
15,15218,1997-12-31,428,4007,4435
15,15218,1998-12-31,417,3913,4330
15,15218,1999-12-31,445,3809,4254
15,15218,2000-12-31,452,3710,4162
15,15218,2001-12-31,457,3647,4104
15,15218,2002-12-31,463,3528,3991
15,15218,2003-12-31,468,3447,3915
15,15218,2004-12-31,474,3366,3840
15,15218,2005-12-31,492,3259,3751
15,15218,2006-12-31,478,3171,3649
15,15218,2007-12-31,470,3099,3569
15,15218,2008-12-31,465,3005,3470
15,15218,2009-12-31,461,2924,3385
15,15218,2010-12-31,462,2873,3335
15,15218,2011-12-31,463,2769,3232
15,15218,2012-12-31,471,2699,3170
15,15218,2013-12-31,478,2650,3128
15,15218,2014-12-31,483,2593,3076
15,15218,2015-12-31,489,2532,3021
15,15218,2016-12-31,493,2473,2966
15,15218,2017-12-31,495,2363,2858
15,15218,2018-12-31,492,2314,2806
15,15218,2019-12-31,494,2248,2742
15,15218,2020-12-31,497,2205,2702
15,15218,2021-12-31,528,2193,2721
15,15218,2022-12-31,557,2181,2738
15,15218,2023-12-31,585,2170,2755
15,15218,2024-12-31,608,2167,2775
15,15218,2025-12-31,614,2155,2769
15,15218,2026-12-31,615,2149,2764
15,15218,2027-12-31,619,2157,2776
15,15218,2028-12-31,620,2165,2785
15,15218,2029-12-31,624,2171,2795
15,15218,2030-12-31,622,2193,2815
15,15218,2031-12-31,632,2200,2832
15,15218,2032-12-31,646,2228,2874
15,15218,2033-12-31,644,2237,2881
15,15218,2034-12-31,653,2250,2903
15,15218,2035-12-31,657,2263,2920
15,15223,1985-12-31,830,3164,3994
15,15223,1986-12-31,876,3338,4214
15,15223,1987-12-31,904,3477,4381
15,15223,1988-12-31,941,3627,4568
15,15223,1989-12-31,993,3771,4764
15,15223,1990-12-31,1031,3911,4942
15,15223,1991-12-31,1061,4052,5113
15,15223,1992-12-31,1109,4215,5324
15,15223,1993-12-31,1145,4360,5505
15,15223,1994-12-31,1199,4500,5699
15,15223,1995-12-31,1237,4653,5890
15,15223,1996-12-31,1276,4773,6049
15,15223,1997-12-31,1327,4914,6241
15,15223,1998-12-31,1382,5067,6449
15,15223,1999-12-31,1419,5209,6628
15,15223,2000-12-31,1473,5345,6818
15,15223,2001-12-31,1520,5450,6970
15,15223,2002-12-31,1555,5573,7128
15,15223,2003-12-31,1588,5692,7280
15,15223,2004-12-31,1626,5843,7469
15,15223,2005-12-31,1682,5995,7677
15,15223,2006-12-31,1674,6136,7810
15,15223,2007-12-31,1735,6265,8000
15,15223,2008-12-31,1782,6418,8200
15,15223,2009-12-31,1838,6600,8438
15,15223,2010-12-31,1885,6745,8630
15,15223,2011-12-31,1931,6878,8809
15,15223,2012-12-31,1964,7047,9011
15,15223,2013-12-31,2012,7215,9227
15,15223,2014-12-31,2044,7376,9420
15,15223,2015-12-31,2079,7534,9613
15,15223,2016-12-31,2113,7714,9827
15,15223,2017-12-31,2143,7960,10103
15,15223,2018-12-31,2182,8137,10319
15,15223,2019-12-31,2243,8320,10563
15,15223,2020-12-31,2296,8454,10750
15,15223,2021-12-31,2417,8411,10828
15,15223,2022-12-31,2532,8365,10897
15,15223,2023-12-31,2644,8320,10964
15,15223,2024-12-31,2704,8285,10989
15,15223,2025-12-31,2743,8273,11016
15,15223,2026-12-31,2790,8266,11056
15,15223,2027-12-31,2815,8282,11097
15,15223,2028-12-31,2841,8311,11152
15,15223,2029-12-31,2869,8356,11225
15,15223,2030-12-31,2896,8418,11314
15,15223,2031-12-31,2910,8483,11393
15,15223,2032-12-31,2938,8549,11487
15,15223,2033-12-31,2953,8623,11576
15,15223,2034-12-31,2975,8677,11652
15,15223,2035-12-31,2995,8746,11741
15,15224,1985-12-31,749,2475,3224
15,15224,1986-12-31,759,2475,3234
15,15224,1987-12-31,775,2488,3263
15,15224,1988-12-31,787,2467,3254
15,15224,1989-12-31,824,2469,3293
15,15224,1990-12-31,819,2455,3274
15,15224,1991-12-31,854,2454,3308
15,15224,1992-12-31,877,2446,3323
15,15224,1993-12-31,899,2418,3317
15,15224,1994-12-31,959,2418,3377
15,15224,1995-12-31,999,2415,3414
15,15224,1996-12-31,1045,2424,3469
15,15224,1997-12-31,1046,2400,3446
15,15224,1998-12-31,1065,2380,3445
15,15224,1999-12-31,1056,2390,3446
15,15224,2000-12-31,1095,2368,3463
15,15224,2001-12-31,1121,2364,3485
15,15224,2002-12-31,1154,2345,3499
15,15224,2003-12-31,1139,2331,3470
15,15224,2004-12-31,1177,2331,3508
15,15224,2005-12-31,1195,2306,3501
15,15224,2006-12-31,1211,2304,3515
15,15224,2007-12-31,1236,2280,3516
15,15224,2008-12-31,1255,2286,3541
15,15224,2009-12-31,1293,2276,3569
15,15224,2010-12-31,1302,2276,3578
15,15224,2011-12-31,1311,2269,3580
15,15224,2012-12-31,1354,2269,3623
15,15224,2013-12-31,1398,2300,3698
15,15224,2014-12-31,1415,2305,3720
15,15224,2015-12-31,1429,2294,3723
15,15224,2016-12-31,1439,2289,3728
15,15224,2017-12-31,1449,2276,3725
15,15224,2018-12-31,1457,2268,3725
15,15224,2019-12-31,1492,2267,3759
15,15224,2020-12-31,1526,2261,3787
15,15224,2021-12-31,1564,2250,3814
15,15224,2022-12-31,1601,2237,3838
15,15224,2023-12-31,1637,2225,3862
15,15224,2024-12-31,1665,2213,3878
15,15224,2025-12-31,1678,2210,3888
15,15224,2026-12-31,1703,2211,3914
15,15224,2027-12-31,1736,2201,3937
15,15224,2028-12-31,1751,2220,3971
15,15224,2029-12-31,1752,2230,3982
15,15224,2030-12-31,1772,2246,4018
15,15224,2031-12-31,1788,2263,4051
15,15224,2032-12-31,1802,2285,4087
15,15224,2033-12-31,1814,2296,4110
15,15224,2034-12-31,1823,2315,4138
15,15224,2035-12-31,1843,2337,4180
15,15226,1985-12-31,190,2097,2287
15,15226,1986-12-31,163,2097,2260
15,15226,1987-12-31,163,2062,2225
15,15226,1988-12-31,162,2031,2193
15,15226,1989-12-31,146,2021,2167
15,15226,1990-12-31,124,1992,2116
15,15226,1991-12-31,121,1978,2099
15,15226,1992-12-31,156,1994,2150
15,15226,1993-12-31,154,1977,2131
15,15226,1994-12-31,219,1947,2166
15,15226,1995-12-31,171,1941,2112
15,15226,1996-12-31,175,1908,2083
15,15226,1997-12-31,187,1928,2115
15,15226,1998-12-31,190,1891,2081
15,15226,1999-12-31,202,1881,2083
15,15226,2000-12-31,216,1828,2044
15,15226,2001-12-31,226,1813,2039
15,15226,2002-12-31,228,1808,2036
15,15226,2003-12-31,229,1783,2012
15,15226,2004-12-31,233,1760,1993
15,15226,2005-12-31,233,1718,1951
15,15226,2006-12-31,232,1698,1930
15,15226,2007-12-31,245,1682,1927
15,15226,2008-12-31,240,1666,1906
15,15226,2009-12-31,234,1649,1883
15,15226,2010-12-31,232,1639,1871
15,15226,2011-12-31,230,1628,1858
15,15226,2012-12-31,255,1623,1878
15,15226,2013-12-31,252,1598,1850
15,15226,2014-12-31,252,1578,1830
15,15226,2015-12-31,251,1562,1813
15,15226,2016-12-31,251,1552,1803
15,15226,2017-12-31,253,1548,1801
15,15226,2018-12-31,251,1547,1798
15,15226,2019-12-31,258,1546,1804
15,15226,2020-12-31,263,1547,1810
15,15226,2021-12-31,284,1539,1823
15,15226,2022-12-31,303,1531,1834
15,15226,2023-12-31,324,1522,1846
15,15226,2024-12-31,312,1522,1834
15,15226,2025-12-31,323,1514,1837
15,15226,2026-12-31,333,1514,1847
15,15226,2027-12-31,343,1512,1855
15,15226,2028-12-31,349,1507,1856
15,15226,2029-12-31,353,1519,1872
15,15226,2030-12-31,353,1532,1885
15,15226,2031-12-31,361,1541,1902
15,15226,2032-12-31,364,1554,1918
15,15226,2033-12-31,369,1566,1935
15,15226,2034-12-31,370,1576,1946
15,15226,2035-12-31,372,1581,1953
15,15232,1985-12-31,27,5252,5279
15,15232,1986-12-31,78,5223,5301
15,15232,1987-12-31,0,5190,5190
15,15232,1988-12-31,0,5168,5168
15,15232,1989-12-31,138,5133,5271
15,15232,1990-12-31,114,5094,5208
15,15232,1991-12-31,117,5044,5161
15,15232,1992-12-31,123,5029,5152
15,15232,1993-12-31,152,4993,5145
15,15232,1994-12-31,158,4976,5134
15,15232,1995-12-31,158,4941,5099
15,15232,1996-12-31,177,4904,5081
15,15232,1997-12-31,175,4875,5050
15,15232,1998-12-31,162,4836,4998
15,15232,1999-12-31,179,4789,4968
15,15232,2000-12-31,158,4734,4892
15,15232,2001-12-31,158,4688,4846
15,15232,2002-12-31,158,4649,4807
15,15232,2003-12-31,157,4612,4769
15,15232,2004-12-31,157,4563,4720
15,15232,2005-12-31,182,4536,4718
15,15232,2006-12-31,200,4494,4694
15,15232,2007-12-31,219,4483,4702
15,15232,2008-12-31,233,4458,4691
15,15232,2009-12-31,249,4431,4680
15,15232,2010-12-31,256,4423,4679
15,15232,2011-12-31,275,4381,4656
15,15232,2012-12-31,264,4359,4623
15,15232,2013-12-31,294,4364,4658
15,15232,2014-12-31,306,4353,4659
15,15232,2015-12-31,314,4305,4619
15,15232,2016-12-31,316,4322,4638
15,15232,2017-12-31,324,4375,4699
15,15232,2018-12-31,332,4352,4684
15,15232,2019-12-31,339,4374,4713
15,15232,2020-12-31,346,4398,4744
15,15232,2021-12-31,402,4376,4778
15,15232,2022-12-31,456,4352,4808
15,15232,2023-12-31,509,4328,4837
15,15232,2024-12-31,525,4309,4834
15,15232,2025-12-31,537,4304,4841
15,15232,2026-12-31,542,4301,4843
15,15232,2027-12-31,548,4300,4848
15,15232,2028-12-31,554,4312,4866
15,15232,2029-12-31,559,4350,4909
15,15232,2030-12-31,563,4363,4926
15,15232,2031-12-31,573,4399,4972
15,15232,2032-12-31,579,4425,5004
15,15232,2033-12-31,577,4477,5054
15,15232,2034-12-31,580,4509,5089
15,15232,2035-12-31,583,4532,5115
15,15236,1985-12-31,0,0,0
15,15236,1986-12-31,0,0,0
15,15236,1987-12-31,0,0,0
15,15236,1988-12-31,0,0,0
15,15236,1989-12-31,0,0,0
15,15236,1990-12-31,0,0,0
15,15236,1991-12-31,1194,2501,3695
15,15236,1992-12-31,1191,2465,3656
15,15236,1993-12-31,1139,2439,3578
15,15236,1994-12-31,1144,2413,3557
15,15236,1995-12-31,1149,2400,3549
15,15236,1996-12-31,1131,2356,3487
15,15236,1997-12-31,1107,2345,3452
15,15236,1998-12-31,1118,2327,3445
15,15236,1999-12-31,1070,2297,3367
15,15236,2000-12-31,1084,2271,3355
15,15236,2001-12-31,1036,2230,3266
15,15236,2002-12-31,1004,2197,3201
15,15236,2003-12-31,970,2160,3130
15,15236,2004-12-31,948,2126,3074
15,15236,2005-12-31,964,2093,3057
15,15236,2006-12-31,944,2054,2998
15,15236,2007-12-31,915,2011,2926
15,15236,2008-12-31,885,2018,2903
15,15236,2009-12-31,891,1987,2878
15,15236,2010-12-31,833,1968,2801
15,15236,2011-12-31,832,1949,2781
15,15236,2012-12-31,807,1928,2735
15,15236,2013-12-31,779,1927,2706
15,15236,2014-12-31,747,1917,2664
15,15236,2015-12-31,755,1873,2628
15,15236,2016-12-31,724,1803,2527
15,15236,2017-12-31,661,1796,2457
15,15236,2018-12-31,681,1798,2479
15,15236,2019-12-31,684,1820,2504
15,15236,2020-12-31,685,1841,2526
15,15236,2021-12-31,712,1832,2544
15,15236,2022-12-31,738,1822,2560
15,15236,2023-12-31,764,1812,2576
15,15236,2024-12-31,775,1804,2579
15,15236,2025-12-31,779,1801,2580
15,15236,2026-12-31,788,1798,2586
15,15236,2027-12-31,794,1802,2596
15,15236,2028-12-31,807,1806,2613
15,15236,2029-12-31,815,1820,2635
15,15236,2030-12-31,822,1832,2654
15,15236,2031-12-31,826,1840,2666
15,15236,2032-12-31,835,1853,2688
15,15236,2033-12-31,838,1867,2705
15,15236,2034-12-31,845,1876,2721
15,15236,2035-12-31,850,1895,2745
15,15238,1985-12-31,50403,13910,64313
15,15238,1986-12-31,51920,13881,65801
15,15238,1987-12-31,53469,13904,67373
15,15238,1988-12-31,55054,13883,68937
15,15238,1989-12-31,56645,13868,70513
15,15238,1990-12-31,58366,13897,72263
15,15238,1991-12-31,59859,13865,73724
15,15238,1992-12-31,61624,13888,75512
15,15238,1993-12-31,63344,13899,77243
15,15238,1994-12-31,65186,13901,79087
15,15238,1995-12-31,67089,13905,80994
15,15238,1996-12-31,69003,13922,82925
15,15238,1997-12-31,70918,13944,84862
15,15238,1998-12-31,72875,13959,86834
15,15238,1999-12-31,74781,13964,88745
15,15238,2000-12-31,76673,13961,90634
15,15238,2001-12-31,78549,13992,92541
15,15238,2002-12-31,80405,13975,94380
15,15238,2003-12-31,82256,13999,96255
15,15238,2004-12-31,84031,14002,98033
15,15238,2005-12-31,85739,13991,99730
15,15238,2006-12-31,87533,14013,101546
15,15238,2007-12-31,89307,14018,103325
15,15238,2008-12-31,91108,14054,105162
15,15238,2009-12-31,92812,14073,106885
15,15238,2010-12-31,94591,14103,108694
15,15238,2011-12-31,96273,14225,110498
15,15238,2012-12-31,97911,14281,112192
15,15238,2013-12-31,99496,14331,113827
15,15238,2014-12-31,101066,14435,115501
15,15238,2015-12-31,102644,14515,117159
15,15238,2016-12-31,104226,14626,118852
15,15238,2017-12-31,105883,14690,120573
15,15238,2018-12-31,107520,14916,122436
15,15238,2019-12-31,110030,14750,124780
15,15238,2020-12-31,112308,14362,126670
15,15238,2021-12-31,113306,14286,127592
15,15238,2022-12-31,114192,14208,128400
15,15238,2023-12-31,115060,14132,129192
15,15238,2024-12-31,116398,14084,130482
15,15238,2025-12-31,117752,14056,131808
15,15238,2026-12-31,119084,14045,133129
15,15238,2027-12-31,120325,14062,134387
15,15238,2028-12-31,121484,14105,135589
15,15238,2029-12-31,122567,14181,136748
15,15238,2030-12-31,123543,14267,137810
15,15238,2031-12-31,124474,14377,138851
15,15238,2032-12-31,125374,14490,139864
15,15238,2033-12-31,126230,14594,140824
15,15238,2034-12-31,127059,14715,141774
15,15238,2035-12-31,127851,14822,142673
15,15244,1985-12-31,2310,4904,7214
15,15244,1986-12-31,2291,4810,7101
15,15244,1987-12-31,2278,4714,6992
15,15244,1988-12-31,2276,4632,6908
15,15244,1989-12-31,2259,4535,6794
15,15244,1990-12-31,2245,4460,6705
15,15244,1991-12-31,2235,4349,6584
15,15244,1992-12-31,2245,4261,6506
15,15244,1993-12-31,2236,4166,6402
15,15244,1994-12-31,2240,4082,6322
15,15244,1995-12-31,2240,3992,6232
15,15244,1996-12-31,2239,3906,6145
15,15244,1997-12-31,2259,3815,6074
15,15244,1998-12-31,2269,3733,6002
15,15244,1999-12-31,2301,3636,5937
15,15244,2000-12-31,2314,3534,5848
15,15244,2001-12-31,2327,3426,5753
15,15244,2002-12-31,2320,3325,5645
15,15244,2003-12-31,2319,3224,5543
15,15244,2004-12-31,2349,3131,5480
15,15244,2005-12-31,2292,3035,5327
15,15244,2006-12-31,2334,2948,5282
15,15244,2007-12-31,2279,2849,5128
15,15244,2008-12-31,2244,2762,5006
15,15244,2009-12-31,2233,2689,4922
15,15244,2010-12-31,2271,2619,4890
15,15244,2011-12-31,2265,2547,4812
15,15244,2012-12-31,2244,2467,4711
15,15244,2013-12-31,2234,2400,4634
15,15244,2014-12-31,2195,2330,4525
15,15244,2015-12-31,2183,2229,4412
15,15244,2016-12-31,2181,2193,4374
15,15244,2017-12-31,2180,2085,4265
15,15244,2018-12-31,2206,2009,4215
15,15244,2019-12-31,2198,1952,4150
15,15244,2020-12-31,2204,1911,4115
15,15244,2021-12-31,2243,1901,4144
15,15244,2022-12-31,2280,1890,4170
15,15244,2023-12-31,2316,1880,4196
15,15244,2024-12-31,2344,1871,4215
15,15244,2025-12-31,2379,1866,4245
15,15244,2026-12-31,2409,1869,4278
15,15244,2027-12-31,2427,1872,4299
15,15244,2028-12-31,2445,1866,4311
15,15244,2029-12-31,2472,1881,4353
15,15244,2030-12-31,2484,1896,4380
15,15244,2031-12-31,2503,1911,4414
15,15244,2032-12-31,2523,1923,4446
15,15244,2033-12-31,2539,1937,4476
15,15244,2034-12-31,2562,1961,4523
15,15244,2035-12-31,2577,1978,4555
15,15248,1985-12-31,1100,2955,4055
15,15248,1986-12-31,1108,2929,4037
15,15248,1987-12-31,1103,2910,4013
15,15248,1988-12-31,1101,2866,3967
15,15248,1989-12-31,1137,2809,3946
15,15248,1990-12-31,1131,2788,3919
15,15248,1991-12-31,1119,2726,3845
15,15248,1992-12-31,1130,2710,3840
15,15248,1993-12-31,1142,2657,3799
15,15248,1994-12-31,1188,2620,3808
15,15248,1995-12-31,1209,2593,3802
15,15248,1996-12-31,1211,2571,3782
15,15248,1997-12-31,1218,2485,3703
15,15248,1998-12-31,1229,2462,3691
15,15248,1999-12-31,1259,2443,3702
15,15248,2000-12-31,1258,2364,3622
15,15248,2001-12-31,1264,2341,3605
15,15248,2002-12-31,1272,2296,3568
15,15248,2003-12-31,1277,2273,3550
15,15248,2004-12-31,1278,2242,3520
15,15248,2005-12-31,1287,2179,3466
15,15248,2006-12-31,1303,2155,3458
15,15248,2007-12-31,1302,2084,3386
15,15248,2008-12-31,1323,2068,3391
15,15248,2009-12-31,1305,2008,3313
15,15248,2010-12-31,1305,2002,3307
15,15248,2011-12-31,1321,1996,3317
15,15248,2012-12-31,1282,1945,3227
15,15248,2013-12-31,1283,1882,3165
15,15248,2014-12-31,1288,1825,3113
15,15248,2015-12-31,1312,1787,3099
15,15248,2016-12-31,1327,1752,3079
15,15248,2017-12-31,1352,1727,3079
15,15248,2018-12-31,1358,1703,3061
15,15248,2019-12-31,1362,1692,3054
15,15248,2020-12-31,1370,1684,3054
15,15248,2021-12-31,1401,1675,3076
15,15248,2022-12-31,1429,1666,3095
15,15248,2023-12-31,1457,1657,3114
15,15248,2024-12-31,1479,1648,3127
15,15248,2025-12-31,1496,1645,3141
15,15248,2026-12-31,1505,1654,3159
15,15248,2027-12-31,1524,1649,3173
15,15248,2028-12-31,1545,1649,3194
15,15248,2029-12-31,1557,1657,3214
15,15248,2030-12-31,1569,1661,3230
15,15248,2031-12-31,1583,1672,3255
15,15248,2032-12-31,1590,1687,3277
15,15248,2033-12-31,1599,1692,3291
15,15248,2034-12-31,1618,1711,3329
15,15248,2035-12-31,1617,1718,3335
15,15272,1985-12-31,1567,4374,5941
15,15272,1986-12-31,1581,4401,5982
15,15272,1987-12-31,1602,4390,5992
15,15272,1988-12-31,1642,4390,6032
15,15272,1989-12-31,1645,4355,6000
15,15272,1990-12-31,1672,4341,6013
15,15272,1991-12-31,1684,4294,5978
15,15272,1992-12-31,1712,4274,5986
15,15272,1993-12-31,1738,4275,6013
15,15272,1994-12-31,1760,4269,6029
15,15272,1995-12-31,1788,4246,6034
15,15272,1996-12-31,1845,4234,6079
15,15272,1997-12-31,1894,4211,6105
15,15272,1998-12-31,1960,4200,6160
15,15272,1999-12-31,2003,4176,6179
15,15272,2000-12-31,2036,4187,6223
15,15272,2001-12-31,2068,4162,6230
15,15272,2002-12-31,2088,4150,6238
15,15272,2003-12-31,2110,4138,6248
15,15272,2004-12-31,2147,4114,6261
15,15272,2005-12-31,2154,4094,6248
15,15272,2006-12-31,2211,4079,6290
15,15272,2007-12-31,2231,4080,6311
15,15272,2008-12-31,2229,4073,6302
15,15272,2009-12-31,2265,4058,6323
15,15272,2010-12-31,2306,3997,6303
15,15272,2011-12-31,2337,3987,6324
15,15272,2012-12-31,2355,3991,6346
15,15272,2013-12-31,2335,3990,6325
15,15272,2014-12-31,2346,3990,6336
15,15272,2015-12-31,2382,4017,6399
15,15272,2016-12-31,2423,4100,6523
15,15272,2017-12-31,2457,4159,6616
15,15272,2018-12-31,2497,4165,6662
15,15272,2019-12-31,2515,4222,6737
15,15272,2020-12-31,2529,4273,6802
15,15272,2021-12-31,2600,4251,6851
15,15272,2022-12-31,2667,4228,6895
15,15272,2023-12-31,2732,4205,6937
15,15272,2024-12-31,2776,4177,6953
15,15272,2025-12-31,2811,4175,6986
15,15272,2026-12-31,2843,4155,6998
15,15272,2027-12-31,2874,4167,7041
15,15272,2028-12-31,2901,4187,7088
15,15272,2029-12-31,2925,4204,7129
15,15272,2030-12-31,2944,4246,7190
15,15272,2031-12-31,2966,4282,7248
15,15272,2032-12-31,2991,4299,7290
15,15272,2033-12-31,3013,4352,7365
15,15272,2034-12-31,3026,4376,7402
15,15272,2035-12-31,3044,4414,7458
15,15276,1985-12-31,1013,3816,4829
15,15276,1986-12-31,993,3818,4811
15,15276,1987-12-31,1014,3760,4774
15,15276,1988-12-31,998,3682,4680
15,15276,1989-12-31,1033,3631,4664
15,15276,1990-12-31,1058,3578,4636
15,15276,1991-12-31,1047,3521,4568
15,15276,1992-12-31,1052,3469,4521
15,15276,1993-12-31,1080,3399,4479
15,15276,1994-12-31,1076,3336,4412
15,15276,1995-12-31,1073,3291,4364
15,15276,1996-12-31,1087,3241,4328
15,15276,1997-12-31,1105,3168,4273
15,15276,1998-12-31,1104,3136,4240
15,15276,1999-12-31,1091,3046,4137
15,15276,2000-12-31,1060,2963,4023
15,15276,2001-12-31,1062,2915,3977
15,15276,2002-12-31,1092,2876,3968
15,15276,2003-12-31,1102,2808,3910
15,15276,2004-12-31,1118,2740,3858
15,15276,2005-12-31,1138,2663,3801
15,15276,2006-12-31,1120,2608,3728
15,15276,2007-12-31,1107,2553,3660
15,15276,2008-12-31,1102,2507,3609
15,15276,2009-12-31,1096,2451,3547
15,15276,2010-12-31,1097,2421,3518
15,15276,2011-12-31,1097,2383,3480
15,15276,2012-12-31,1100,2338,3438
15,15276,2013-12-31,1105,2328,3433
15,15276,2014-12-31,1112,2308,3420
15,15276,2015-12-31,1118,2297,3415
15,15276,2016-12-31,1126,2224,3350
15,15276,2017-12-31,1138,2117,3255
15,15276,2018-12-31,1152,2114,3266
15,15276,2019-12-31,1174,2066,3240
15,15276,2020-12-31,1194,2037,3231
15,15276,2021-12-31,1228,2026,3254
15,15276,2022-12-31,1259,2015,3274
15,15276,2023-12-31,1291,2004,3295
15,15276,2024-12-31,1308,2002,3310
15,15276,2025-12-31,1325,1999,3324
15,15276,2026-12-31,1332,1997,3329
15,15276,2027-12-31,1357,1991,3348
15,15276,2028-12-31,1373,2001,3374
15,15276,2029-12-31,1383,2008,3391
15,15276,2030-12-31,1390,2020,3410
15,15276,2031-12-31,1398,2032,3430
15,15276,2032-12-31,1405,2049,3454
15,15276,2033-12-31,1419,2066,3485
15,15276,2034-12-31,1433,2082,3515
15,15276,2035-12-31,1445,2092,3537
15,15293,1985-12-31,303,3399,3702
15,15293,1986-12-31,308,3394,3702
15,15293,1987-12-31,304,3343,3647
15,15293,1988-12-31,310,3308,3618
15,15293,1989-12-31,320,3260,3580
15,15293,1990-12-31,332,3231,3563
15,15293,1991-12-31,328,3173,3501
15,15293,1992-12-31,337,3144,3481
15,15293,1993-12-31,377,3094,3471
15,15293,1994-12-31,413,3059,3472
15,15293,1995-12-31,401,3031,3432
15,15293,1996-12-31,380,2995,3375
15,15293,1997-12-31,388,2965,3353
15,15293,1998-12-31,409,2926,3335
15,15293,1999-12-31,392,2873,3265
15,15293,2000-12-31,417,2820,3237
15,15293,2001-12-31,407,2778,3185
15,15293,2002-12-31,467,2731,3198
15,15293,2003-12-31,472,2690,3162
15,15293,2004-12-31,472,2653,3125
15,15293,2005-12-31,498,2612,3110
15,15293,2006-12-31,468,2573,3041
15,15293,2007-12-31,492,2530,3022
15,15293,2008-12-31,448,2497,2945
15,15293,2009-12-31,455,2466,2921
15,15293,2010-12-31,479,2433,2912
15,15293,2011-12-31,494,2402,2896
15,15293,2012-12-31,489,2389,2878
15,15293,2013-12-31,516,2407,2923
15,15293,2014-12-31,524,2356,2880
15,15293,2015-12-31,532,2316,2848
15,15293,2016-12-31,537,2257,2794
15,15293,2017-12-31,542,2232,2774
15,15293,2018-12-31,557,2232,2789
15,15293,2019-12-31,569,2210,2779
15,15293,2020-12-31,580,2198,2778
15,15293,2021-12-31,612,2186,2798
15,15293,2022-12-31,641,2174,2815
15,15293,2023-12-31,670,2163,2833
15,15293,2024-12-31,675,2151,2826
15,15293,2025-12-31,687,2152,2839
15,15293,2026-12-31,697,2143,2840
15,15293,2027-12-31,702,2146,2848
15,15293,2028-12-31,706,2157,2863
15,15293,2029-12-31,711,2162,2873
15,15293,2030-12-31,714,2174,2888
15,15293,2031-12-31,724,2195,2919
15,15293,2032-12-31,732,2213,2945
15,15293,2033-12-31,739,2226,2965
15,15293,2034-12-31,739,2251,2990
15,15293,2035-12-31,752,2255,3007
15,15296,1985-12-31,1316,4700,6016
15,15296,1986-12-31,1305,4675,5980
15,15296,1987-12-31,1304,4644,5948
15,15296,1988-12-31,1319,4604,5923
15,15296,1989-12-31,1310,4605,5915
15,15296,1990-12-31,1302,4556,5858
15,15296,1991-12-31,1293,4511,5804
15,15296,1992-12-31,1305,4470,5775
15,15296,1993-12-31,1305,4398,5703
15,15296,1994-12-31,1312,4347,5659
15,15296,1995-12-31,1337,4308,5645
15,15296,1996-12-31,1348,4274,5622
15,15296,1997-12-31,1364,4229,5593
15,15296,1998-12-31,1371,4162,5533
15,15296,1999-12-31,1348,4137,5485
15,15296,2000-12-31,1354,4078,5432
15,15296,2001-12-31,1363,4027,5390
15,15296,2002-12-31,1371,3997,5368
15,15296,2003-12-31,1335,3947,5282
15,15296,2004-12-31,1361,3879,5240
15,15296,2005-12-31,1330,3840,5170
15,15296,2006-12-31,1359,3794,5153
15,15296,2007-12-31,1360,3764,5124
15,15296,2008-12-31,1358,3717,5075
15,15296,2009-12-31,1356,3687,5043
15,15296,2010-12-31,1355,3660,5015
15,15296,2011-12-31,1334,3614,4948
15,15296,2012-12-31,1329,3576,4905
15,15296,2013-12-31,1328,3563,4891
15,15296,2014-12-31,1293,3536,4829
15,15296,2015-12-31,1288,3567,4855
15,15296,2016-12-31,1303,3538,4841
15,15296,2017-12-31,1312,3522,4834
15,15296,2018-12-31,1327,3523,4850
15,15296,2019-12-31,1323,3522,4845
15,15296,2020-12-31,1328,3523,4851
15,15296,2021-12-31,1380,3505,4885
15,15296,2022-12-31,1430,3486,4916
15,15296,2023-12-31,1480,3467,4947
15,15296,2024-12-31,1495,3459,4954
15,15296,2025-12-31,1518,3452,4970
15,15296,2026-12-31,1535,3452,4987
15,15296,2027-12-31,1556,3447,5003
15,15296,2028-12-31,1557,3460,5017
15,15296,2029-12-31,1576,3482,5058
15,15296,2030-12-31,1589,3496,5085
15,15296,2031-12-31,1600,3518,5118
15,15296,2032-12-31,1617,3555,5172
15,15296,2033-12-31,1629,3587,5216
15,15296,2034-12-31,1645,3598,5243
15,15296,2035-12-31,1645,3629,5274
15,15299,1985-12-31,7225,6047,13272
15,15299,1986-12-31,7371,6010,13381
15,15299,1987-12-31,7496,6005,13501
15,15299,1988-12-31,7630,5997,13627
15,15299,1989-12-31,7762,5976,13738
15,15299,1990-12-31,7920,5937,13857
15,15299,1991-12-31,8052,5857,13909
15,15299,1992-12-31,8209,5838,14047
15,15299,1993-12-31,8368,5814,14182
15,15299,1994-12-31,8530,5794,14324
15,15299,1995-12-31,8708,5776,14484
15,15299,1996-12-31,8899,5750,14649
15,15299,1997-12-31,9064,5735,14799
15,15299,1998-12-31,9258,5711,14969
15,15299,1999-12-31,9422,5696,15118
15,15299,2000-12-31,9594,5669,15263
15,15299,2001-12-31,9736,5631,15367
15,15299,2002-12-31,9893,5584,15477
15,15299,2003-12-31,10088,5582,15670
15,15299,2004-12-31,10276,5550,15826
15,15299,2005-12-31,10424,5519,15943
15,15299,2006-12-31,10591,5486,16077
15,15299,2007-12-31,10788,5474,16262
15,15299,2008-12-31,10973,5474,16447
15,15299,2009-12-31,11130,5456,16586
15,15299,2010-12-31,11303,5453,16756
15,15299,2011-12-31,11459,5447,16906
15,15299,2012-12-31,11593,5446,17039
15,15299,2013-12-31,11725,5464,17189
15,15299,2014-12-31,11846,5434,17280
15,15299,2015-12-31,11939,5462,17401
15,15299,2016-12-31,12071,5433,17504
15,15299,2017-12-31,12199,5508,17707
15,15299,2018-12-31,12358,5574,17932
15,15299,2019-12-31,12619,5525,18144
15,15299,2020-12-31,12859,5463,18322
15,15299,2021-12-31,13021,5434,18455
15,15299,2022-12-31,13168,5404,18572
15,15299,2023-12-31,13312,5375,18687
15,15299,2024-12-31,13473,5356,18829
15,15299,2025-12-31,13638,5341,18979
15,15299,2026-12-31,13776,5342,19118
15,15299,2027-12-31,13930,5348,19278
15,15299,2028-12-31,14058,5356,19414
15,15299,2029-12-31,14199,5381,19580
15,15299,2030-12-31,14309,5420,19729
15,15299,2031-12-31,14412,5470,19882
15,15299,2032-12-31,14520,5510,20030
15,15299,2033-12-31,14618,5533,20151
15,15299,2034-12-31,14716,5576,20292
15,15299,2035-12-31,14803,5621,20424
15,15317,1985-12-31,568,2489,3057
15,15317,1986-12-31,569,2415,2984
15,15317,1987-12-31,562,2386,2948
15,15317,1988-12-31,580,2359,2939
15,15317,1989-12-31,595,2328,2923
15,15317,1990-12-31,615,2306,2921
15,15317,1991-12-31,626,2268,2894
15,15317,1992-12-31,628,2230,2858
15,15317,1993-12-31,624,2169,2793
15,15317,1994-12-31,572,2110,2682
15,15317,1995-12-31,565,2076,2641
15,15317,1996-12-31,563,2065,2628
15,15317,1997-12-31,566,2026,2592
15,15317,1998-12-31,591,1989,2580
15,15317,1999-12-31,599,1958,2557
15,15317,2000-12-31,568,1919,2487
15,15317,2001-12-31,576,1867,2443
15,15317,2002-12-31,577,1825,2402
15,15317,2003-12-31,585,1786,2371
15,15317,2004-12-31,590,1759,2349
15,15317,2005-12-31,563,1674,2237
15,15317,2006-12-31,566,1642,2208
15,15317,2007-12-31,563,1605,2168
15,15317,2008-12-31,568,1582,2150
15,15317,2009-12-31,573,1547,2120
15,15317,2010-12-31,573,1529,2102
15,15317,2011-12-31,561,1508,2069
15,15317,2012-12-31,582,1495,2077
15,15317,2013-12-31,588,1436,2024
15,15317,2014-12-31,600,1413,2013
15,15317,2015-12-31,604,1333,1937
15,15317,2016-12-31,611,1288,1899
15,15317,2017-12-31,616,1241,1857
15,15317,2018-12-31,624,1241,1865
15,15317,2019-12-31,624,1219,1843
15,15317,2020-12-31,628,1206,1834
15,15317,2021-12-31,647,1200,1847
15,15317,2022-12-31,666,1193,1859
15,15317,2023-12-31,683,1187,1870
15,15317,2024-12-31,685,1184,1869
15,15317,2025-12-31,689,1175,1864
15,15317,2026-12-31,703,1168,1871
15,15317,2027-12-31,708,1172,1880
15,15317,2028-12-31,722,1185,1907
15,15317,2029-12-31,728,1192,1920
15,15317,2030-12-31,730,1207,1937
15,15317,2031-12-31,741,1208,1949
15,15317,2032-12-31,749,1213,1962
15,15317,2033-12-31,752,1222,1974
15,15317,2034-12-31,750,1235,1985
15,15317,2035-12-31,757,1242,1999
15,15322,1985-12-31,5683,3974,9657
15,15322,1986-12-31,5714,3938,9652
15,15322,1987-12-31,5760,3924,9684
15,15322,1988-12-31,5806,3899,9705
15,15322,1989-12-31,5845,3873,9718
15,15322,1990-12-31,5897,3833,9730
15,15322,1991-12-31,5942,3787,9729
15,15322,1992-12-31,6034,3749,9783
15,15322,1993-12-31,6070,3716,9786
15,15322,1994-12-31,6157,3687,9844
15,15322,1995-12-31,6240,3650,9890
15,15322,1996-12-31,6295,3626,9921
15,15322,1997-12-31,6378,3600,9978
15,15322,1998-12-31,6457,3550,10007
15,15322,1999-12-31,6515,3522,10037
15,15322,2000-12-31,6562,3477,10039
15,15322,2001-12-31,6626,3438,10064
15,15322,2002-12-31,6710,3409,10119
15,15322,2003-12-31,6808,3362,10170
15,15322,2004-12-31,6878,3325,10203
15,15322,2005-12-31,6926,3296,10222
15,15322,2006-12-31,6998,3262,10260
15,15322,2007-12-31,7076,3205,10281
15,15322,2008-12-31,7156,3204,10360
15,15322,2009-12-31,7205,3167,10372
15,15322,2010-12-31,7279,3116,10395
15,15322,2011-12-31,7352,3096,10448
15,15322,2012-12-31,7379,3091,10470
15,15322,2013-12-31,7372,3114,10486
15,15322,2014-12-31,7417,3119,10536
15,15322,2015-12-31,7476,3061,10537
15,15322,2016-12-31,7558,3041,10599
15,15322,2017-12-31,7524,3050,10574
15,15322,2018-12-31,7631,3068,10699
15,15322,2019-12-31,7691,3118,10809
15,15322,2020-12-31,7767,3137,10904
15,15322,2021-12-31,7860,3121,10981
15,15322,2022-12-31,7947,3104,11051
15,15322,2023-12-31,8032,3087,11119
15,15322,2024-12-31,8122,3073,11195
15,15322,2025-12-31,8210,3063,11273
15,15322,2026-12-31,8296,3057,11353
15,15322,2027-12-31,8370,3067,11437
15,15322,2028-12-31,8449,3074,11523
15,15322,2029-12-31,8524,3101,11625
15,15322,2030-12-31,8586,3096,11682
15,15322,2031-12-31,8653,3130,11783
15,15322,2032-12-31,8715,3159,11874
15,15322,2033-12-31,8775,3182,11957
15,15322,2034-12-31,8832,3201,12033
15,15322,2035-12-31,8887,3234,12121
15,15325,1985-12-31,1056,6277,7333
15,15325,1986-12-31,1066,6164,7230
15,15325,1987-12-31,1043,6036,7079
15,15325,1988-12-31,1031,5920,6951
15,15325,1989-12-31,1034,5817,6851
15,15325,1990-12-31,1045,5700,6745
15,15325,1991-12-31,1049,5513,6562
15,15325,1992-12-31,1048,5367,6415
15,15325,1993-12-31,1053,5233,6286
15,15325,1994-12-31,1076,5100,6176
15,15325,1995-12-31,1093,4985,6078
15,15325,1996-12-31,1092,4853,5945
15,15325,1997-12-31,1105,4709,5814
15,15325,1998-12-31,1107,4595,5702
15,15325,1999-12-31,1089,4475,5564
15,15325,2000-12-31,1093,4359,5452
15,15325,2001-12-31,1126,4214,5340
15,15325,2002-12-31,1131,4101,5232
15,15325,2003-12-31,1103,3960,5063
15,15325,2004-12-31,1088,3841,4929
15,15325,2005-12-31,1092,3710,4802
15,15325,2006-12-31,1133,3580,4713
15,15325,2007-12-31,1152,3447,4599
15,15325,2008-12-31,1134,3327,4461
15,15325,2009-12-31,1119,3267,4386
15,15325,2010-12-31,1106,3141,4247
15,15325,2011-12-31,1094,3013,4107
15,15325,2012-12-31,1091,2910,4001
15,15325,2013-12-31,1083,2803,3886
15,15325,2014-12-31,1080,2685,3765
15,15325,2015-12-31,1091,2601,3692
15,15325,2016-12-31,1104,2535,3639
15,15325,2017-12-31,1109,2396,3505
15,15325,2018-12-31,1117,2283,3400
15,15325,2019-12-31,1125,2262,3387
15,15325,2020-12-31,1138,2253,3391
15,15325,2021-12-31,1174,2241,3415
15,15325,2022-12-31,1208,2229,3437
15,15325,2023-12-31,1241,2217,3458
15,15325,2024-12-31,1262,2212,3474
15,15325,2025-12-31,1280,2203,3483
15,15325,2026-12-31,1287,2203,3490
15,15325,2027-12-31,1302,2196,3498
15,15325,2028-12-31,1320,2198,3518
15,15325,2029-12-31,1328,2211,3539
15,15325,2030-12-31,1333,2223,3556
15,15325,2031-12-31,1352,2245,3597
15,15325,2032-12-31,1365,2263,3628
15,15325,2033-12-31,1369,2276,3645
15,15325,2034-12-31,1377,2298,3675
15,15325,2035-12-31,1385,2301,3686
15,15332,1985-12-31,1299,4903,6202
15,15332,1986-12-31,1277,4842,6119
15,15332,1987-12-31,1278,4784,6062
15,15332,1988-12-31,1270,4720,5990
15,15332,1989-12-31,1275,4661,5936
15,15332,1990-12-31,1281,4598,5879
15,15332,1991-12-31,1288,4519,5807
15,15332,1992-12-31,1291,4460,5751
15,15332,1993-12-31,1295,4399,5694
15,15332,1994-12-31,1300,4328,5628
15,15332,1995-12-31,1318,4281,5599
15,15332,1996-12-31,1349,4208,5557
15,15332,1997-12-31,1356,4149,5505
15,15332,1998-12-31,1354,4093,5447
15,15332,1999-12-31,1363,4027,5390
15,15332,2000-12-31,1360,3948,5308
15,15332,2001-12-31,1359,3880,5239
15,15332,2002-12-31,1362,3812,5174
15,15332,2003-12-31,1371,3733,5104
15,15332,2004-12-31,1368,3662,5030
15,15332,2005-12-31,1370,3590,4960
15,15332,2006-12-31,1355,3524,4879
15,15332,2007-12-31,1359,3456,4815
15,15332,2008-12-31,1363,3375,4738
15,15332,2009-12-31,1370,3353,4723
15,15332,2010-12-31,1370,3309,4679
15,15332,2011-12-31,1377,3228,4605
15,15332,2012-12-31,1373,3197,4570
15,15332,2013-12-31,1359,3141,4500
15,15332,2014-12-31,1341,3084,4425
15,15332,2015-12-31,1297,3029,4326
15,15332,2016-12-31,1322,2991,4313
15,15332,2017-12-31,1340,2957,4297
15,15332,2018-12-31,1353,2926,4279
15,15332,2019-12-31,1348,2937,4285
15,15332,2020-12-31,1351,2950,4301
15,15332,2021-12-31,1396,2935,4331
15,15332,2022-12-31,1440,2919,4359
15,15332,2023-12-31,1483,2903,4386
15,15332,2024-12-31,1499,2886,4385
15,15332,2025-12-31,1518,2889,4407
15,15332,2026-12-31,1530,2880,4410
15,15332,2027-12-31,1553,2895,4448
15,15332,2028-12-31,1562,2902,4464
15,15332,2029-12-31,1584,2912,4496
15,15332,2030-12-31,1594,2937,4531
15,15332,2031-12-31,1597,2968,4565
15,15332,2032-12-31,1620,2975,4595
15,15332,2033-12-31,1627,2994,4621
15,15332,2034-12-31,1632,3018,4650
15,15332,2035-12-31,1648,3039,4687
15,15362,1985-12-31,562,910,1472
15,15362,1986-12-31,549,899,1448
15,15362,1987-12-31,594,905,1499
15,15362,1988-12-31,611,931,1542
15,15362,1989-12-31,632,939,1571
15,15362,1990-12-31,619,936,1555
15,15362,1991-12-31,662,936,1598
15,15362,1992-12-31,667,934,1601
15,15362,1993-12-31,696,905,1601
15,15362,1994-12-31,725,914,1639
15,15362,1995-12-31,733,907,1640
15,15362,1996-12-31,778,868,1646
15,15362,1997-12-31,765,889,1654
15,15362,1998-12-31,789,896,1685
15,15362,1999-12-31,795,878,1673
15,15362,2000-12-31,819,885,1704
15,15362,2001-12-31,824,855,1679
15,15362,2002-12-31,838,854,1692
15,15362,2003-12-31,896,849,1745
15,15362,2004-12-31,898,841,1739
15,15362,2005-12-31,938,847,1785
15,15362,2006-12-31,968,826,1794
15,15362,2007-12-31,966,833,1799
15,15362,2008-12-31,946,843,1789
15,15362,2009-12-31,961,809,1770
15,15362,2010-12-31,982,807,1789
15,15362,2011-12-31,1026,866,1892
15,15362,2012-12-31,1039,849,1888
15,15362,2013-12-31,1070,836,1906
15,15362,2014-12-31,1084,814,1898
15,15362,2015-12-31,1106,804,1910
15,15362,2016-12-31,1123,797,1920
15,15362,2017-12-31,1142,791,1933
15,15362,2018-12-31,1160,787,1947
15,15362,2019-12-31,1185,787,1972
15,15362,2020-12-31,1207,788,1995
15,15362,2021-12-31,1226,784,2010
15,15362,2022-12-31,1242,780,2022
15,15362,2023-12-31,1259,776,2035
15,15362,2024-12-31,1268,769,2037
15,15362,2025-12-31,1286,768,2054
15,15362,2026-12-31,1304,774,2078
15,15362,2027-12-31,1311,775,2086
15,15362,2028-12-31,1333,780,2113
15,15362,2029-12-31,1347,785,2132
15,15362,2030-12-31,1352,780,2132
15,15362,2031-12-31,1352,790,2142
15,15362,2032-12-31,1364,798,2162
15,15362,2033-12-31,1376,803,2179
15,15362,2034-12-31,1389,805,2194
15,15362,2035-12-31,1395,820,2215
15,15367,1985-12-31,791,5995,6786
15,15367,1986-12-31,818,5975,6793
15,15367,1987-12-31,876,5934,6810
15,15367,1988-12-31,880,5933,6813
15,15367,1989-12-31,935,5931,6866
15,15367,1990-12-31,947,5869,6816
15,15367,1991-12-31,966,5827,6793
15,15367,1992-12-31,996,5801,6797
15,15367,1993-12-31,1026,5758,6784
15,15367,1994-12-31,1063,5733,6796
15,15367,1995-12-31,1098,5725,6823
15,15367,1996-12-31,1119,5713,6832
15,15367,1997-12-31,1111,5660,6771
15,15367,1998-12-31,1163,5665,6828
15,15367,1999-12-31,1193,5651,6844
15,15367,2000-12-31,1224,5626,6850
15,15367,2001-12-31,1297,5600,6897
15,15367,2002-12-31,1278,5582,6860
15,15367,2003-12-31,1300,5554,6854
15,15367,2004-12-31,1336,5530,6866
15,15367,2005-12-31,1363,5495,6858
15,15367,2006-12-31,1390,5486,6876
15,15367,2007-12-31,1414,5480,6894
15,15367,2008-12-31,1435,5420,6855
15,15367,2009-12-31,1470,5412,6882
15,15367,2010-12-31,1523,5386,6909
15,15367,2011-12-31,1558,5385,6943
15,15367,2012-12-31,1581,5385,6966
15,15367,2013-12-31,1598,5370,6968
15,15367,2014-12-31,1615,5365,6980
15,15367,2015-12-31,1632,5347,6979
15,15367,2016-12-31,1651,5362,7013
15,15367,2017-12-31,1675,5510,7185
15,15367,2018-12-31,1696,5504,7200
15,15367,2019-12-31,1738,5536,7274
15,15367,2020-12-31,1777,5561,7338
15,15367,2021-12-31,1857,5533,7390
15,15367,2022-12-31,1935,5502,7437
15,15367,2023-12-31,2010,5473,7483
15,15367,2024-12-31,2054,5443,7497
15,15367,2025-12-31,2090,5438,7528
15,15367,2026-12-31,2114,5423,7537
15,15367,2027-12-31,2130,5438,7568
15,15367,2028-12-31,2152,5469,7621
15,15367,2029-12-31,2175,5483,7658
15,15367,2030-12-31,2186,5533,7719
15,15367,2031-12-31,2207,5563,7770
15,15367,2032-12-31,2220,5605,7825
15,15367,2033-12-31,2229,5655,7884
15,15367,2034-12-31,2254,5688,7942
15,15367,2035-12-31,2273,5732,8005
15,15368,1985-12-31,502,5275,5777
15,15368,1986-12-31,527,5234,5761
15,15368,1987-12-31,583,5159,5742
15,15368,1988-12-31,602,5091,5693
15,15368,1989-12-31,630,5027,5657
15,15368,1990-12-31,641,4941,5582
15,15368,1991-12-31,648,4819,5467
15,15368,1992-12-31,660,4753,5413
15,15368,1993-12-31,681,4628,5309
15,15368,1994-12-31,739,4569,5308
15,15368,1995-12-31,693,4467,5160
15,15368,1996-12-31,702,4366,5068
15,15368,1997-12-31,812,4275,5087
15,15368,1998-12-31,746,4176,4922
15,15368,1999-12-31,790,4100,4890
15,15368,2000-12-31,812,4050,4862
15,15368,2001-12-31,820,3941,4761
15,15368,2002-12-31,913,3864,4777
15,15368,2003-12-31,918,3793,4711
15,15368,2004-12-31,928,3721,4649
15,15368,2005-12-31,931,3633,4564
15,15368,2006-12-31,922,3507,4429
15,15368,2007-12-31,978,3460,4438
15,15368,2008-12-31,1018,3364,4382
15,15368,2009-12-31,1011,3274,4285
15,15368,2010-12-31,1035,3184,4219
15,15368,2011-12-31,1058,3112,4170
15,15368,2012-12-31,1077,3038,4115
15,15368,2013-12-31,1054,2997,4051
15,15368,2014-12-31,1083,2969,4052
15,15368,2015-12-31,1120,2935,4055
15,15368,2016-12-31,1152,2906,4058
15,15368,2017-12-31,1178,2767,3945
15,15368,2018-12-31,1201,2728,3929
15,15368,2019-12-31,1226,2674,3900
15,15368,2020-12-31,1250,2639,3889
15,15368,2021-12-31,1292,2625,3917
15,15368,2022-12-31,1330,2611,3941
15,15368,2023-12-31,1369,2597,3966
15,15368,2024-12-31,1395,2586,3981
15,15368,2025-12-31,1409,2579,3988
15,15368,2026-12-31,1433,2578,4011
15,15368,2027-12-31,1445,2584,4029
15,15368,2028-12-31,1451,2593,4044
15,15368,2029-12-31,1466,2610,4076
15,15368,2030-12-31,1481,2623,4104
15,15368,2031-12-31,1495,2637,4132
15,15368,2032-12-31,1507,2667,4174
15,15368,2033-12-31,1511,2681,4192
15,15368,2034-12-31,1522,2719,4241
15,15368,2035-12-31,1532,2734,4266
15,15377,1985-12-31,552,4795,5347
15,15377,1986-12-31,583,4738,5321
15,15377,1987-12-31,596,4668,5264
15,15377,1988-12-31,601,4588,5189
15,15377,1989-12-31,630,4521,5151
15,15377,1990-12-31,644,4436,5080
15,15377,1991-12-31,652,4349,5001
15,15377,1992-12-31,663,4275,4938
15,15377,1993-12-31,676,4191,4867
15,15377,1994-12-31,718,4112,4830
15,15377,1995-12-31,732,4081,4813
15,15377,1996-12-31,774,3982,4756
15,15377,1997-12-31,810,3905,4715
15,15377,1998-12-31,819,3831,4650
15,15377,1999-12-31,849,3738,4587
15,15377,2000-12-31,851,3632,4483
15,15377,2001-12-31,872,3554,4426
15,15377,2002-12-31,892,3475,4367
15,15377,2003-12-31,908,3393,4301
15,15377,2004-12-31,923,3322,4245
15,15377,2005-12-31,938,3228,4166
15,15377,2006-12-31,953,3154,4107
15,15377,2007-12-31,971,3075,4046
15,15377,2008-12-31,990,3004,3994
15,15377,2009-12-31,1007,2967,3974
15,15377,2010-12-31,1019,2849,3868
15,15377,2011-12-31,1039,2779,3818
15,15377,2012-12-31,1044,2745,3789
15,15377,2013-12-31,1060,2702,3762
15,15377,2014-12-31,1068,2642,3710
15,15377,2015-12-31,1080,2625,3705
15,15377,2016-12-31,1094,2531,3625
15,15377,2017-12-31,1113,2429,3542
15,15377,2018-12-31,1128,2398,3526
15,15377,2019-12-31,1154,2347,3501
15,15377,2020-12-31,1178,2315,3493
15,15377,2021-12-31,1215,2303,3518
15,15377,2022-12-31,1250,2290,3540
15,15377,2023-12-31,1284,2278,3562
15,15377,2024-12-31,1304,2259,3563
15,15377,2025-12-31,1318,2260,3578
15,15377,2026-12-31,1338,2268,3606
15,15377,2027-12-31,1356,2266,3622
15,15377,2028-12-31,1370,2267,3637
15,15377,2029-12-31,1382,2280,3662
15,15377,2030-12-31,1397,2300,3697
15,15377,2031-12-31,1398,2318,3716
15,15377,2032-12-31,1413,2328,3741
15,15377,2033-12-31,1426,2342,3768
15,15377,2034-12-31,1436,2354,3790
15,15377,2035-12-31,1445,2377,3822
15,15380,1985-12-31,725,2828,3553
15,15380,1986-12-31,782,2771,3553
15,15380,1987-12-31,799,2755,3554
15,15380,1988-12-31,815,2727,3542
15,15380,1989-12-31,825,2678,3503
15,15380,1990-12-31,787,2641,3428
15,15380,1991-12-31,823,2612,3435
15,15380,1992-12-31,814,2575,3389
15,15380,1993-12-31,801,2543,3344
15,15380,1994-12-31,859,2521,3380
15,15380,1995-12-31,876,2482,3358
15,15380,1996-12-31,881,2441,3322
15,15380,1997-12-31,847,2400,3247
15,15380,1998-12-31,875,2322,3197
15,15380,1999-12-31,852,2338,3190
15,15380,2000-12-31,881,2304,3185
15,15380,2001-12-31,884,2219,3103
15,15380,2002-12-31,892,2177,3069
15,15380,2003-12-31,900,2123,3023
15,15380,2004-12-31,921,2079,3000
15,15380,2005-12-31,948,2067,3015
15,15380,2006-12-31,946,2022,2968
15,15380,2007-12-31,941,1982,2923
15,15380,2008-12-31,936,1944,2880
15,15380,2009-12-31,937,1930,2867
15,15380,2010-12-31,946,1913,2859
15,15380,2011-12-31,950,1901,2851
15,15380,2012-12-31,963,1891,2854
15,15380,2013-12-31,968,1862,2830
15,15380,2014-12-31,972,1831,2803
15,15380,2015-12-31,979,1762,2741
15,15380,2016-12-31,986,1688,2674
15,15380,2017-12-31,996,1670,2666
15,15380,2018-12-31,1012,1677,2689
15,15380,2019-12-31,1026,1660,2686
15,15380,2020-12-31,1041,1650,2691
15,15380,2021-12-31,1069,1641,2710
15,15380,2022-12-31,1095,1632,2727
15,15380,2023-12-31,1120,1624,2744
15,15380,2024-12-31,1148,1623,2771
15,15380,2025-12-31,1161,1617,2778
15,15380,2026-12-31,1170,1621,2791
15,15380,2027-12-31,1179,1615,2794
15,15380,2028-12-31,1193,1613,2806
15,15380,2029-12-31,1198,1624,2822
15,15380,2030-12-31,1213,1634,2847
15,15380,2031-12-31,1222,1648,2870
15,15380,2032-12-31,1229,1659,2888
15,15380,2033-12-31,1235,1673,2908
15,15380,2034-12-31,1247,1690,2937
15,15380,2035-12-31,1257,1691,2948
15,15401,1985-12-31,280,2098,2378
15,15401,1986-12-31,259,2105,2364
15,15401,1987-12-31,257,2058,2315
15,15401,1988-12-31,259,2004,2263
15,15401,1989-12-31,258,1982,2240
15,15401,1990-12-31,267,1928,2195
15,15401,1991-12-31,267,1883,2150
15,15401,1992-12-31,272,1847,2119
15,15401,1993-12-31,266,1825,2091
15,15401,1994-12-31,328,1754,2082
15,15401,1995-12-31,344,1742,2086
15,15401,1996-12-31,345,1670,2015
15,15401,1997-12-31,342,1629,1971
15,15401,1998-12-31,314,1589,1903
15,15401,1999-12-31,320,1530,1850
15,15401,2000-12-31,338,1526,1864
15,15401,2001-12-31,359,1409,1768
15,15401,2002-12-31,378,1396,1774
15,15401,2003-12-31,387,1372,1759
15,15401,2004-12-31,393,1328,1721
15,15401,2005-12-31,392,1277,1669
15,15401,2006-12-31,370,1237,1607
15,15401,2007-12-31,355,1196,1551
15,15401,2008-12-31,362,1159,1521
15,15401,2009-12-31,357,1084,1441
15,15401,2010-12-31,396,1039,1435
15,15401,2011-12-31,365,1013,1378
15,15401,2012-12-31,401,964,1365
15,15401,2013-12-31,419,908,1327
15,15401,2014-12-31,407,888,1295
15,15401,2015-12-31,402,858,1260
15,15401,2016-12-31,400,778,1178
15,15401,2017-12-31,389,713,1102
15,15401,2018-12-31,400,718,1118
15,15401,2019-12-31,408,710,1118
15,15401,2020-12-31,416,701,1117
15,15401,2021-12-31,428,697,1125
15,15401,2022-12-31,439,693,1132
15,15401,2023-12-31,449,690,1139
15,15401,2024-12-31,465,677,1142
15,15401,2025-12-31,476,677,1153
15,15401,2026-12-31,472,676,1148
15,15401,2027-12-31,473,680,1153
15,15401,2028-12-31,467,683,1150
15,15401,2029-12-31,468,685,1153
15,15401,2030-12-31,477,691,1168
15,15401,2031-12-31,479,698,1177
15,15401,2032-12-31,489,701,1190
15,15401,2033-12-31,492,702,1194
15,15401,2034-12-31,496,710,1206
15,15401,2035-12-31,499,726,1225
15,15403,1985-12-31,1688,9508,11196
15,15403,1986-12-31,1680,9278,10958
15,15403,1987-12-31,1671,9044,10715
15,15403,1988-12-31,1642,8793,10435
15,15403,1989-12-31,1625,8531,10156
15,15403,1990-12-31,1593,8248,9841
15,15403,1991-12-31,1571,7982,9553
15,15403,1992-12-31,1562,7737,9299
15,15403,1993-12-31,1548,7497,9045
15,15403,1994-12-31,1541,7249,8790
15,15403,1995-12-31,1558,7001,8559
15,15403,1996-12-31,1580,6765,8345
15,15403,1997-12-31,1591,6494,8085
15,15403,1998-12-31,1571,6259,7830
15,15403,1999-12-31,1567,6015,7582
15,15403,2000-12-31,1568,5804,7372
15,15403,2001-12-31,1524,5546,7070
15,15403,2002-12-31,1517,5307,6824
15,15403,2003-12-31,1501,5077,6578
15,15403,2004-12-31,1499,4829,6328
15,15403,2005-12-31,1490,4591,6081
15,15403,2006-12-31,1464,4383,5847
15,15403,2007-12-31,1459,4097,5556
15,15403,2008-12-31,1430,3915,5345
15,15403,2009-12-31,1409,3679,5088
15,15403,2010-12-31,1384,3440,4824
15,15403,2011-12-31,1380,3207,4587
15,15403,2012-12-31,1363,2979,4342
15,15403,2013-12-31,1356,2788,4144
15,15403,2014-12-31,1366,2596,3962
15,15403,2015-12-31,1293,2418,3711
15,15403,2016-12-31,1255,2190,3445
15,15403,2017-12-31,1267,1947,3214
15,15403,2018-12-31,1277,1722,2999
15,15403,2019-12-31,1249,1582,2831
15,15403,2020-12-31,1235,1495,2730
15,15403,2021-12-31,1262,1487,2749
15,15403,2022-12-31,1288,1479,2767
15,15403,2023-12-31,1313,1471,2784
15,15403,2024-12-31,1337,1466,2803
15,15403,2025-12-31,1350,1461,2811
15,15403,2026-12-31,1363,1456,2819
15,15403,2027-12-31,1380,1462,2842
15,15403,2028-12-31,1387,1470,2857
15,15403,2029-12-31,1407,1474,2881
15,15403,2030-12-31,1419,1480,2899
15,15403,2031-12-31,1428,1496,2924
15,15403,2032-12-31,1442,1506,2948
15,15403,2033-12-31,1456,1511,2967
15,15403,2034-12-31,1451,1530,2981
15,15403,2035-12-31,1466,1548,3014
15,15407,1985-12-31,2271,3181,5452
15,15407,1986-12-31,2415,3327,5742
15,15407,1987-12-31,2581,3488,6069
15,15407,1988-12-31,2729,3641,6370
15,15407,1989-12-31,2900,3802,6702
15,15407,1990-12-31,3058,3947,7005
15,15407,1991-12-31,3236,4076,7312
15,15407,1992-12-31,3393,4255,7648
15,15407,1993-12-31,3572,4382,7954
15,15407,1994-12-31,3729,4524,8253
15,15407,1995-12-31,3899,4661,8560
15,15407,1996-12-31,4079,4802,8881
15,15407,1997-12-31,4247,4933,9180
15,15407,1998-12-31,4418,5054,9472
15,15407,1999-12-31,4580,5204,9784
15,15407,2000-12-31,4747,5351,10098
15,15407,2001-12-31,4957,5503,10460
15,15407,2002-12-31,5153,5642,10795
15,15407,2003-12-31,5362,5777,11139
15,15407,2004-12-31,5547,5908,11455
15,15407,2005-12-31,5717,6037,11754
15,15407,2006-12-31,5891,6175,12066
15,15407,2007-12-31,6063,6327,12390
15,15407,2008-12-31,6260,6493,12753
15,15407,2009-12-31,6433,6641,13074
15,15407,2010-12-31,6621,6793,13414
15,15407,2011-12-31,6750,6945,13695
15,15407,2012-12-31,6955,7117,14072
15,15407,2013-12-31,7129,7304,14433
15,15407,2014-12-31,7281,7469,14750
15,15407,2015-12-31,7445,7605,15050
15,15407,2016-12-31,7594,7792,15386
15,15407,2017-12-31,7743,8026,15769
15,15407,2018-12-31,7897,8242,16139
15,15407,2019-12-31,8150,8467,16617
15,15407,2020-12-31,8365,8608,16973
15,15407,2021-12-31,8532,8564,17096
15,15407,2022-12-31,8688,8517,17205
15,15407,2023-12-31,8839,8472,17311
15,15407,2024-12-31,8979,8437,17416
15,15407,2025-12-31,9103,8418,17521
15,15407,2026-12-31,9224,8425,17649
15,15407,2027-12-31,9321,8423,17744
15,15407,2028-12-31,9425,8437,17862
15,15407,2029-12-31,9519,8494,18013
15,15407,2030-12-31,9612,8546,18158
15,15407,2031-12-31,9680,8627,18307
15,15407,2032-12-31,9757,8679,18436
15,15407,2033-12-31,9825,8752,18577
15,15407,2034-12-31,9892,8816,18708
15,15407,2035-12-31,9949,8879,18828
15,15425,1985-12-31,514,4532,5046
15,15425,1986-12-31,531,4526,5057
15,15425,1987-12-31,578,4517,5095
15,15425,1988-12-31,614,4484,5098
15,15425,1989-12-31,623,4456,5079
15,15425,1990-12-31,659,4423,5082
15,15425,1991-12-31,650,4364,5014
15,15425,1992-12-31,679,4336,5015
15,15425,1993-12-31,683,4295,4978
15,15425,1994-12-31,708,4291,4999
15,15425,1995-12-31,678,4229,4907
15,15425,1996-12-31,712,4224,4936
15,15425,1997-12-31,732,4204,4936
15,15425,1998-12-31,733,4162,4895
15,15425,1999-12-31,755,4130,4885
15,15425,2000-12-31,791,4113,4904
15,15425,2001-12-31,808,4088,4896
15,15425,2002-12-31,833,4066,4899
15,15425,2003-12-31,847,4045,4892
15,15425,2004-12-31,878,4010,4888
15,15425,2005-12-31,911,3955,4866
15,15425,2006-12-31,938,3955,4893
15,15425,2007-12-31,950,3910,4860
15,15425,2008-12-31,970,3911,4881
15,15425,2009-12-31,984,3852,4836
15,15425,2010-12-31,1004,3838,4842
15,15425,2011-12-31,1025,3818,4843
15,15425,2012-12-31,1028,3818,4846
15,15425,2013-12-31,1038,3809,4847
15,15425,2014-12-31,1064,3800,4864
15,15425,2015-12-31,1086,3745,4831
15,15425,2016-12-31,1110,3778,4888
15,15425,2017-12-31,1123,3835,4958
15,15425,2018-12-31,1134,3842,4976
15,15425,2019-12-31,1161,3866,5027
15,15425,2020-12-31,1186,3886,5072
15,15425,2021-12-31,1242,3866,5108
15,15425,2022-12-31,1295,3845,5140
15,15425,2023-12-31,1348,3824,5172
15,15425,2024-12-31,1381,3798,5179
15,15425,2025-12-31,1401,3801,5202
15,15425,2026-12-31,1420,3797,5217
15,15425,2027-12-31,1433,3805,5238
15,15425,2028-12-31,1442,3810,5252
15,15425,2029-12-31,1459,3824,5283
15,15425,2030-12-31,1471,3857,5328
15,15425,2031-12-31,1478,3883,5361
15,15425,2032-12-31,1492,3923,5415
15,15425,2033-12-31,1503,3944,5447
15,15425,2034-12-31,1512,3970,5482
15,15425,2035-12-31,1517,3999,5516
15,15442,1985-12-31,457,8206,8663
15,15442,1986-12-31,492,8120,8612
15,15442,1987-12-31,497,8022,8519
15,15442,1988-12-31,527,7921,8448
15,15442,1989-12-31,550,7831,8381
15,15442,1990-12-31,559,7691,8250
15,15442,1991-12-31,555,7578,8133
15,15442,1992-12-31,547,7450,7997
15,15442,1993-12-31,565,7309,7874
15,15442,1994-12-31,572,7237,7809
15,15442,1995-12-31,582,7138,7720
15,15442,1996-12-31,582,7031,7613
15,15442,1997-12-31,599,6919,7518
15,15442,1998-12-31,610,6796,7406
15,15442,1999-12-31,621,6678,7299
15,15442,2000-12-31,636,6584,7220
15,15442,2001-12-31,642,6478,7120
15,15442,2002-12-31,656,6358,7014
15,15442,2003-12-31,658,6252,6910
15,15442,2004-12-31,661,6155,6816
15,15442,2005-12-31,651,6042,6693
15,15442,2006-12-31,676,5945,6621
15,15442,2007-12-31,681,5810,6491
15,15442,2008-12-31,691,5746,6437
15,15442,2009-12-31,688,5642,6330
15,15442,2010-12-31,685,5562,6247
15,15442,2011-12-31,725,5477,6202
15,15442,2012-12-31,745,5387,6132
15,15442,2013-12-31,748,5291,6039
15,15442,2014-12-31,749,5207,5956
15,15442,2015-12-31,749,5101,5850
15,15442,2016-12-31,746,5059,5805
15,15442,2017-12-31,751,5062,5813
15,15442,2018-12-31,762,4979,5741
15,15442,2019-12-31,776,4921,5697
15,15442,2020-12-31,790,4893,5683
15,15442,2021-12-31,856,4867,5723
15,15442,2022-12-31,918,4841,5759
15,15442,2023-12-31,981,4814,5795
15,15442,2024-12-31,1005,4798,5803
15,15442,2025-12-31,1020,4789,5809
15,15442,2026-12-31,1030,4783,5813
15,15442,2027-12-31,1037,4782,5819
15,15442,2028-12-31,1057,4807,5864
15,15442,2029-12-31,1068,4819,5887
15,15442,2030-12-31,1078,4847,5925
15,15442,2031-12-31,1083,4888,5971
15,15442,2032-12-31,1089,4925,6014
15,15442,2033-12-31,1097,4972,6069
15,15442,2034-12-31,1109,4997,6106
15,15442,2035-12-31,1109,5030,6139
15,15455,1985-12-31,3431,5857,9288
15,15455,1986-12-31,3478,5755,9233
15,15455,1987-12-31,3518,5720,9238
15,15455,1988-12-31,3569,5657,9226
15,15455,1989-12-31,3572,5550,9122
15,15455,1990-12-31,3686,5496,9182
15,15455,1991-12-31,3711,5385,9096
15,15455,1992-12-31,3771,5291,9062
15,15455,1993-12-31,3823,5210,9033
15,15455,1994-12-31,3888,5142,9030
15,15455,1995-12-31,3940,5051,8991
15,15455,1996-12-31,3994,4984,8978
15,15455,1997-12-31,4060,4902,8962
15,15455,1998-12-31,4122,4845,8967
15,15455,1999-12-31,4176,4786,8962
15,15455,2000-12-31,4233,4715,8948
15,15455,2001-12-31,4333,4634,8967
15,15455,2002-12-31,4415,4547,8962
15,15455,2003-12-31,4487,4477,8964
15,15455,2004-12-31,4563,4373,8936
15,15455,2005-12-31,4609,4323,8932
15,15455,2006-12-31,4668,4203,8871
15,15455,2007-12-31,4700,4176,8876
15,15455,2008-12-31,4750,4094,8844
15,15455,2009-12-31,4804,4009,8813
15,15455,2010-12-31,4867,3938,8805
15,15455,2011-12-31,4926,3868,8794
15,15455,2012-12-31,4987,3805,8792
15,15455,2013-12-31,5018,3757,8775
15,15455,2014-12-31,5033,3712,8745
15,15455,2015-12-31,5066,3693,8759
15,15455,2016-12-31,5134,3682,8816
15,15455,2017-12-31,5198,3593,8791
15,15455,2018-12-31,5270,3577,8847
15,15455,2019-12-31,5386,3551,8937
15,15455,2020-12-31,5492,3523,9015
15,15455,2021-12-31,5575,3504,9079
15,15455,2022-12-31,5651,3485,9136
15,15455,2023-12-31,5727,3466,9193
15,15455,2024-12-31,5806,3455,9261
15,15455,2025-12-31,5869,3432,9301
15,15455,2026-12-31,5945,3438,9383
15,15455,2027-12-31,6005,3439,9444
15,15455,2028-12-31,6074,3458,9532
15,15455,2029-12-31,6126,3473,9599
15,15455,2030-12-31,6172,3491,9663
15,15455,2031-12-31,6214,3517,9731
15,15455,2032-12-31,6260,3538,9798
15,15455,2033-12-31,6296,3565,9861
15,15455,2034-12-31,6339,3588,9927
15,15455,2035-12-31,6382,3622,10004
15,15464,1985-12-31,1774,4166,5940
15,15464,1986-12-31,1785,4168,5953
15,15464,1987-12-31,1774,4112,5886
15,15464,1988-12-31,1779,4060,5839
15,15464,1989-12-31,1778,4014,5792
15,15464,1990-12-31,1782,3971,5753
15,15464,1991-12-31,1782,3898,5680
15,15464,1992-12-31,1755,3852,5607
15,15464,1993-12-31,1789,3808,5597
15,15464,1994-12-31,1776,3751,5527
15,15464,1995-12-31,1822,3713,5535
15,15464,1996-12-31,1835,3666,5501
15,15464,1997-12-31,1859,3627,5486
15,15464,1998-12-31,1889,3551,5440
15,15464,1999-12-31,1925,3484,5409
15,15464,2000-12-31,1925,3399,5324
15,15464,2001-12-31,1941,3343,5284
15,15464,2002-12-31,1935,3271,5206
15,15464,2003-12-31,1948,3220,5168
15,15464,2004-12-31,1942,3177,5119
15,15464,2005-12-31,1955,3097,5052
15,15464,2006-12-31,1957,3071,5028
15,15464,2007-12-31,1944,3033,4977
15,15464,2008-12-31,1965,2982,4947
15,15464,2009-12-31,1968,2941,4909
15,15464,2010-12-31,1956,2894,4850
15,15464,2011-12-31,1966,2862,4828
15,15464,2012-12-31,1953,2824,4777
15,15464,2013-12-31,1972,2795,4767
15,15464,2014-12-31,1982,2782,4764
15,15464,2015-12-31,1980,2772,4752
15,15464,2016-12-31,1971,2707,4678
15,15464,2017-12-31,1962,2649,4611
15,15464,2018-12-31,1992,2644,4636
15,15464,2019-12-31,1989,2631,4620
15,15464,2020-12-31,1996,2623,4619
15,15464,2021-12-31,2044,2608,4652
15,15464,2022-12-31,2088,2593,4681
15,15464,2023-12-31,2131,2579,4710
15,15464,2024-12-31,2151,2570,4721
15,15464,2025-12-31,2178,2564,4742
15,15464,2026-12-31,2206,2564,4770
15,15464,2027-12-31,2230,2563,4793
15,15464,2028-12-31,2252,2580,4832
15,15464,2029-12-31,2263,2582,4845
15,15464,2030-12-31,2285,2609,4894
15,15464,2031-12-31,2302,2622,4924
15,15464,2032-12-31,2322,2644,4966
15,15464,2033-12-31,2341,2659,5000
15,15464,2034-12-31,2358,2691,5049
15,15464,2035-12-31,2371,2698,5069
15,15466,1985-12-31,3053,2668,5721
15,15466,1986-12-31,3016,2657,5673
15,15466,1987-12-31,3005,2606,5611
15,15466,1988-12-31,2962,2609,5571
15,15466,1989-12-31,2923,2592,5515
15,15466,1990-12-31,2892,2558,5450
15,15466,1991-12-31,2871,2544,5415
15,15466,1992-12-31,2852,2515,5367
15,15466,1993-12-31,2831,2466,5297
15,15466,1994-12-31,2817,2463,5280
15,15466,1995-12-31,2804,2423,5227
15,15466,1996-12-31,2788,2425,5213
15,15466,1997-12-31,2750,2389,5139
15,15466,1998-12-31,2762,2372,5134
15,15466,1999-12-31,2759,2345,5104
15,15466,2000-12-31,2790,2303,5093
15,15466,2001-12-31,2786,2257,5043
15,15466,2002-12-31,2752,2246,4998
15,15466,2003-12-31,2716,2221,4937
15,15466,2004-12-31,2701,2199,4900
15,15466,2005-12-31,2680,2164,4844
15,15466,2006-12-31,2654,2115,4769
15,15466,2007-12-31,2615,2106,4721
15,15466,2008-12-31,2589,2077,4666
15,15466,2009-12-31,2567,2047,4614
15,15466,2010-12-31,2544,2031,4575
15,15466,2011-12-31,2523,2015,4538
15,15466,2012-12-31,2490,1988,4478
15,15466,2013-12-31,2456,1980,4436
15,15466,2014-12-31,2432,1954,4386
15,15466,2015-12-31,2403,1935,4338
15,15466,2016-12-31,2381,1921,4302
15,15466,2017-12-31,2310,1913,4223
15,15466,2018-12-31,2327,1907,4234
15,15466,2019-12-31,2302,1964,4266
15,15466,2020-12-31,2292,2000,4292
15,15466,2021-12-31,2332,1990,4322
15,15466,2022-12-31,2371,1979,4350
15,15466,2023-12-31,2409,1968,4377
15,15466,2024-12-31,2445,1953,4398
15,15466,2025-12-31,2476,1951,4427
15,15466,2026-12-31,2505,1947,4452
15,15466,2027-12-31,2531,1954,4485
15,15466,2028-12-31,2551,1956,4507
15,15466,2029-12-31,2570,1975,4545
15,15466,2030-12-31,2587,1987,4574
15,15466,2031-12-31,2605,1986,4591
15,15466,2032-12-31,2629,2014,4643
15,15466,2033-12-31,2657,2024,4681
15,15466,2034-12-31,2671,2040,4711
15,15466,2035-12-31,2684,2064,4748
15,15469,1985-12-31,7080,13126,20206
15,15469,1986-12-31,7205,12988,20193
15,15469,1987-12-31,7319,12913,20232
15,15469,1988-12-31,7442,12817,20259
15,15469,1989-12-31,7552,12698,20250
15,15469,1990-12-31,7685,12624,20309
15,15469,1991-12-31,7786,12519,20305
15,15469,1992-12-31,7933,12439,20372
15,15469,1993-12-31,8064,12347,20411
15,15469,1994-12-31,8215,12267,20482
15,15469,1995-12-31,8376,12205,20581
15,15469,1996-12-31,8545,12125,20670
15,15469,1997-12-31,8686,12063,20749
15,15469,1998-12-31,8837,11983,20820
15,15469,1999-12-31,8985,11891,20876
15,15469,2000-12-31,9134,11815,20949
15,15469,2001-12-31,9271,11741,21012
15,15469,2002-12-31,9399,11670,21069
15,15469,2003-12-31,9565,11560,21125
15,15469,2004-12-31,9744,11469,21213
15,15469,2005-12-31,9862,11380,21242
15,15469,2006-12-31,10016,11311,21327
15,15469,2007-12-31,10189,11251,21440
15,15469,2008-12-31,10346,11167,21513
15,15469,2009-12-31,10497,11127,21624
15,15469,2010-12-31,10642,11112,21754
15,15469,2011-12-31,10771,11040,21811
15,15469,2012-12-31,10892,10995,21887
15,15469,2013-12-31,10996,10987,21983
15,15469,2014-12-31,11035,10947,21982
15,15469,2015-12-31,11167,10941,22108
15,15469,2016-12-31,11299,11003,22302
15,15469,2017-12-31,11368,10897,22265
15,15469,2018-12-31,11539,11033,22572
15,15469,2019-12-31,11784,11037,22821
15,15469,2020-12-31,12008,11028,23036
15,15469,2021-12-31,12228,10972,23200
15,15469,2022-12-31,12434,10912,23346
15,15469,2023-12-31,12637,10853,23490
15,15469,2024-12-31,12822,10816,23638
15,15469,2025-12-31,12975,10793,23768
15,15469,2026-12-31,13126,10783,23909
15,15469,2027-12-31,13264,10799,24063
15,15469,2028-12-31,13390,10823,24213
15,15469,2029-12-31,13515,10882,24397
15,15469,2030-12-31,13625,10954,24579
15,15469,2031-12-31,13730,11051,24781
15,15469,2032-12-31,13828,11122,24950
15,15469,2033-12-31,13917,11202,25119
15,15469,2034-12-31,14007,11295,25302
15,15469,2035-12-31,14106,11368,25474
15,15476,1985-12-31,113,4556,4669
15,15476,1986-12-31,173,4571,4744
15,15476,1987-12-31,160,4584,4744
15,15476,1988-12-31,159,4604,4763
15,15476,1989-12-31,162,4597,4759
15,15476,1990-12-31,162,4604,4766
15,15476,1991-12-31,319,4592,4911
15,15476,1992-12-31,319,4589,4908
15,15476,1993-12-31,325,4620,4945
15,15476,1994-12-31,265,4602,4867
15,15476,1995-12-31,282,4607,4889
15,15476,1996-12-31,374,4615,4989
15,15476,1997-12-31,349,4654,5003
15,15476,1998-12-31,342,4632,4974
15,15476,1999-12-31,387,4600,4987
15,15476,2000-12-31,437,4588,5025
15,15476,2001-12-31,447,4586,5033
15,15476,2002-12-31,483,4571,5054
15,15476,2003-12-31,479,4561,5040
15,15476,2004-12-31,520,4562,5082
15,15476,2005-12-31,535,4571,5106
15,15476,2006-12-31,557,4580,5137
15,15476,2007-12-31,570,4568,5138
15,15476,2008-12-31,579,4581,5160
15,15476,2009-12-31,593,4614,5207
15,15476,2010-12-31,616,4613,5229
15,15476,2011-12-31,639,4624,5263
15,15476,2012-12-31,656,4644,5300
15,15476,2013-12-31,686,4654,5340
15,15476,2014-12-31,705,4663,5368
15,15476,2015-12-31,720,4704,5424
15,15476,2016-12-31,727,4747,5474
15,15476,2017-12-31,732,4828,5560
15,15476,2018-12-31,742,4827,5569
15,15476,2019-12-31,778,4863,5641
15,15476,2020-12-31,806,4897,5703
15,15476,2021-12-31,872,4872,5744
15,15476,2022-12-31,936,4845,5781
15,15476,2023-12-31,998,4819,5817
15,15476,2024-12-31,1030,4797,5827
15,15476,2025-12-31,1059,4790,5849
15,15476,2026-12-31,1081,4781,5862
15,15476,2027-12-31,1090,4799,5889
15,15476,2028-12-31,1104,4803,5907
15,15476,2029-12-31,1111,4837,5948
15,15476,2030-12-31,1119,4859,5978
15,15476,2031-12-31,1133,4900,6033
15,15476,2032-12-31,1138,4947,6085
15,15476,2033-12-31,1148,4993,6141
15,15476,2034-12-31,1145,5013,6158
15,15476,2035-12-31,1156,5057,6213
15,15480,1985-12-31,3942,8821,12763
15,15480,1986-12-31,3975,8667,12642
15,15480,1987-12-31,4022,8480,12502
15,15480,1988-12-31,4059,8306,12365
15,15480,1989-12-31,4091,8140,12231
15,15480,1990-12-31,4150,7946,12096
15,15480,1991-12-31,4162,7751,11913
15,15480,1992-12-31,4219,7572,11791
15,15480,1993-12-31,4264,7401,11665
15,15480,1994-12-31,4308,7202,11510
15,15480,1995-12-31,4377,7009,11386
15,15480,1996-12-31,4429,6828,11257
15,15480,1997-12-31,4490,6641,11131
15,15480,1998-12-31,4531,6477,11008
15,15480,1999-12-31,4580,6278,10858
15,15480,2000-12-31,4617,6105,10722
15,15480,2001-12-31,4686,5922,10608
15,15480,2002-12-31,4787,5757,10544
15,15480,2003-12-31,4840,5583,10423
15,15480,2004-12-31,4881,5410,10291
15,15480,2005-12-31,4923,5232,10155
15,15480,2006-12-31,4946,5046,9992
15,15480,2007-12-31,5005,4885,9890
15,15480,2008-12-31,5015,4716,9731
15,15480,2009-12-31,5026,4569,9595
15,15480,2010-12-31,5063,4401,9464
15,15480,2011-12-31,5130,4256,9386
15,15480,2012-12-31,5166,4072,9238
15,15480,2013-12-31,5183,3904,9087
15,15480,2014-12-31,5227,3754,8981
15,15480,2015-12-31,5241,3628,8869
15,15480,2016-12-31,5277,3489,8766
15,15480,2017-12-31,5334,3366,8700
15,15480,2018-12-31,5392,3205,8597
15,15480,2019-12-31,5474,2992,8466
15,15480,2020-12-31,5559,2835,8394
15,15480,2021-12-31,5633,2820,8453
15,15480,2022-12-31,5702,2805,8507
15,15480,2023-12-31,5769,2790,8559
15,15480,2024-12-31,5829,2780,8609
15,15480,2025-12-31,5894,2769,8663
15,15480,2026-12-31,5943,2768,8711
15,15480,2027-12-31,5986,2776,8762
15,15480,2028-12-31,6034,2774,8808
15,15480,2029-12-31,6079,2792,8871
15,15480,2030-12-31,6113,2820,8933
15,15480,2031-12-31,6148,2837,8985
15,15480,2032-12-31,6181,2847,9028
15,15480,2033-12-31,6216,2887,9103
15,15480,2034-12-31,6253,2896,9149
15,15480,2035-12-31,6282,2929,9211
15,15491,1985-12-31,2604,8225,10829
15,15491,1986-12-31,2667,8318,10985
15,15491,1987-12-31,2722,8407,11129
15,15491,1988-12-31,2794,8477,11271
15,15491,1989-12-31,2860,8560,11420
15,15491,1990-12-31,2934,8599,11533
15,15491,1991-12-31,2995,8639,11634
15,15491,1992-12-31,3072,8723,11795
15,15491,1993-12-31,3136,8775,11911
15,15491,1994-12-31,3207,8830,12037
15,15491,1995-12-31,3301,8905,12206
15,15491,1996-12-31,3356,8962,12318
15,15491,1997-12-31,3445,9042,12487
15,15491,1998-12-31,3533,9078,12611
15,15491,1999-12-31,3609,9187,12796
15,15491,2000-12-31,3696,9237,12933
15,15491,2001-12-31,3816,9289,13105
15,15491,2002-12-31,3927,9404,13331
15,15491,2003-12-31,3985,9443,13428
15,15491,2004-12-31,4069,9504,13573
15,15491,2005-12-31,4139,9558,13697
15,15491,2006-12-31,4215,9601,13816
15,15491,2007-12-31,4268,9748,14016
15,15491,2008-12-31,4337,9767,14104
15,15491,2009-12-31,4409,9859,14268
15,15491,2010-12-31,4496,9937,14433
15,15491,2011-12-31,4539,10037,14576
15,15491,2012-12-31,4636,10140,14776
15,15491,2013-12-31,4686,10240,14926
15,15491,2014-12-31,4730,10321,15051
15,15491,2015-12-31,4856,10478,15334
15,15491,2016-12-31,4918,10615,15533
15,15491,2017-12-31,4975,10793,15768
15,15491,2018-12-31,5026,10950,15976
15,15491,2019-12-31,5156,11082,16238
15,15491,2020-12-31,5277,11169,16446
15,15491,2021-12-31,5454,11112,16566
15,15491,2022-12-31,5620,11051,16671
15,15491,2023-12-31,5781,10992,16773
15,15491,2024-12-31,5895,10940,16835
15,15491,2025-12-31,5982,10926,16908
15,15491,2026-12-31,6056,10915,16971
15,15491,2027-12-31,6130,10941,17071
15,15491,2028-12-31,6188,10972,17160
15,15491,2029-12-31,6228,11028,17256
15,15491,2030-12-31,6291,11093,17384
15,15491,2031-12-31,6348,11185,17533
15,15491,2032-12-31,6386,11279,17665
15,15491,2033-12-31,6437,11367,17804
15,15491,2034-12-31,6464,11453,17917
15,15491,2035-12-31,6510,11539,18049
15,15494,1985-12-31,452,5104,5556
15,15494,1986-12-31,488,5094,5582
15,15494,1987-12-31,516,5062,5578
15,15494,1988-12-31,523,5032,5555
15,15494,1989-12-31,513,5000,5513
15,15494,1990-12-31,535,4994,5529
15,15494,1991-12-31,545,4915,5460
15,15494,1992-12-31,563,4884,5447
15,15494,1993-12-31,586,4837,5423
15,15494,1994-12-31,626,4799,5425
15,15494,1995-12-31,639,4763,5402
15,15494,1996-12-31,652,4707,5359
15,15494,1997-12-31,679,4686,5365
15,15494,1998-12-31,719,4650,5369
15,15494,1999-12-31,724,4602,5326
15,15494,2000-12-31,704,4557,5261
15,15494,2001-12-31,714,4516,5230
15,15494,2002-12-31,742,4467,5209
15,15494,2003-12-31,759,4442,5201
15,15494,2004-12-31,786,4410,5196
15,15494,2005-12-31,800,4361,5161
15,15494,2006-12-31,826,4332,5158
15,15494,2007-12-31,831,4296,5127
15,15494,2008-12-31,833,4264,5097
15,15494,2009-12-31,862,4278,5140
15,15494,2010-12-31,870,4225,5095
15,15494,2011-12-31,911,4173,5084
15,15494,2012-12-31,941,4124,5065
15,15494,2013-12-31,952,4094,5046
15,15494,2014-12-31,957,4060,5017
15,15494,2015-12-31,968,4039,5007
15,15494,2016-12-31,975,4078,5053
15,15494,2017-12-31,983,4138,5121
15,15494,2018-12-31,993,4128,5121
15,15494,2019-12-31,1018,4154,5172
15,15494,2020-12-31,1041,4176,5217
15,15494,2021-12-31,1099,4155,5254
15,15494,2022-12-31,1155,4132,5287
15,15494,2023-12-31,1210,4110,5320
15,15494,2024-12-31,1241,4088,5329
15,15494,2025-12-31,1259,4080,5339
15,15494,2026-12-31,1272,4085,5357
15,15494,2027-12-31,1287,4074,5361
15,15494,2028-12-31,1305,4096,5401
15,15494,2029-12-31,1318,4113,5431
15,15494,2030-12-31,1323,4143,5466
15,15494,2031-12-31,1332,4183,5515
15,15494,2032-12-31,1343,4211,5554
15,15494,2033-12-31,1350,4230,5580
15,15494,2034-12-31,1365,4257,5622
15,15494,2035-12-31,1369,4292,5661
15,15500,1985-12-31,128,2125,2253
15,15500,1986-12-31,87,2128,2215
15,15500,1987-12-31,138,2134,2272
15,15500,1988-12-31,132,2153,2285
15,15500,1989-12-31,135,2172,2307
15,15500,1990-12-31,134,2179,2313
15,15500,1991-12-31,154,2204,2358
15,15500,1992-12-31,166,2212,2378
15,15500,1993-12-31,207,2194,2401
15,15500,1994-12-31,161,2224,2385
15,15500,1995-12-31,161,2209,2370
15,15500,1996-12-31,164,2249,2413
15,15500,1997-12-31,238,2262,2500
15,15500,1998-12-31,240,2256,2496
15,15500,1999-12-31,247,2255,2502
15,15500,2000-12-31,248,2239,2487
15,15500,2001-12-31,253,2250,2503
15,15500,2002-12-31,253,2257,2510
15,15500,2003-12-31,256,2264,2520
15,15500,2004-12-31,258,2276,2534
15,15500,2005-12-31,266,2273,2539
15,15500,2006-12-31,277,2285,2562
15,15500,2007-12-31,303,2286,2589
15,15500,2008-12-31,328,2283,2611
15,15500,2009-12-31,348,2290,2638
15,15500,2010-12-31,349,2296,2645
15,15500,2011-12-31,354,2307,2661
15,15500,2012-12-31,360,2347,2707
15,15500,2013-12-31,367,2387,2754
15,15500,2014-12-31,381,2424,2805
15,15500,2015-12-31,389,2427,2816
15,15500,2016-12-31,397,2422,2819
15,15500,2017-12-31,404,2423,2827
15,15500,2018-12-31,400,2421,2821
15,15500,2019-12-31,413,2445,2858
15,15500,2020-12-31,424,2466,2890
15,15500,2021-12-31,458,2453,2911
15,15500,2022-12-31,489,2440,2929
15,15500,2023-12-31,521,2427,2948
15,15500,2024-12-31,528,2410,2938
15,15500,2025-12-31,542,2410,2952
15,15500,2026-12-31,547,2408,2955
15,15500,2027-12-31,555,2415,2970
15,15500,2028-12-31,556,2428,2984
15,15500,2029-12-31,561,2436,2997
15,15500,2030-12-31,577,2450,3027
15,15500,2031-12-31,580,2468,3048
15,15500,2032-12-31,584,2484,3068
15,15500,2033-12-31,589,2511,3100
15,15500,2034-12-31,594,2541,3135
15,15500,2035-12-31,593,2556,3149
15,15507,1985-12-31,1394,6780,8174
15,15507,1986-12-31,1453,6712,8165
15,15507,1987-12-31,1503,6654,8157
15,15507,1988-12-31,1566,6572,8138
15,15507,1989-12-31,1623,6518,8141
15,15507,1990-12-31,1678,6444,8122
15,15507,1991-12-31,1751,6352,8103
15,15507,1992-12-31,1798,6277,8075
15,15507,1993-12-31,1864,6180,8044
15,15507,1994-12-31,1923,6121,8044
15,15507,1995-12-31,1962,6032,7994
15,15507,1996-12-31,2042,5989,8031
15,15507,1997-12-31,2107,5895,8002
15,15507,1998-12-31,2182,5798,7980
15,15507,1999-12-31,2270,5718,7988
15,15507,2000-12-31,2354,5637,7991
15,15507,2001-12-31,2425,5574,7999
15,15507,2002-12-31,2490,5486,7976
15,15507,2003-12-31,2543,5415,7958
15,15507,2004-12-31,2609,5340,7949
15,15507,2005-12-31,2660,5259,7919
15,15507,2006-12-31,2724,5195,7919
15,15507,2007-12-31,2785,5129,7914
15,15507,2008-12-31,2856,5056,7912
15,15507,2009-12-31,2908,4990,7898
15,15507,2010-12-31,2973,4968,7941
15,15507,2011-12-31,3036,4862,7898
15,15507,2012-12-31,3097,4783,7880
15,15507,2013-12-31,3176,4735,7911
15,15507,2014-12-31,3218,4682,7900
15,15507,2015-12-31,3266,4612,7878
15,15507,2016-12-31,3337,4600,7937
15,15507,2017-12-31,3427,4598,8025
15,15507,2018-12-31,3449,4569,8018
15,15507,2019-12-31,3522,4480,8002
15,15507,2020-12-31,3589,4415,8004
15,15507,2021-12-31,3669,4392,8061
15,15507,2022-12-31,3744,4368,8112
15,15507,2023-12-31,3818,4344,8162
15,15507,2024-12-31,3879,4327,8206
15,15507,2025-12-31,3929,4317,8246
15,15507,2026-12-31,3977,4320,8297
15,15507,2027-12-31,4013,4327,8340
15,15507,2028-12-31,4049,4333,8382
15,15507,2029-12-31,4095,4353,8448
15,15507,2030-12-31,4127,4393,8520
15,15507,2031-12-31,4149,4406,8555
15,15507,2032-12-31,4182,4460,8642
15,15507,2033-12-31,4202,4495,8697
15,15507,2034-12-31,4229,4516,8745
15,15507,2035-12-31,4266,4539,8805
15,15511,1985-12-31,405,3632,4037
15,15511,1986-12-31,415,3579,3994
15,15511,1987-12-31,428,3520,3948
15,15511,1988-12-31,413,3472,3885
15,15511,1989-12-31,412,3418,3830
15,15511,1990-12-31,410,3363,3773
15,15511,1991-12-31,405,3286,3691
15,15511,1992-12-31,420,3224,3644
15,15511,1993-12-31,415,3170,3585
15,15511,1994-12-31,457,3179,3636
15,15511,1995-12-31,449,3077,3526
15,15511,1996-12-31,453,2999,3452
15,15511,1997-12-31,461,3019,3480
15,15511,1998-12-31,449,2907,3356
15,15511,1999-12-31,429,2848,3277
15,15511,2000-12-31,410,2797,3207
15,15511,2001-12-31,449,2738,3187
15,15511,2002-12-31,444,2681,3125
15,15511,2003-12-31,439,2614,3053
15,15511,2004-12-31,456,2567,3023
15,15511,2005-12-31,423,2487,2910
15,15511,2006-12-31,430,2412,2842
15,15511,2007-12-31,436,2375,2811
15,15511,2008-12-31,438,2328,2766
15,15511,2009-12-31,446,2262,2708
15,15511,2010-12-31,469,2231,2700
15,15511,2011-12-31,472,2200,2672
15,15511,2012-12-31,489,2161,2650
15,15511,2013-12-31,492,2140,2632
15,15511,2014-12-31,496,2160,2656
15,15511,2015-12-31,500,2134,2634
15,15511,2016-12-31,501,2034,2535
15,15511,2017-12-31,502,1949,2451
15,15511,2018-12-31,520,1947,2467
15,15511,2019-12-31,524,1923,2447
15,15511,2020-12-31,530,1911,2441
15,15511,2021-12-31,557,1901,2458
15,15511,2022-12-31,584,1890,2474
15,15511,2023-12-31,609,1880,2489
15,15511,2024-12-31,620,1873,2493
15,15511,2025-12-31,632,1860,2492
15,15511,2026-12-31,634,1854,2488
15,15511,2027-12-31,637,1869,2506
15,15511,2028-12-31,636,1876,2512
15,15511,2029-12-31,645,1879,2524
15,15511,2030-12-31,655,1887,2542
15,15511,2031-12-31,664,1901,2565
15,15511,2032-12-31,666,1922,2588
15,15511,2033-12-31,668,1935,2603
15,15511,2034-12-31,671,1948,2619
15,15511,2035-12-31,681,1954,2635
15,15514,1985-12-31,825,4045,4870
15,15514,1986-12-31,823,3986,4809
15,15514,1987-12-31,847,3922,4769
15,15514,1988-12-31,864,3859,4723
15,15514,1989-12-31,897,3807,4704
15,15514,1990-12-31,899,3738,4637
15,15514,1991-12-31,928,3652,4580
15,15514,1992-12-31,951,3586,4537
15,15514,1993-12-31,982,3522,4504
15,15514,1994-12-31,985,3445,4430
15,15514,1995-12-31,984,3386,4370
15,15514,1996-12-31,1001,3336,4337
15,15514,1997-12-31,1011,3259,4270
15,15514,1998-12-31,1052,3204,4256
15,15514,1999-12-31,1066,3123,4189
15,15514,2000-12-31,1085,3047,4132
15,15514,2001-12-31,1098,2953,4051
15,15514,2002-12-31,1110,2884,3994
15,15514,2003-12-31,1142,2829,3971
15,15514,2004-12-31,1154,2749,3903
15,15514,2005-12-31,1157,2685,3842
15,15514,2006-12-31,1182,2612,3794
15,15514,2007-12-31,1166,2538,3704
15,15514,2008-12-31,1177,2471,3648
15,15514,2009-12-31,1192,2399,3591
15,15514,2010-12-31,1198,2357,3555
15,15514,2011-12-31,1222,2311,3533
15,15514,2012-12-31,1236,2270,3506
15,15514,2013-12-31,1250,2230,3480
15,15514,2014-12-31,1275,2155,3430
15,15514,2015-12-31,1292,2110,3402
15,15514,2016-12-31,1307,2079,3386
15,15514,2017-12-31,1332,1951,3283
15,15514,2018-12-31,1353,1930,3283
15,15514,2019-12-31,1377,1879,3256
15,15514,2020-12-31,1398,1846,3244
15,15514,2021-12-31,1431,1836,3267
15,15514,2022-12-31,1462,1826,3288
15,15514,2023-12-31,1492,1816,3308
15,15514,2024-12-31,1509,1803,3312
15,15514,2025-12-31,1522,1797,3319
15,15514,2026-12-31,1545,1798,3343
15,15514,2027-12-31,1568,1803,3371
15,15514,2028-12-31,1584,1817,3401
15,15514,2029-12-31,1589,1822,3411
15,15514,2030-12-31,1611,1842,3453
15,15514,2031-12-31,1627,1850,3477
15,15514,2032-12-31,1636,1854,3490
15,15514,2033-12-31,1645,1871,3516
15,15514,2034-12-31,1650,1891,3541
15,15514,2035-12-31,1663,1900,3563
15,15516,1985-12-31,6275,13775,20050
15,15516,1986-12-31,6671,13733,20404
15,15516,1987-12-31,7048,13701,20749
15,15516,1988-12-31,7442,13660,21102
15,15516,1989-12-31,7830,13589,21419
15,15516,1990-12-31,8198,13558,21756
15,15516,1991-12-31,8602,13503,22105
15,15516,1992-12-31,9009,13492,22501
15,15516,1993-12-31,9410,13466,22876
15,15516,1994-12-31,9845,13419,23264
15,15516,1995-12-31,10303,13398,23701
15,15516,1996-12-31,10731,13377,24108
15,15516,1997-12-31,11175,13361,24536
15,15516,1998-12-31,11608,13325,24933
15,15516,1999-12-31,12057,13302,25359
15,15516,2000-12-31,12496,13271,25767
15,15516,2001-12-31,12937,13256,26193
15,15516,2002-12-31,13357,13216,26573
15,15516,2003-12-31,13799,13157,26956
15,15516,2004-12-31,14247,13132,27379
15,15516,2005-12-31,14665,13107,27772
15,15516,2006-12-31,15114,13101,28215
15,15516,2007-12-31,15581,13067,28648
15,15516,2008-12-31,16007,13046,29053
15,15516,2009-12-31,16443,13065,29508
15,15516,2010-12-31,16880,13084,29964
15,15516,2011-12-31,17282,13104,30386
15,15516,2012-12-31,17696,13093,30789
15,15516,2013-12-31,18103,13111,31214
15,15516,2014-12-31,18474,13186,31660
15,15516,2015-12-31,18818,13235,32053
15,15516,2016-12-31,19222,13278,32500
15,15516,2017-12-31,19633,13307,32940
15,15516,2018-12-31,20021,13514,33535
15,15516,2019-12-31,20667,13510,34177
15,15516,2020-12-31,21222,13457,34679
15,15516,2021-12-31,21541,13390,34931
15,15516,2022-12-31,21836,13317,35153
15,15516,2023-12-31,22125,13245,35370
15,15516,2024-12-31,22424,13203,35627
15,15516,2025-12-31,22683,13156,35839
15,15516,2026-12-31,22945,13140,36085
15,15516,2027-12-31,23179,13181,36360
15,15516,2028-12-31,23411,13201,36612
15,15516,2029-12-31,23616,13284,36900
15,15516,2030-12-31,23814,13363,37177
15,15516,2031-12-31,23987,13484,37471
15,15516,2032-12-31,24163,13588,37751
15,15516,2033-12-31,24317,13681,37998
15,15516,2034-12-31,24485,13780,38265
15,15516,2035-12-31,24625,13882,38507
15,15518,1985-12-31,625,2431,3056
15,15518,1986-12-31,640,2388,3028
15,15518,1987-12-31,626,2363,2989
15,15518,1988-12-31,654,2329,2983
15,15518,1989-12-31,668,2297,2965
15,15518,1990-12-31,672,2285,2957
15,15518,1991-12-31,655,2234,2889
15,15518,1992-12-31,692,2214,2906
15,15518,1993-12-31,704,2185,2889
15,15518,1994-12-31,702,2144,2846
15,15518,1995-12-31,721,2125,2846
15,15518,1996-12-31,731,2105,2836
15,15518,1997-12-31,756,2049,2805
15,15518,1998-12-31,753,2000,2753
15,15518,1999-12-31,765,2003,2768
15,15518,2000-12-31,802,1963,2765
15,15518,2001-12-31,812,1950,2762
15,15518,2002-12-31,820,1886,2706
15,15518,2003-12-31,831,1867,2698
15,15518,2004-12-31,839,1809,2648
15,15518,2005-12-31,846,1795,2641
15,15518,2006-12-31,852,1767,2619
15,15518,2007-12-31,864,1751,2615
15,15518,2008-12-31,863,1713,2576
15,15518,2009-12-31,871,1678,2549
15,15518,2010-12-31,876,1682,2558
15,15518,2011-12-31,889,1604,2493
15,15518,2012-12-31,895,1589,2484
15,15518,2013-12-31,908,1569,2477
15,15518,2014-12-31,918,1558,2476
15,15518,2015-12-31,927,1539,2466
15,15518,2016-12-31,930,1465,2395
15,15518,2017-12-31,940,1420,2360
15,15518,2018-12-31,960,1430,2390
15,15518,2019-12-31,977,1423,2400
15,15518,2020-12-31,994,1420,2414
15,15518,2021-12-31,1019,1412,2431
15,15518,2022-12-31,1043,1403,2446
15,15518,2023-12-31,1067,1395,2462
15,15518,2024-12-31,1071,1390,2461
15,15518,2025-12-31,1094,1393,2487
15,15518,2026-12-31,1110,1395,2505
15,15518,2027-12-31,1120,1402,2522
15,15518,2028-12-31,1132,1400,2532
15,15518,2029-12-31,1138,1396,2534
15,15518,2030-12-31,1148,1408,2556
15,15518,2031-12-31,1155,1416,2571
15,15518,2032-12-31,1165,1432,2597
15,15518,2033-12-31,1178,1437,2615
15,15518,2034-12-31,1181,1454,2635
15,15518,2035-12-31,1191,1462,2653
15,15522,1985-12-31,512,2087,2599
15,15522,1986-12-31,519,2040,2559
15,15522,1987-12-31,525,1956,2481
15,15522,1988-12-31,525,1923,2448
15,15522,1989-12-31,534,1897,2431
15,15522,1990-12-31,539,1871,2410
15,15522,1991-12-31,552,1840,2392
15,15522,1992-12-31,560,1790,2350
15,15522,1993-12-31,576,1752,2328
15,15522,1994-12-31,575,1784,2359
15,15522,1995-12-31,592,1720,2312
15,15522,1996-12-31,606,1673,2279
15,15522,1997-12-31,615,1624,2239
15,15522,1998-12-31,610,1584,2194
15,15522,1999-12-31,673,1557,2230
15,15522,2000-12-31,654,1548,2202
15,15522,2001-12-31,658,1504,2162
15,15522,2002-12-31,659,1488,2147
15,15522,2003-12-31,665,1456,2121
15,15522,2004-12-31,671,1353,2024
15,15522,2005-12-31,697,1360,2057
15,15522,2006-12-31,692,1312,2004
15,15522,2007-12-31,682,1286,1968
15,15522,2008-12-31,689,1257,1946
15,15522,2009-12-31,691,1206,1897
15,15522,2010-12-31,707,1183,1890
15,15522,2011-12-31,732,1154,1886
15,15522,2012-12-31,745,1128,1873
15,15522,2013-12-31,761,1097,1858
15,15522,2014-12-31,778,1080,1858
15,15522,2015-12-31,784,1030,1814
15,15522,2016-12-31,792,945,1737
15,15522,2017-12-31,807,902,1709
15,15522,2018-12-31,810,907,1717
15,15522,2019-12-31,825,877,1702
15,15522,2020-12-31,838,859,1697
15,15522,2021-12-31,855,854,1709
15,15522,2022-12-31,870,850,1720
15,15522,2023-12-31,885,845,1730
15,15522,2024-12-31,892,836,1728
15,15522,2025-12-31,902,837,1739
15,15522,2026-12-31,917,837,1754
15,15522,2027-12-31,929,836,1765
15,15522,2028-12-31,941,837,1778
15,15522,2029-12-31,949,845,1794
15,15522,2030-12-31,954,847,1801
15,15522,2031-12-31,962,853,1815
15,15522,2032-12-31,964,865,1829
15,15522,2033-12-31,975,874,1849
15,15522,2034-12-31,977,876,1853
15,15522,2035-12-31,990,882,1872
15,15531,1985-12-31,1493,9038,10531
15,15531,1986-12-31,1488,8926,10414
15,15531,1987-12-31,1503,8811,10314
15,15531,1988-12-31,1517,8685,10202
15,15531,1989-12-31,1540,8530,10070
15,15531,1990-12-31,1554,8376,9930
15,15531,1991-12-31,1573,8207,9780
15,15531,1992-12-31,1568,8080,9648
15,15531,1993-12-31,1589,7930,9519
15,15531,1994-12-31,1601,7808,9409
15,15531,1995-12-31,1642,7696,9338
15,15531,1996-12-31,1668,7567,9235
15,15531,1997-12-31,1686,7446,9132
15,15531,1998-12-31,1731,7309,9040
15,15531,1999-12-31,1760,7176,8936
15,15531,2000-12-31,1786,7080,8866
15,15531,2001-12-31,1791,6936,8727
15,15531,2002-12-31,1802,6812,8614
15,15531,2003-12-31,1820,6682,8502
15,15531,2004-12-31,1841,6567,8408
15,15531,2005-12-31,1869,6442,8311
15,15531,2006-12-31,1870,6327,8197
15,15531,2007-12-31,1885,6205,8090
15,15531,2008-12-31,1917,6120,8037
15,15531,2009-12-31,1940,5946,7886
15,15531,2010-12-31,1960,5857,7817
15,15531,2011-12-31,1959,5734,7693
15,15531,2012-12-31,1970,5633,7603
15,15531,2013-12-31,2038,5523,7561
15,15531,2014-12-31,2031,5402,7433
15,15531,2015-12-31,2033,5298,7331
15,15531,2016-12-31,2047,5231,7278
15,15531,2017-12-31,2058,5209,7267
15,15531,2018-12-31,2073,5112,7185
15,15531,2019-12-31,2112,5086,7198
15,15531,2020-12-31,2149,5063,7212
15,15531,2021-12-31,2227,5036,7263
15,15531,2022-12-31,2300,5009,7309
15,15531,2023-12-31,2372,4982,7354
15,15531,2024-12-31,2405,4964,7369
15,15531,2025-12-31,2442,4952,7394
15,15531,2026-12-31,2475,4952,7427
15,15531,2027-12-31,2500,4946,7446
15,15531,2028-12-31,2528,4969,7497
15,15531,2029-12-31,2551,4986,7537
15,15531,2030-12-31,2569,5023,7592
15,15531,2031-12-31,2588,5052,7640
15,15531,2032-12-31,2606,5073,7679
15,15531,2033-12-31,2623,5118,7741
15,15531,2034-12-31,2642,5146,7788
15,15531,2035-12-31,2659,5189,7848
15,15533,1985-12-31,144,2244,2388
15,15533,1986-12-31,161,2262,2423
15,15533,1987-12-31,162,2260,2422
15,15533,1988-12-31,156,2264,2420
15,15533,1989-12-31,238,2233,2471
15,15533,1990-12-31,208,2216,2424
15,15533,1991-12-31,210,2202,2412
15,15533,1992-12-31,238,2194,2432
15,15533,1993-12-31,240,2180,2420
15,15533,1994-12-31,210,2174,2384
15,15533,1995-12-31,233,2176,2409
15,15533,1996-12-31,249,2174,2423
15,15533,1997-12-31,285,2164,2449
15,15533,1998-12-31,309,2172,2481
15,15533,1999-12-31,318,2168,2486
15,15533,2000-12-31,314,2152,2466
15,15533,2001-12-31,324,2144,2468
15,15533,2002-12-31,340,2136,2476
15,15533,2003-12-31,347,2148,2495
15,15533,2004-12-31,356,2129,2485
15,15533,2005-12-31,357,2126,2483
15,15533,2006-12-31,365,2126,2491
15,15533,2007-12-31,360,2097,2457
15,15533,2008-12-31,401,2096,2497
15,15533,2009-12-31,409,2095,2504
15,15533,2010-12-31,424,2079,2503
15,15533,2011-12-31,426,2081,2507
15,15533,2012-12-31,432,2081,2513
15,15533,2013-12-31,463,2076,2539
15,15533,2014-12-31,473,2076,2549
15,15533,2015-12-31,470,2092,2562
15,15533,2016-12-31,469,2105,2574
15,15533,2017-12-31,469,2100,2569
15,15533,2018-12-31,481,2112,2593
15,15533,2019-12-31,511,2105,2616
15,15533,2020-12-31,537,2098,2635
15,15533,2021-12-31,567,2087,2654
15,15533,2022-12-31,595,2075,2670
15,15533,2023-12-31,623,2064,2687
15,15533,2024-12-31,646,2049,2695
15,15533,2025-12-31,663,2042,2705
15,15533,2026-12-31,696,2044,2740
15,15533,2027-12-31,718,2045,2763
15,15533,2028-12-31,732,2055,2787
15,15533,2029-12-31,760,2066,2826
15,15533,2030-12-31,778,2081,2859
15,15533,2031-12-31,800,2090,2890
15,15533,2032-12-31,829,2117,2946
15,15533,2033-12-31,848,2130,2978
15,15533,2034-12-31,862,2145,3007
15,15533,2035-12-31,885,2158,3043
15,15537,1985-12-31,3289,3499,6788
15,15537,1986-12-31,3256,3425,6681
15,15537,1987-12-31,3221,3377,6598
15,15537,1988-12-31,3221,3296,6517
15,15537,1989-12-31,3197,3267,6464
15,15537,1990-12-31,3184,3205,6389
15,15537,1991-12-31,3167,3124,6291
15,15537,1992-12-31,3142,3080,6222
15,15537,1993-12-31,3138,2992,6130
15,15537,1994-12-31,3133,2938,6071
15,15537,1995-12-31,3127,2872,5999
15,15537,1996-12-31,3099,2832,5931
15,15537,1997-12-31,3090,2768,5858
15,15537,1998-12-31,3079,2701,5780
15,15537,1999-12-31,3091,2629,5720
15,15537,2000-12-31,3105,2562,5667
15,15537,2001-12-31,3113,2496,5609
15,15537,2002-12-31,3104,2421,5525
15,15537,2003-12-31,3088,2362,5450
15,15537,2004-12-31,3085,2274,5359
15,15537,2005-12-31,3039,2222,5261
15,15537,2006-12-31,3027,2146,5173
15,15537,2007-12-31,3013,2079,5092
15,15537,2008-12-31,2988,2016,5004
15,15537,2009-12-31,2970,1996,4966
15,15537,2010-12-31,2954,1962,4916
15,15537,2011-12-31,2936,1904,4840
15,15537,2012-12-31,2919,1880,4799
15,15537,2013-12-31,2882,1783,4665
15,15537,2014-12-31,2858,1718,4576
15,15537,2015-12-31,2847,1697,4544
15,15537,2016-12-31,2853,1648,4501
15,15537,2017-12-31,2758,1497,4255
15,15537,2018-12-31,2788,1497,4285
15,15537,2019-12-31,2757,1471,4228
15,15537,2020-12-31,2750,1448,4198
15,15537,2021-12-31,2788,1440,4228
15,15537,2022-12-31,2822,1432,4254
15,15537,2023-12-31,2856,1425,4281
15,15537,2024-12-31,2887,1427,4314
15,15537,2025-12-31,2927,1423,4350
15,15537,2026-12-31,2950,1419,4369
15,15537,2027-12-31,2987,1417,4404
15,15537,2028-12-31,3013,1427,4440
15,15537,2029-12-31,3046,1426,4472
15,15537,2030-12-31,3067,1436,4503
15,15537,2031-12-31,3092,1444,4536
15,15537,2032-12-31,3117,1457,4574
15,15537,2033-12-31,3138,1474,4612
15,15537,2034-12-31,3147,1485,4632
15,15537,2035-12-31,3175,1486,4661
15,15542,1985-12-31,2899,9644,12543
15,15542,1986-12-31,2875,9474,12349
15,15542,1987-12-31,2865,9354,12219
15,15542,1988-12-31,2821,9180,12001
15,15542,1989-12-31,2799,8996,11795
15,15542,1990-12-31,2781,8823,11604
15,15542,1991-12-31,2742,8618,11360
15,15542,1992-12-31,2719,8447,11166
15,15542,1993-12-31,2711,8265,10976
15,15542,1994-12-31,2698,8099,10797
15,15542,1995-12-31,2678,7952,10630
15,15542,1996-12-31,2674,7789,10463
15,15542,1997-12-31,2643,7606,10249
15,15542,1998-12-31,2659,7457,10116
15,15542,1999-12-31,2653,7323,9976
15,15542,2000-12-31,2658,7147,9805
15,15542,2001-12-31,2648,6992,9640
15,15542,2002-12-31,2632,6841,9473
15,15542,2003-12-31,2616,6683,9299
15,15542,2004-12-31,2588,6520,9108
15,15542,2005-12-31,2566,6361,8927
15,15542,2006-12-31,2544,6186,8730
15,15542,2007-12-31,2500,6074,8574
15,15542,2008-12-31,2476,5910,8386
15,15542,2009-12-31,2458,5780,8238
15,15542,2010-12-31,2424,5619,8043
15,15542,2011-12-31,2412,5476,7888
15,15542,2012-12-31,2410,5344,7754
15,15542,2013-12-31,2348,5173,7521
15,15542,2014-12-31,2334,5041,7375
15,15542,2015-12-31,2314,4915,7229
15,15542,2016-12-31,2298,4790,7088
15,15542,2017-12-31,2221,4775,6996
15,15542,2018-12-31,2245,4607,6852
15,15542,2019-12-31,2240,4525,6765
15,15542,2020-12-31,2251,4479,6730
15,15542,2021-12-31,2323,4455,6778
15,15542,2022-12-31,2390,4431,6821
15,15542,2023-12-31,2456,4407,6863
15,15542,2024-12-31,2492,4398,6890
15,15542,2025-12-31,2513,4374,6887
15,15542,2026-12-31,2551,4377,6928
15,15542,2027-12-31,2567,4389,6956
15,15542,2028-12-31,2591,4403,6994
15,15542,2029-12-31,2613,4410,7023
15,15542,2030-12-31,2647,4461,7108
15,15542,2031-12-31,2663,4495,7158
15,15542,2032-12-31,2676,4523,7199
15,15542,2033-12-31,2697,4547,7244
15,15542,2034-12-31,2722,4581,7303
15,15542,2035-12-31,2742,4628,7370
15,15550,1985-12-31,65,1477,1542
15,15550,1986-12-31,96,1513,1609
15,15550,1987-12-31,150,1507,1657
15,15550,1988-12-31,158,1504,1662
15,15550,1989-12-31,159,1485,1644
15,15550,1990-12-31,152,1478,1630
15,15550,1991-12-31,160,1470,1630
15,15550,1992-12-31,165,1463,1628
15,15550,1993-12-31,180,1452,1632
15,15550,1994-12-31,216,1444,1660
15,15550,1995-12-31,220,1394,1614
15,15550,1996-12-31,224,1391,1615
15,15550,1997-12-31,255,1404,1659
15,15550,1998-12-31,276,1395,1671
15,15550,1999-12-31,304,1382,1686
15,15550,2000-12-31,300,1376,1676
15,15550,2001-12-31,312,1359,1671
15,15550,2002-12-31,349,1352,1701
15,15550,2003-12-31,358,1339,1697
15,15550,2004-12-31,368,1323,1691
15,15550,2005-12-31,373,1331,1704
15,15550,2006-12-31,382,1316,1698
15,15550,2007-12-31,392,1320,1712
15,15550,2008-12-31,429,1323,1752
15,15550,2009-12-31,438,1321,1759
15,15550,2010-12-31,443,1276,1719
15,15550,2011-12-31,461,1262,1723
15,15550,2012-12-31,476,1263,1739
15,15550,2013-12-31,482,1242,1724
15,15550,2014-12-31,495,1232,1727
15,15550,2015-12-31,503,1225,1728
15,15550,2016-12-31,505,1222,1727
15,15550,2017-12-31,517,1226,1743
15,15550,2018-12-31,527,1236,1763
15,15550,2019-12-31,547,1232,1779
15,15550,2020-12-31,564,1229,1793
15,15550,2021-12-31,583,1223,1806
15,15550,2022-12-31,601,1216,1817
15,15550,2023-12-31,618,1210,1828
15,15550,2024-12-31,628,1199,1827
15,15550,2025-12-31,644,1195,1839
15,15550,2026-12-31,659,1195,1854
15,15550,2027-12-31,671,1198,1869
15,15550,2028-12-31,688,1210,1898
15,15550,2029-12-31,702,1208,1910
15,15550,2030-12-31,719,1219,1938
15,15550,2031-12-31,737,1225,1962
15,15550,2032-12-31,757,1230,1987
15,15550,2033-12-31,771,1243,2014
15,15550,2034-12-31,792,1245,2037
15,15550,2035-12-31,803,1255,2058
15,15572,1985-12-31,16709,12482,29191
15,15572,1986-12-31,17132,12476,29608
15,15572,1987-12-31,17575,12506,30081
15,15572,1988-12-31,18018,12572,30590
15,15572,1989-12-31,18472,12534,31006
15,15572,1990-12-31,18953,12572,31525
15,15572,1991-12-31,19391,12534,31925
15,15572,1992-12-31,19887,12574,32461
15,15572,1993-12-31,20373,12577,32950
15,15572,1994-12-31,20896,12584,33480
15,15572,1995-12-31,21456,12605,34061
15,15572,1996-12-31,21991,12631,34622
15,15572,1997-12-31,22560,12660,35220
15,15572,1998-12-31,23126,12712,35838
15,15572,1999-12-31,23671,12740,36411
15,15572,2000-12-31,24211,12762,36973
15,15572,2001-12-31,24751,12773,37524
15,15572,2002-12-31,25284,12787,38071
15,15572,2003-12-31,25809,12813,38622
15,15572,2004-12-31,26330,12805,39135
15,15572,2005-12-31,26812,12813,39625
15,15572,2006-12-31,27333,12843,40176
15,15572,2007-12-31,27850,12877,40727
15,15572,2008-12-31,28350,12901,41251
15,15572,2009-12-31,28844,12945,41789
15,15572,2010-12-31,29366,13007,42373
15,15572,2011-12-31,29828,13067,42895
15,15572,2012-12-31,30291,13128,43419
15,15572,2013-12-31,30759,13189,43948
15,15572,2014-12-31,31220,13255,44475
15,15572,2015-12-31,31625,13313,44938
15,15572,2016-12-31,32036,13473,45509
15,15572,2017-12-31,32494,13579,46073
15,15572,2018-12-31,32979,13757,46736
15,15572,2019-12-31,33792,13808,47600
15,15572,2020-12-31,34551,13720,48271
15,15572,2021-12-31,34942,13680,48622
15,15572,2022-12-31,35320,13610,48930
15,15572,2023-12-31,35695,13537,49232
15,15572,2024-12-31,36150,13486,49636
15,15572,2025-12-31,36578,13462,50040
15,15572,2026-12-31,36991,13476,50467
15,15572,2027-12-31,37377,13487,50864
15,15572,2028-12-31,37737,13526,51263
15,15572,2029-12-31,38069,13609,51678
15,15572,2030-12-31,38387,13681,52068
15,15572,2031-12-31,38679,13789,52468
15,15572,2032-12-31,38951,13897,52848
15,15572,2033-12-31,39212,14007,53219
15,15572,2034-12-31,39470,14127,53597
15,15572,2035-12-31,39715,14223,53938
15,15580,1985-12-31,718,4502,5220
15,15580,1986-12-31,653,4461,5114
15,15580,1987-12-31,694,4437,5131
15,15580,1988-12-31,715,4416,5131
15,15580,1989-12-31,732,4394,5126
15,15580,1990-12-31,737,4383,5120
15,15580,1991-12-31,757,4319,5076
15,15580,1992-12-31,780,4284,5064
15,15580,1993-12-31,804,4250,5054
15,15580,1994-12-31,822,4220,5042
15,15580,1995-12-31,898,4184,5082
15,15580,1996-12-31,906,4206,5112
15,15580,1997-12-31,928,4131,5059
15,15580,1998-12-31,940,4099,5039
15,15580,1999-12-31,964,4049,5013
15,15580,2000-12-31,978,4013,4991
15,15580,2001-12-31,1005,3966,4971
15,15580,2002-12-31,1022,3919,4941
15,15580,2003-12-31,1036,3887,4923
15,15580,2004-12-31,1057,3837,4894
15,15580,2005-12-31,1059,3790,4849
15,15580,2006-12-31,1091,3773,4864
15,15580,2007-12-31,1123,3739,4862
15,15580,2008-12-31,1134,3727,4861
15,15580,2009-12-31,1153,3690,4843
15,15580,2010-12-31,1170,3638,4808
15,15580,2011-12-31,1195,3630,4825
15,15580,2012-12-31,1214,3595,4809
15,15580,2013-12-31,1214,3563,4777
15,15580,2014-12-31,1277,3566,4843
15,15580,2015-12-31,1312,3543,4855
15,15580,2016-12-31,1313,3618,4931
15,15580,2017-12-31,1315,3613,4928
15,15580,2018-12-31,1326,3563,4889
15,15580,2019-12-31,1354,3585,4939
15,15580,2020-12-31,1380,3602,4982
15,15580,2021-12-31,1433,3584,5017
15,15580,2022-12-31,1485,3564,5049
15,15580,2023-12-31,1535,3545,5080
15,15580,2024-12-31,1564,3535,5099
15,15580,2025-12-31,1578,3545,5123
15,15580,2026-12-31,1599,3538,5137
15,15580,2027-12-31,1616,3538,5154
15,15580,2028-12-31,1635,3555,5190
15,15580,2029-12-31,1647,3573,5220
15,15580,2030-12-31,1667,3612,5279
15,15580,2031-12-31,1678,3643,5321
15,15580,2032-12-31,1691,3677,5368
15,15580,2033-12-31,1703,3702,5405
15,15580,2034-12-31,1714,3723,5437
15,15580,2035-12-31,1714,3740,5454
15,15599,1985-12-31,2376,6727,9103
15,15599,1986-12-31,2416,6694,9110
15,15599,1987-12-31,2483,6666,9149
15,15599,1988-12-31,2539,6635,9174
15,15599,1989-12-31,2571,6621,9192
15,15599,1990-12-31,2609,6595,9204
15,15599,1991-12-31,2646,6520,9166
15,15599,1992-12-31,2696,6473,9169
15,15599,1993-12-31,2753,6439,9192
15,15599,1994-12-31,2806,6392,9198
15,15599,1995-12-31,2855,6351,9206
15,15599,1996-12-31,2919,6313,9232
15,15599,1997-12-31,2973,6261,9234
15,15599,1998-12-31,3020,6258,9278
15,15599,1999-12-31,3086,6185,9271
15,15599,2000-12-31,3179,6166,9345
15,15599,2001-12-31,3264,6115,9379
15,15599,2002-12-31,3318,6090,9408
15,15599,2003-12-31,3374,6045,9419
15,15599,2004-12-31,3417,5997,9414
15,15599,2005-12-31,3445,5987,9432
15,15599,2006-12-31,3487,5945,9432
15,15599,2007-12-31,3566,5902,9468
15,15599,2008-12-31,3592,5891,9483
15,15599,2009-12-31,3624,5879,9503
15,15599,2010-12-31,3674,5815,9489
15,15599,2011-12-31,3759,5817,9576
15,15599,2012-12-31,3807,5804,9611
15,15599,2013-12-31,3848,5796,9644
15,15599,2014-12-31,3882,5781,9663
15,15599,2015-12-31,3913,5762,9675
15,15599,2016-12-31,3957,5719,9676
15,15599,2017-12-31,3998,5822,9820
15,15599,2018-12-31,4053,5834,9887
15,15599,2019-12-31,4134,5854,9988
15,15599,2020-12-31,4210,5866,10076
15,15599,2021-12-31,4311,5836,10147
15,15599,2022-12-31,4408,5804,10212
15,15599,2023-12-31,4502,5773,10275
15,15599,2024-12-31,4571,5748,10319
15,15599,2025-12-31,4630,5745,10375
15,15599,2026-12-31,4678,5734,10412
15,15599,2027-12-31,4734,5743,10477
15,15599,2028-12-31,4781,5746,10527
15,15599,2029-12-31,4821,5786,10607
15,15599,2030-12-31,4856,5830,10686
15,15599,2031-12-31,4894,5879,10773
15,15599,2032-12-31,4931,5914,10845
15,15599,2033-12-31,4960,5963,10923
15,15599,2034-12-31,4991,6005,10996
15,15599,2035-12-31,5023,6047,11070
15,15600,1985-12-31,661,5707,6368
15,15600,1986-12-31,683,5705,6388
15,15600,1987-12-31,728,5701,6429
15,15600,1988-12-31,778,5696,6474
15,15600,1989-12-31,812,5726,6538
15,15600,1990-12-31,858,5712,6570
15,15600,1991-12-31,910,5658,6568
15,15600,1992-12-31,951,5630,6581
15,15600,1993-12-31,998,5610,6608
15,15600,1994-12-31,1077,5581,6658
15,15600,1995-12-31,1134,5573,6707
15,15600,1996-12-31,1174,5569,6743
15,15600,1997-12-31,1236,5554,6790
15,15600,1998-12-31,1287,5542,6829
15,15600,1999-12-31,1334,5532,6866
15,15600,2000-12-31,1376,5546,6922
15,15600,2001-12-31,1419,5538,6957
15,15600,2002-12-31,1474,5535,7009
15,15600,2003-12-31,1507,5513,7020
15,15600,2004-12-31,1553,5510,7063
15,15600,2005-12-31,1601,5483,7084
15,15600,2006-12-31,1675,5477,7152
15,15600,2007-12-31,1706,5473,7179
15,15600,2008-12-31,1741,5470,7211
15,15600,2009-12-31,1812,5474,7286
15,15600,2010-12-31,1862,5475,7337
15,15600,2011-12-31,1902,5481,7383
15,15600,2012-12-31,1951,5487,7438
15,15600,2013-12-31,1989,5501,7490
15,15600,2014-12-31,2033,5503,7536
15,15600,2015-12-31,2060,5508,7568
15,15600,2016-12-31,2144,5540,7684
15,15600,2017-12-31,2196,5703,7899
15,15600,2018-12-31,2217,5660,7877
15,15600,2019-12-31,2374,5584,7958
15,15600,2020-12-31,2523,5505,8028
15,15600,2021-12-31,2609,5476,8085
15,15600,2022-12-31,2690,5446,8136
15,15600,2023-12-31,2769,5417,8186
15,15600,2024-12-31,2826,5403,8229
15,15600,2025-12-31,2882,5390,8272
15,15600,2026-12-31,2927,5393,8320
15,15600,2027-12-31,2979,5401,8380
15,15600,2028-12-31,3008,5416,8424
15,15600,2029-12-31,3049,5422,8471
15,15600,2030-12-31,3069,5487,8556
15,15600,2031-12-31,3104,5520,8624
15,15600,2032-12-31,3130,5555,8685
15,15600,2033-12-31,3149,5601,8750
15,15600,2034-12-31,3172,5643,8815
15,15600,2035-12-31,3191,5701,8892
15,15621,1985-12-31,446,3216,3662
15,15621,1986-12-31,444,3191,3635
15,15621,1987-12-31,461,3144,3605
15,15621,1988-12-31,473,3105,3578
15,15621,1989-12-31,439,3053,3492
15,15621,1990-12-31,465,3003,3468
15,15621,1991-12-31,465,2972,3437
15,15621,1992-12-31,463,2926,3389
15,15621,1993-12-31,453,2863,3316
15,15621,1994-12-31,500,2819,3319
15,15621,1995-12-31,511,2791,3302
15,15621,1996-12-31,495,2751,3246
15,15621,1997-12-31,500,2726,3226
15,15621,1998-12-31,529,2648,3177
15,15621,1999-12-31,510,2634,3144
15,15621,2000-12-31,524,2585,3109
15,15621,2001-12-31,524,2523,3047
15,15621,2002-12-31,534,2423,2957
15,15621,2003-12-31,542,2366,2908
15,15621,2004-12-31,515,2304,2819
15,15621,2005-12-31,521,2267,2788
15,15621,2006-12-31,523,2207,2730
15,15621,2007-12-31,528,2199,2727
15,15621,2008-12-31,536,2168,2704
15,15621,2009-12-31,536,2116,2652
15,15621,2010-12-31,544,2090,2634
15,15621,2011-12-31,557,2090,2647
15,15621,2012-12-31,559,2070,2629
15,15621,2013-12-31,560,2036,2596
15,15621,2014-12-31,568,2001,2569
15,15621,2015-12-31,576,1930,2506
15,15621,2016-12-31,582,1843,2425
15,15621,2017-12-31,594,1816,2410
15,15621,2018-12-31,600,1807,2407
15,15621,2019-12-31,613,1771,2384
15,15621,2020-12-31,624,1749,2373
15,15621,2021-12-31,650,1740,2390
15,15621,2022-12-31,675,1730,2405
15,15621,2023-12-31,699,1721,2420
15,15621,2024-12-31,714,1711,2425
15,15621,2025-12-31,719,1704,2423
15,15621,2026-12-31,724,1704,2428
15,15621,2027-12-31,733,1709,2442
15,15621,2028-12-31,744,1706,2450
15,15621,2029-12-31,749,1709,2458
15,15621,2030-12-31,756,1732,2488
15,15621,2031-12-31,762,1741,2503
15,15621,2032-12-31,765,1751,2516
15,15621,2033-12-31,770,1761,2531
15,15621,2034-12-31,774,1776,2550
15,15621,2035-12-31,781,1796,2577
15,15632,1985-12-31,605,13277,13882
15,15632,1986-12-31,598,13196,13794
15,15632,1987-12-31,608,13171,13779
15,15632,1988-12-31,622,13129,13751
15,15632,1989-12-31,667,13036,13703
15,15632,1990-12-31,674,12994,13668
15,15632,1991-12-31,677,12922,13599
15,15632,1992-12-31,690,12902,13592
15,15632,1993-12-31,689,12861,13550
15,15632,1994-12-31,716,12831,13547
15,15632,1995-12-31,716,12782,13498
15,15632,1996-12-31,748,12746,13494
15,15632,1997-12-31,755,12729,13484
15,15632,1998-12-31,749,12671,13420
15,15632,1999-12-31,747,12635,13382
15,15632,2000-12-31,757,12608,13365
15,15632,2001-12-31,782,12578,13360
15,15632,2002-12-31,792,12537,13329
15,15632,2003-12-31,802,12481,13283
15,15632,2004-12-31,812,12429,13241
15,15632,2005-12-31,832,12393,13225
15,15632,2006-12-31,842,12358,13200
15,15632,2007-12-31,867,12331,13198
15,15632,2008-12-31,859,12311,13170
15,15632,2009-12-31,860,12300,13160
15,15632,2010-12-31,882,12291,13173
15,15632,2011-12-31,857,12287,13144
15,15632,2012-12-31,874,12315,13189
15,15632,2013-12-31,894,12309,13203
15,15632,2014-12-31,915,12340,13255
15,15632,2015-12-31,930,12404,13334
15,15632,2016-12-31,939,12406,13345
15,15632,2017-12-31,955,12428,13383
15,15632,2018-12-31,978,12610,13588
15,15632,2019-12-31,999,12729,13728
15,15632,2020-12-31,1018,12831,13849
15,15632,2021-12-31,1181,12766,13947
15,15632,2022-12-31,1339,12696,14035
15,15632,2023-12-31,1494,12628,14122
15,15632,2024-12-31,1548,12594,14142
15,15632,2025-12-31,1582,12544,14126
15,15632,2026-12-31,1604,12539,14143
15,15632,2027-12-31,1636,12555,14191
15,15632,2028-12-31,1644,12606,14250
15,15632,2029-12-31,1660,12671,14331
15,15632,2030-12-31,1678,12737,14415
15,15632,2031-12-31,1688,12849,14537
15,15632,2032-12-31,1694,12935,14629
15,15632,2033-12-31,1704,13037,14741
15,15632,2034-12-31,1715,13148,14863
15,15632,2035-12-31,1723,13221,14944
15,15638,1985-12-31,819,1523,2342
15,15638,1986-12-31,873,1548,2421
15,15638,1987-12-31,926,1586,2512
15,15638,1988-12-31,966,1634,2600
15,15638,1989-12-31,1015,1686,2701
15,15638,1990-12-31,1087,1703,2790
15,15638,1991-12-31,1142,1755,2897
15,15638,1992-12-31,1186,1806,2992
15,15638,1993-12-31,1235,1840,3075
15,15638,1994-12-31,1302,1870,3172
15,15638,1995-12-31,1349,1915,3264
15,15638,1996-12-31,1416,1957,3373
15,15638,1997-12-31,1466,2006,3472
15,15638,1998-12-31,1534,2067,3601
15,15638,1999-12-31,1604,2094,3698
15,15638,2000-12-31,1634,2141,3775
15,15638,2001-12-31,1677,2154,3831
15,15638,2002-12-31,1763,2172,3935
15,15638,2003-12-31,1801,2220,4021
15,15638,2004-12-31,1852,2251,4103
15,15638,2005-12-31,1909,2314,4223
15,15638,2006-12-31,1951,2326,4277
15,15638,2007-12-31,1999,2350,4349
15,15638,2008-12-31,2065,2437,4502
15,15638,2009-12-31,2100,2437,4537
15,15638,2010-12-31,2154,2506,4660
15,15638,2011-12-31,2172,2550,4722
15,15638,2012-12-31,2231,2576,4807
15,15638,2013-12-31,2299,2619,4918
15,15638,2014-12-31,2359,2655,5014
15,15638,2015-12-31,2417,2720,5137
15,15638,2016-12-31,2461,2827,5288
15,15638,2017-12-31,2514,2861,5375
15,15638,2018-12-31,2567,2885,5452
15,15638,2019-12-31,2647,2931,5578
15,15638,2020-12-31,2715,2962,5677
15,15638,2021-12-31,2771,2947,5718
15,15638,2022-12-31,2824,2931,5755
15,15638,2023-12-31,2875,2915,5790
15,15638,2024-12-31,2914,2897,5811
15,15638,2025-12-31,2959,2906,5865
15,15638,2026-12-31,3000,2896,5896
15,15638,2027-12-31,3036,2897,5933
15,15638,2028-12-31,3074,2917,5991
15,15638,2029-12-31,3108,2922,6030
15,15638,2030-12-31,3139,2951,6090
15,15638,2031-12-31,3167,2975,6142
15,15638,2032-12-31,3186,2996,6182
15,15638,2033-12-31,3218,3017,6235
15,15638,2034-12-31,3240,3041,6281
15,15638,2035-12-31,3261,3061,6322
15,15646,1985-12-31,2302,10449,12751
15,15646,1986-12-31,2445,10460,12905
15,15646,1987-12-31,2568,10486,13054
15,15646,1988-12-31,2712,10515,13227
15,15646,1989-12-31,2830,10510,13340
15,15646,1990-12-31,2975,10487,13462
15,15646,1991-12-31,3108,10461,13569
15,15646,1992-12-31,3263,10473,13736
15,15646,1993-12-31,3402,10470,13872
15,15646,1994-12-31,3545,10469,14014
15,15646,1995-12-31,3694,10490,14184
15,15646,1996-12-31,3853,10478,14331
15,15646,1997-12-31,4000,10509,14509
15,15646,1998-12-31,4142,10532,14674
15,15646,1999-12-31,4294,10546,14840
15,15646,2000-12-31,4431,10568,14999
15,15646,2001-12-31,4594,10580,15174
15,15646,2002-12-31,4789,10577,15366
15,15646,2003-12-31,4966,10588,15554
15,15646,2004-12-31,5110,10585,15695
15,15646,2005-12-31,5253,10567,15820
15,15646,2006-12-31,5395,10592,15987
15,15646,2007-12-31,5540,10602,16142
15,15646,2008-12-31,5709,10604,16313
15,15646,2009-12-31,5852,10644,16496
15,15646,2010-12-31,5992,10675,16667
15,15646,2011-12-31,6165,10712,16877
15,15646,2012-12-31,6267,10758,17025
15,15646,2013-12-31,6397,10794,17191
15,15646,2014-12-31,6534,10848,17382
15,15646,2015-12-31,6673,10925,17598
15,15646,2016-12-31,6814,10986,17800
15,15646,2017-12-31,6947,11104,18051
15,15646,2018-12-31,7075,11223,18298
15,15646,2019-12-31,7298,11290,18588
15,15646,2020-12-31,7486,11332,18818
15,15646,2021-12-31,7680,11275,18955
15,15646,2022-12-31,7862,11213,19075
15,15646,2023-12-31,8041,11152,19193
15,15646,2024-12-31,8225,11096,19321
15,15646,2025-12-31,8398,11082,19480
15,15646,2026-12-31,8572,11093,19665
15,15646,2027-12-31,8730,11094,19824
15,15646,2028-12-31,8890,11137,20027
15,15646,2029-12-31,9038,11202,20240
15,15646,2030-12-31,9187,11269,20456
15,15646,2031-12-31,9327,11356,20683
15,15646,2032-12-31,9454,11439,20893
15,15646,2033-12-31,9596,11529,21125
15,15646,2034-12-31,9735,11610,21345
15,15646,2035-12-31,9866,11709,21575
15,15660,1985-12-31,608,2493,3101
15,15660,1986-12-31,617,2499,3116
15,15660,1987-12-31,641,2410,3051
15,15660,1988-12-31,620,2396,3016
15,15660,1989-12-31,649,2324,2973
15,15660,1990-12-31,634,2293,2927
15,15660,1991-12-31,637,2230,2867
15,15660,1992-12-31,626,2161,2787
15,15660,1993-12-31,630,2138,2768
15,15660,1994-12-31,655,2098,2753
15,15660,1995-12-31,679,2054,2733
15,15660,1996-12-31,682,1995,2677
15,15660,1997-12-31,696,1959,2655
15,15660,1998-12-31,679,1941,2620
15,15660,1999-12-31,649,1894,2543
15,15660,2000-12-31,670,1862,2532
15,15660,2001-12-31,654,1763,2417
15,15660,2002-12-31,656,1728,2384
15,15660,2003-12-31,664,1701,2365
15,15660,2004-12-31,671,1595,2266
15,15660,2005-12-31,685,1547,2232
15,15660,2006-12-31,682,1516,2198
15,15660,2007-12-31,678,1480,2158
15,15660,2008-12-31,677,1454,2131
15,15660,2009-12-31,682,1408,2090
15,15660,2010-12-31,688,1375,2063
15,15660,2011-12-31,696,1313,2009
15,15660,2012-12-31,697,1229,1926
15,15660,2013-12-31,702,1184,1886
15,15660,2014-12-31,712,1157,1869
15,15660,2015-12-31,716,1138,1854
15,15660,2016-12-31,724,1074,1798
15,15660,2017-12-31,730,966,1696
15,15660,2018-12-31,732,969,1701
15,15660,2019-12-31,748,928,1676
15,15660,2020-12-31,763,897,1660
15,15660,2021-12-31,780,892,1672
15,15660,2022-12-31,795,887,1682
15,15660,2023-12-31,810,883,1693
15,15660,2024-12-31,823,869,1692
15,15660,2025-12-31,828,864,1692
15,15660,2026-12-31,843,861,1704
15,15660,2027-12-31,848,868,1716
15,15660,2028-12-31,854,874,1728
15,15660,2029-12-31,863,876,1739
15,15660,2030-12-31,872,879,1751
15,15660,2031-12-31,875,897,1772
15,15660,2032-12-31,882,901,1783
15,15660,2033-12-31,888,910,1798
15,15660,2034-12-31,891,922,1813
15,15660,2035-12-31,898,926,1824
15,15664,1985-12-31,605,5591,6196
15,15664,1986-12-31,611,5544,6155
15,15664,1987-12-31,623,5500,6123
15,15664,1988-12-31,626,5456,6082
15,15664,1989-12-31,643,5406,6049
15,15664,1990-12-31,681,5364,6045
15,15664,1991-12-31,682,5263,5945
15,15664,1992-12-31,693,5217,5910
15,15664,1993-12-31,697,5168,5865
15,15664,1994-12-31,689,5118,5807
15,15664,1995-12-31,689,5050,5739
15,15664,1996-12-31,720,4990,5710
15,15664,1997-12-31,739,4936,5675
15,15664,1998-12-31,755,4877,5632
15,15664,1999-12-31,804,4815,5619
15,15664,2000-12-31,822,4759,5581
15,15664,2001-12-31,816,4708,5524
15,15664,2002-12-31,807,4651,5458
15,15664,2003-12-31,805,4584,5389
15,15664,2004-12-31,808,4539,5347
15,15664,2005-12-31,813,4479,5292
15,15664,2006-12-31,861,4422,5283
15,15664,2007-12-31,903,4367,5270
15,15664,2008-12-31,915,4318,5233
15,15664,2009-12-31,914,4270,5184
15,15664,2010-12-31,913,4225,5138
15,15664,2011-12-31,915,4175,5090
15,15664,2012-12-31,918,4126,5044
15,15664,2013-12-31,925,4095,5020
15,15664,2014-12-31,935,4061,4996
15,15664,2015-12-31,940,4052,4992
15,15664,2016-12-31,948,4025,4973
15,15664,2017-12-31,959,4019,4978
15,15664,2018-12-31,978,4010,4988
15,15664,2019-12-31,1000,3989,4989
15,15664,2020-12-31,1020,3979,4999
15,15664,2021-12-31,1079,3955,5034
15,15664,2022-12-31,1134,3932,5066
15,15664,2023-12-31,1188,3910,5098
15,15664,2024-12-31,1213,3892,5105
15,15664,2025-12-31,1230,3883,5113
15,15664,2026-12-31,1238,3885,5123
15,15664,2027-12-31,1259,3885,5144
15,15664,2028-12-31,1274,3882,5156
15,15664,2029-12-31,1280,3905,5185
15,15664,2030-12-31,1292,3919,5211
15,15664,2031-12-31,1300,3938,5238
15,15664,2032-12-31,1311,3939,5250
15,15664,2033-12-31,1322,3928,5250
15,15664,2034-12-31,1326,3902,5228
15,15664,2035-12-31,1340,3856,5196
15,15667,1985-12-31,1659,5290,6949
15,15667,1986-12-31,1665,5206,6871
15,15667,1987-12-31,1708,5122,6830
15,15667,1988-12-31,1745,5065,6810
15,15667,1989-12-31,1771,4996,6767
15,15667,1990-12-31,1784,4961,6745
15,15667,1991-12-31,1795,4846,6641
15,15667,1992-12-31,1829,4743,6572
15,15667,1993-12-31,1827,4729,6556
15,15667,1994-12-31,1863,4646,6509
15,15667,1995-12-31,1893,4558,6451
15,15667,1996-12-31,1888,4474,6362
15,15667,1997-12-31,1937,4403,6340
15,15667,1998-12-31,2008,4313,6321
15,15667,1999-12-31,2038,4233,6271
15,15667,2000-12-31,2070,4163,6233
15,15667,2001-12-31,2093,4137,6230
15,15667,2002-12-31,2112,4048,6160
15,15667,2003-12-31,2125,3964,6089
15,15667,2004-12-31,2146,3908,6054
15,15667,2005-12-31,2162,3812,5974
15,15667,2006-12-31,2205,3687,5892
15,15667,2007-12-31,2230,3651,5881
15,15667,2008-12-31,2244,3578,5822
15,15667,2009-12-31,2258,3499,5757
15,15667,2010-12-31,2279,3429,5708
15,15667,2011-12-31,2296,3364,5660
15,15667,2012-12-31,2324,3312,5636
15,15667,2013-12-31,2348,3257,5605
15,15667,2014-12-31,2313,3204,5517
15,15667,2015-12-31,2339,3206,5545
15,15667,2016-12-31,2368,3209,5577
15,15667,2017-12-31,2404,3072,5476
15,15667,2018-12-31,2444,3055,5499
15,15667,2019-12-31,2441,3035,5476
15,15667,2020-12-31,2450,3023,5473
15,15667,2021-12-31,2505,3007,5512
15,15667,2022-12-31,2556,2991,5547
15,15667,2023-12-31,2607,2974,5581
15,15667,2024-12-31,2648,2962,5610
15,15667,2025-12-31,2666,2950,5616
15,15667,2026-12-31,2698,2953,5651
15,15667,2027-12-31,2720,2960,5680
15,15667,2028-12-31,2760,2967,5727
15,15667,2029-12-31,2781,2973,5754
15,15667,2030-12-31,2804,2989,5793
15,15667,2031-12-31,2826,3008,5834
15,15667,2032-12-31,2847,3047,5894
15,15667,2033-12-31,2861,3062,5923
15,15667,2034-12-31,2879,3087,5966
15,15667,2035-12-31,2896,3101,5997
15,15673,1985-12-31,1250,8027,9277
15,15673,1986-12-31,1250,7852,9102
15,15673,1987-12-31,1239,7687,8926
15,15673,1988-12-31,1242,7486,8728
15,15673,1989-12-31,1241,7321,8562
15,15673,1990-12-31,1210,7111,8321
15,15673,1991-12-31,1217,6873,8090
15,15673,1992-12-31,1217,6683,7900
15,15673,1993-12-31,1212,6499,7711
15,15673,1994-12-31,1229,6308,7537
15,15673,1995-12-31,1248,6136,7384
15,15673,1996-12-31,1246,5939,7185
15,15673,1997-12-31,1228,5760,6988
15,15673,1998-12-31,1231,5559,6790
15,15673,1999-12-31,1236,5389,6625
15,15673,2000-12-31,1230,5216,6446
15,15673,2001-12-31,1238,5034,6272
15,15673,2002-12-31,1249,4859,6108
15,15673,2003-12-31,1271,4679,5950
15,15673,2004-12-31,1266,4487,5753
15,15673,2005-12-31,1238,4309,5547
15,15673,2006-12-31,1258,4092,5350
15,15673,2007-12-31,1232,4002,5234
15,15673,2008-12-31,1204,3750,4954
15,15673,2009-12-31,1179,3614,4793
15,15673,2010-12-31,1170,3441,4611
15,15673,2011-12-31,1163,3268,4431
15,15673,2012-12-31,1157,3114,4271
15,15673,2013-12-31,1147,2962,4109
15,15673,2014-12-31,1140,2791,3931
15,15673,2015-12-31,1138,2679,3817
15,15673,2016-12-31,1146,2522,3668
15,15673,2017-12-31,1148,2349,3497
15,15673,2018-12-31,1163,2169,3332
15,15673,2019-12-31,1158,2046,3204
15,15673,2020-12-31,1162,1969,3131
15,15673,2021-12-31,1194,1959,3153
15,15673,2022-12-31,1225,1948,3173
15,15673,2023-12-31,1256,1937,3193
15,15673,2024-12-31,1262,1924,3186
15,15673,2025-12-31,1280,1925,3205
15,15673,2026-12-31,1295,1935,3230
15,15673,2027-12-31,1310,1929,3239
15,15673,2028-12-31,1324,1930,3254
15,15673,2029-12-31,1332,1941,3273
15,15673,2030-12-31,1342,1946,3288
15,15673,2031-12-31,1359,1969,3328
15,15673,2032-12-31,1364,1982,3346
15,15673,2033-12-31,1374,1999,3373
15,15673,2034-12-31,1387,2010,3397
15,15673,2035-12-31,1396,2028,3424
15,15676,1985-12-31,306,3631,3937
15,15676,1986-12-31,313,3635,3948
15,15676,1987-12-31,313,3590,3903
15,15676,1988-12-31,315,3556,3871
15,15676,1989-12-31,304,3525,3829
15,15676,1990-12-31,317,3495,3812
15,15676,1991-12-31,326,3449,3775
15,15676,1992-12-31,356,3419,3775
15,15676,1993-12-31,357,3381,3738
15,15676,1994-12-31,361,3338,3699
15,15676,1995-12-31,373,3272,3645
15,15676,1996-12-31,373,3271,3644
15,15676,1997-12-31,371,3237,3608
15,15676,1998-12-31,392,3208,3600
15,15676,1999-12-31,393,3157,3550
15,15676,2000-12-31,390,3128,3518
15,15676,2001-12-31,389,3088,3477
15,15676,2002-12-31,395,3049,3444
15,15676,2003-12-31,409,3012,3421
15,15676,2004-12-31,417,2966,3383
15,15676,2005-12-31,371,2883,3254
15,15676,2006-12-31,419,2830,3249
15,15676,2007-12-31,426,2806,3232
15,15676,2008-12-31,424,2773,3197
15,15676,2009-12-31,417,2758,3175
15,15676,2010-12-31,407,2760,3167
15,15676,2011-12-31,400,2732,3132
15,15676,2012-12-31,399,2698,3097
15,15676,2013-12-31,401,2689,3090
15,15676,2014-12-31,403,2661,3064
15,15676,2015-12-31,403,2642,3045
15,15676,2016-12-31,410,2625,3035
15,15676,2017-12-31,411,2615,3026
15,15676,2018-12-31,412,2597,3009
15,15676,2019-12-31,418,2588,3006
15,15676,2020-12-31,424,2587,3011
15,15676,2021-12-31,458,2574,3032
15,15676,2022-12-31,492,2560,3052
15,15676,2023-12-31,524,2546,3070
15,15676,2024-12-31,535,2541,3076
15,15676,2025-12-31,540,2526,3066
15,15676,2026-12-31,544,2519,3063
15,15676,2027-12-31,548,2530,3078
15,15676,2028-12-31,552,2525,3077
15,15676,2029-12-31,558,2534,3092
15,15676,2030-12-31,564,2547,3111
15,15676,2031-12-31,569,2552,3121
15,15676,2032-12-31,573,2566,3139
15,15676,2033-12-31,578,2581,3159
15,15676,2034-12-31,589,2590,3179
15,15676,2035-12-31,593,2612,3205
15,15681,1985-12-31,455,6553,7008
15,15681,1986-12-31,453,6552,7005
15,15681,1987-12-31,456,6536,6992
15,15681,1988-12-31,456,6492,6948
15,15681,1989-12-31,466,6495,6961
15,15681,1990-12-31,495,6465,6960
15,15681,1991-12-31,503,6424,6927
15,15681,1992-12-31,508,6388,6896
15,15681,1993-12-31,513,6359,6872
15,15681,1994-12-31,542,6326,6868
15,15681,1995-12-31,546,6294,6840
15,15681,1996-12-31,559,6246,6805
15,15681,1997-12-31,583,6202,6785
15,15681,1998-12-31,600,6165,6765
15,15681,1999-12-31,590,6146,6736
15,15681,2000-12-31,602,6114,6716
15,15681,2001-12-31,633,6101,6734
15,15681,2002-12-31,628,6041,6669
15,15681,2003-12-31,636,6007,6643
15,15681,2004-12-31,625,5987,6612
15,15681,2005-12-31,651,5958,6609
15,15681,2006-12-31,674,5930,6604
15,15681,2007-12-31,684,5911,6595
15,15681,2008-12-31,690,5889,6579
15,15681,2009-12-31,695,5865,6560
15,15681,2010-12-31,692,5857,6549
15,15681,2011-12-31,702,5829,6531
15,15681,2012-12-31,703,5808,6511
15,15681,2013-12-31,713,5816,6529
15,15681,2014-12-31,715,5800,6515
15,15681,2015-12-31,716,5795,6511
15,15681,2016-12-31,722,5785,6507
15,15681,2017-12-31,731,5901,6632
15,15681,2018-12-31,745,5863,6608
15,15681,2019-12-31,759,5905,6664
15,15681,2020-12-31,772,5944,6716
15,15681,2021-12-31,850,5914,6764
15,15681,2022-12-31,925,5881,6806
15,15681,2023-12-31,998,5850,6848
15,15681,2024-12-31,1031,5827,6858
15,15681,2025-12-31,1053,5818,6871
15,15681,2026-12-31,1059,5821,6880
15,15681,2027-12-31,1065,5817,6882
15,15681,2028-12-31,1070,5835,6905
15,15681,2029-12-31,1084,5861,6945
15,15681,2030-12-31,1096,5919,7015
15,15681,2031-12-31,1100,5954,7054
15,15681,2032-12-31,1120,6000,7120
15,15681,2033-12-31,1121,6026,7147
15,15681,2034-12-31,1128,6073,7201
15,15681,2035-12-31,1140,6126,7266
15,15686,1985-12-31,1242,5419,6661
15,15686,1986-12-31,1290,5409,6699
15,15686,1987-12-31,1311,5406,6717
15,15686,1988-12-31,1346,5387,6733
15,15686,1989-12-31,1401,5375,6776
15,15686,1990-12-31,1453,5388,6841
15,15686,1991-12-31,1473,5343,6816
15,15686,1992-12-31,1520,5329,6849
15,15686,1993-12-31,1565,5300,6865
15,15686,1994-12-31,1600,5285,6885
15,15686,1995-12-31,1612,5263,6875
15,15686,1996-12-31,1652,5279,6931
15,15686,1997-12-31,1717,5230,6947
15,15686,1998-12-31,1766,5188,6954
15,15686,1999-12-31,1835,5150,6985
15,15686,2000-12-31,1848,5138,6986
15,15686,2001-12-31,1883,5109,6992
15,15686,2002-12-31,1910,5101,7011
15,15686,2003-12-31,1942,5071,7013
15,15686,2004-12-31,1981,5050,7031
15,15686,2005-12-31,2031,5061,7092
15,15686,2006-12-31,2081,5028,7109
15,15686,2007-12-31,2115,5031,7146
15,15686,2008-12-31,2169,5016,7185
15,15686,2009-12-31,2206,4998,7204
15,15686,2010-12-31,2242,4997,7239
15,15686,2011-12-31,2285,4999,7284
15,15686,2012-12-31,2321,4965,7286
15,15686,2013-12-31,2352,4954,7306
15,15686,2014-12-31,2388,4938,7326
15,15686,2015-12-31,2417,4923,7340
15,15686,2016-12-31,2456,4936,7392
15,15686,2017-12-31,2487,5043,7530
15,15686,2018-12-31,2525,5040,7565
15,15686,2019-12-31,2576,5067,7643
15,15686,2020-12-31,2623,5087,7710
15,15686,2021-12-31,2704,5061,7765
15,15686,2022-12-31,2781,5033,7814
15,15686,2023-12-31,2856,5006,7862
15,15686,2024-12-31,2900,4991,7891
15,15686,2025-12-31,2939,4968,7907
15,15686,2026-12-31,2975,4959,7934
15,15686,2027-12-31,3003,4987,7990
15,15686,2028-12-31,3031,4997,8028
15,15686,2029-12-31,3062,5019,8081
15,15686,2030-12-31,3076,5046,8122
15,15686,2031-12-31,3104,5094,8198
15,15686,2032-12-31,3130,5132,8262
15,15686,2033-12-31,3149,5167,8316
15,15686,2034-12-31,3182,5211,8393
15,15686,2035-12-31,3198,5235,8433
15,15690,1985-12-31,2684,3123,5807
15,15690,1986-12-31,2661,3071,5732
15,15690,1987-12-31,2654,3031,5685
15,15690,1988-12-31,2630,2968,5598
15,15690,1989-12-31,2622,2922,5544
15,15690,1990-12-31,2607,2865,5472
15,15690,1991-12-31,2578,2804,5382
15,15690,1992-12-31,2572,2758,5330
15,15690,1993-12-31,2541,2698,5239
15,15690,1994-12-31,2534,2655,5189
15,15690,1995-12-31,2518,2605,5123
15,15690,1996-12-31,2501,2551,5052
15,15690,1997-12-31,2472,2517,4989
15,15690,1998-12-31,2487,2470,4957
15,15690,1999-12-31,2484,2413,4897
15,15690,2000-12-31,2500,2366,4866
15,15690,2001-12-31,2486,2326,4812
15,15690,2002-12-31,2468,2274,4742
15,15690,2003-12-31,2440,2203,4643
15,15690,2004-12-31,2424,2145,4569
15,15690,2005-12-31,2390,2089,4479
15,15690,2006-12-31,2360,2030,4390
15,15690,2007-12-31,2327,1961,4288
15,15690,2008-12-31,2304,1920,4224
15,15690,2009-12-31,2312,1872,4184
15,15690,2010-12-31,2265,1848,4113
15,15690,2011-12-31,2240,1802,4042
15,15690,2012-12-31,2228,1755,3983
15,15690,2013-12-31,2196,1697,3893
15,15690,2014-12-31,2188,1658,3846
15,15690,2015-12-31,2191,1618,3809
15,15690,2016-12-31,2144,1563,3707
15,15690,2017-12-31,2095,1469,3564
15,15690,2018-12-31,2107,1452,3559
15,15690,2019-12-31,2078,1440,3518
15,15690,2020-12-31,2068,1430,3498
15,15690,2021-12-31,2101,1422,3523
15,15690,2022-12-31,2130,1415,3545
15,15690,2023-12-31,2160,1407,3567
15,15690,2024-12-31,2186,1406,3592
15,15690,2025-12-31,2213,1408,3621
15,15690,2026-12-31,2251,1401,3652
15,15690,2027-12-31,2266,1397,3663
15,15690,2028-12-31,2289,1405,3694
15,15690,2029-12-31,2314,1412,3726
15,15690,2030-12-31,2323,1429,3752
15,15690,2031-12-31,2344,1434,3778
15,15690,2032-12-31,2357,1443,3800
15,15690,2033-12-31,2378,1459,3837
15,15690,2034-12-31,2392,1457,3849
15,15690,2035-12-31,2405,1472,3877
15,15693,1985-12-31,4651,5712,10363
15,15693,1986-12-31,4712,5678,10390
15,15693,1987-12-31,4822,5666,10488
15,15693,1988-12-31,4894,5647,10541
15,15693,1989-12-31,4985,5638,10623
15,15693,1990-12-31,5074,5633,10707
15,15693,1991-12-31,5162,5547,10709
15,15693,1992-12-31,5251,5514,10765
15,15693,1993-12-31,5351,5475,10826
15,15693,1994-12-31,5458,5471,10929
15,15693,1995-12-31,5577,5432,11009
15,15693,1996-12-31,5688,5400,11088
15,15693,1997-12-31,5800,5377,11177
15,15693,1998-12-31,5937,5349,11286
15,15693,1999-12-31,6028,5327,11355
15,15693,2000-12-31,6119,5313,11432
15,15693,2001-12-31,6253,5295,11548
15,15693,2002-12-31,6375,5258,11633
15,15693,2003-12-31,6528,5231,11759
15,15693,2004-12-31,6618,5196,11814
15,15693,2005-12-31,6720,5178,11898
15,15693,2006-12-31,6816,5167,11983
15,15693,2007-12-31,6921,5129,12050
15,15693,2008-12-31,7062,5123,12185
15,15693,2009-12-31,7143,5105,12248
15,15693,2010-12-31,7243,5078,12321
15,15693,2011-12-31,7340,5080,12420
15,15693,2012-12-31,7415,5076,12491
15,15693,2013-12-31,7500,5063,12563
15,15693,2014-12-31,7566,5014,12580
15,15693,2015-12-31,7653,4993,12646
15,15693,2016-12-31,7736,5011,12747
15,15693,2017-12-31,7838,5122,12960
15,15693,2018-12-31,7937,5129,13066
15,15693,2019-12-31,8018,5187,13205
15,15693,2020-12-31,8106,5219,13325
15,15693,2021-12-31,8226,5193,13419
15,15693,2022-12-31,8340,5164,13504
15,15693,2023-12-31,8452,5136,13588
15,15693,2024-12-31,8557,5113,13670
15,15693,2025-12-31,8660,5115,13775
15,15693,2026-12-31,8769,5105,13874
15,15693,2027-12-31,8852,5117,13969
15,15693,2028-12-31,8928,5140,14068
15,15693,2029-12-31,9019,5164,14183
15,15693,2030-12-31,9089,5192,14281
15,15693,2031-12-31,9155,5233,14388
15,15693,2032-12-31,9219,5269,14488
15,15693,2033-12-31,9286,5304,14590
15,15693,2034-12-31,9347,5349,14696
15,15693,2035-12-31,9410,5396,14806
15,15696,1985-12-31,515,2777,3292
15,15696,1986-12-31,524,2743,3267
15,15696,1987-12-31,536,2732,3268
15,15696,1988-12-31,562,2744,3306
15,15696,1989-12-31,607,2724,3331
15,15696,1990-12-31,634,2731,3365
15,15696,1991-12-31,643,2702,3345
15,15696,1992-12-31,652,2705,3357
15,15696,1993-12-31,666,2665,3331
15,15696,1994-12-31,685,2611,3296
15,15696,1995-12-31,704,2589,3293
15,15696,1996-12-31,723,2581,3304
15,15696,1997-12-31,720,2576,3296
15,15696,1998-12-31,691,2555,3246
15,15696,1999-12-31,708,2504,3212
15,15696,2000-12-31,732,2456,3188
15,15696,2001-12-31,758,2437,3195
15,15696,2002-12-31,762,2429,3191
15,15696,2003-12-31,800,2381,3181
15,15696,2004-12-31,818,2378,3196
15,15696,2005-12-31,837,2296,3133
15,15696,2006-12-31,843,2297,3140
15,15696,2007-12-31,866,2285,3151
15,15696,2008-12-31,837,2264,3101
15,15696,2009-12-31,842,2260,3102
15,15696,2010-12-31,867,2255,3122
15,15696,2011-12-31,886,2244,3130
15,15696,2012-12-31,909,2275,3184
15,15696,2013-12-31,934,2221,3155
15,15696,2014-12-31,953,2192,3145
15,15696,2015-12-31,976,2174,3150
15,15696,2016-12-31,991,2162,3153
15,15696,2017-12-31,1007,2160,3167
15,15696,2018-12-31,1019,2160,3179
15,15696,2019-12-31,1036,2159,3195
15,15696,2020-12-31,1051,2161,3212
15,15696,2021-12-31,1085,2150,3235
15,15696,2022-12-31,1117,2138,3255
15,15696,2023-12-31,1148,2127,3275
15,15696,2024-12-31,1161,2117,3278
15,15696,2025-12-31,1175,2112,3287
15,15696,2026-12-31,1188,2107,3295
15,15696,2027-12-31,1206,2109,3315
15,15696,2028-12-31,1218,2120,3338
15,15696,2029-12-31,1225,2120,3345
15,15696,2030-12-31,1235,2145,3380
15,15696,2031-12-31,1251,2156,3407
15,15696,2032-12-31,1249,2182,3431
15,15696,2033-12-31,1265,2195,3460
15,15696,2034-12-31,1276,2203,3479
15,15696,2035-12-31,1277,2235,3512
15,15720,1985-12-31,530,3617,4147
15,15720,1986-12-31,549,3564,4113
15,15720,1987-12-31,541,3498,4039
15,15720,1988-12-31,546,3467,4013
15,15720,1989-12-31,577,3392,3969
15,15720,1990-12-31,592,3314,3906
15,15720,1991-12-31,621,3244,3865
15,15720,1992-12-31,624,3188,3812
15,15720,1993-12-31,631,3103,3734
15,15720,1994-12-31,587,3056,3643
15,15720,1995-12-31,581,2994,3575
15,15720,1996-12-31,582,2939,3521
15,15720,1997-12-31,582,2874,3456
15,15720,1998-12-31,588,2794,3382
15,15720,1999-12-31,619,2725,3344
15,15720,2000-12-31,617,2627,3244
15,15720,2001-12-31,618,2567,3185
15,15720,2002-12-31,615,2499,3114
15,15720,2003-12-31,605,2415,3020
15,15720,2004-12-31,610,2349,2959
15,15720,2005-12-31,636,2278,2914
15,15720,2006-12-31,644,2207,2851
15,15720,2007-12-31,639,2155,2794
15,15720,2008-12-31,655,2103,2758
15,15720,2009-12-31,635,2036,2671
15,15720,2010-12-31,606,1998,2604
15,15720,2011-12-31,614,1938,2552
15,15720,2012-12-31,616,1916,2532
15,15720,2013-12-31,636,1856,2492
15,15720,2014-12-31,651,1774,2425
15,15720,2015-12-31,656,1736,2392
15,15720,2016-12-31,665,1685,2350
15,15720,2017-12-31,679,1542,2221
15,15720,2018-12-31,680,1541,2221
15,15720,2019-12-31,679,1498,2177
15,15720,2020-12-31,682,1471,2153
15,15720,2021-12-31,705,1463,2168
15,15720,2022-12-31,727,1455,2182
15,15720,2023-12-31,748,1447,2195
15,15720,2024-12-31,760,1446,2206
15,15720,2025-12-31,768,1435,2203
15,15720,2026-12-31,767,1432,2199
15,15720,2027-12-31,781,1434,2215
15,15720,2028-12-31,787,1448,2235
15,15720,2029-12-31,796,1453,2249
15,15720,2030-12-31,800,1461,2261
15,15720,2031-12-31,813,1463,2276
15,15720,2032-12-31,812,1474,2286
15,15720,2033-12-31,821,1488,2309
15,15720,2034-12-31,821,1504,2325
15,15720,2035-12-31,829,1509,2338
15,15723,1985-12-31,235,1014,1249
15,15723,1986-12-31,243,1062,1305
15,15723,1987-12-31,246,1033,1279
15,15723,1988-12-31,264,1016,1280
15,15723,1989-12-31,282,1024,1306
15,15723,1990-12-31,286,1015,1301
15,15723,1991-12-31,279,1024,1303
15,15723,1992-12-31,273,1005,1278
15,15723,1993-12-31,278,958,1236
15,15723,1994-12-31,280,992,1272
15,15723,1995-12-31,283,978,1261
15,15723,1996-12-31,281,975,1256
15,15723,1997-12-31,283,935,1218
15,15723,1998-12-31,297,934,1231
15,15723,1999-12-31,279,925,1204
15,15723,2000-12-31,298,938,1236
15,15723,2001-12-31,296,936,1232
15,15723,2002-12-31,296,952,1248
15,15723,2003-12-31,297,924,1221
15,15723,2004-12-31,299,934,1233
15,15723,2005-12-31,310,889,1199
15,15723,2006-12-31,306,932,1238
15,15723,2007-12-31,299,911,1210
15,15723,2008-12-31,297,888,1185
15,15723,2009-12-31,292,873,1165
15,15723,2010-12-31,294,857,1151
15,15723,2011-12-31,298,850,1148
15,15723,2012-12-31,300,836,1136
15,15723,2013-12-31,292,827,1119
15,15723,2014-12-31,295,807,1102
15,15723,2015-12-31,295,795,1090
15,15723,2016-12-31,298,785,1083
15,15723,2017-12-31,297,777,1074
15,15723,2018-12-31,302,795,1097
15,15723,2019-12-31,306,794,1100
15,15723,2020-12-31,310,795,1105
15,15723,2021-12-31,322,791,1113
15,15723,2022-12-31,333,787,1120
15,15723,2023-12-31,345,782,1127
15,15723,2024-12-31,356,770,1126
15,15723,2025-12-31,354,779,1133
15,15723,2026-12-31,356,776,1132
15,15723,2027-12-31,357,774,1131
15,15723,2028-12-31,361,777,1138
15,15723,2029-12-31,370,781,1151
15,15723,2030-12-31,371,791,1162
15,15723,2031-12-31,369,796,1165
15,15723,2032-12-31,379,802,1181
15,15723,2033-12-31,378,804,1182
15,15723,2034-12-31,384,810,1194
15,15723,2035-12-31,383,818,1201
15,15740,1985-12-31,892,6646,7538
15,15740,1986-12-31,896,6619,7515
15,15740,1987-12-31,899,6609,7508
15,15740,1988-12-31,899,6540,7439
15,15740,1989-12-31,898,6517,7415
15,15740,1990-12-31,904,6504,7408
15,15740,1991-12-31,910,6448,7358
15,15740,1992-12-31,921,6372,7293
15,15740,1993-12-31,920,6339,7259
15,15740,1994-12-31,933,6306,7239
15,15740,1995-12-31,944,6272,7216
15,15740,1996-12-31,974,6228,7202
15,15740,1997-12-31,965,6170,7135
15,15740,1998-12-31,992,6122,7114
15,15740,1999-12-31,990,6075,7065
15,15740,2000-12-31,1005,6027,7032
15,15740,2001-12-31,1023,5996,7019
15,15740,2002-12-31,1038,5946,6984
15,15740,2003-12-31,1054,5901,6955
15,15740,2004-12-31,1072,5876,6948
15,15740,2005-12-31,1056,5823,6879
15,15740,2006-12-31,1047,5800,6847
15,15740,2007-12-31,1039,5777,6816
15,15740,2008-12-31,1039,5734,6773
15,15740,2009-12-31,1040,5705,6745
15,15740,2010-12-31,1046,5667,6713
15,15740,2011-12-31,1052,5612,6664
15,15740,2012-12-31,1060,5571,6631
15,15740,2013-12-31,1063,5569,6632
15,15740,2014-12-31,1074,5555,6629
15,15740,2015-12-31,1079,5532,6611
15,15740,2016-12-31,1088,5522,6610
15,15740,2017-12-31,1105,5607,6712
15,15740,2018-12-31,1117,5612,6729
15,15740,2019-12-31,1124,5623,6747
15,15740,2020-12-31,1135,5639,6774
15,15740,2021-12-31,1212,5610,6822
15,15740,2022-12-31,1285,5580,6865
15,15740,2023-12-31,1358,5550,6908
15,15740,2024-12-31,1389,5525,6914
15,15740,2025-12-31,1408,5520,6928
15,15740,2026-12-31,1427,5513,6940
15,15740,2027-12-31,1441,5519,6960
15,15740,2028-12-31,1454,5536,6990
15,15740,2029-12-31,1468,5568,7036
15,15740,2030-12-31,1469,5606,7075
15,15740,2031-12-31,1486,5663,7149
15,15740,2032-12-31,1499,5689,7188
15,15740,2033-12-31,1510,5732,7242
15,15740,2034-12-31,1516,5774,7290
15,15740,2035-12-31,1523,5821,7344
15,15753,1985-12-31,6335,10272,16607
15,15753,1986-12-31,6311,10012,16323
15,15753,1987-12-31,6307,9802,16109
15,15753,1988-12-31,6308,9573,15881
15,15753,1989-12-31,6312,9306,15618
15,15753,1990-12-31,6309,9029,15338
15,15753,1991-12-31,6296,8777,15073
15,15753,1992-12-31,6311,8522,14833
15,15753,1993-12-31,6309,8281,14590
15,15753,1994-12-31,6326,8049,14375
15,15753,1995-12-31,6325,7776,14101
15,15753,1996-12-31,6349,7528,13877
15,15753,1997-12-31,6376,7292,13668
15,15753,1998-12-31,6389,7061,13450
15,15753,1999-12-31,6386,6844,13230
15,15753,2000-12-31,6363,6603,12966
15,15753,2001-12-31,6387,6367,12754
15,15753,2002-12-31,6407,6118,12525
15,15753,2003-12-31,6446,5898,12344
15,15753,2004-12-31,6470,5661,12131
15,15753,2005-12-31,6467,5421,11888
15,15753,2006-12-31,6475,5204,11679
15,15753,2007-12-31,6485,4967,11452
15,15753,2008-12-31,6474,4760,11234
15,15753,2009-12-31,6496,4532,11028
15,15753,2010-12-31,6485,4315,10800
15,15753,2011-12-31,6466,4084,10550
15,15753,2012-12-31,6437,3843,10280
15,15753,2013-12-31,6439,3632,10071
15,15753,2014-12-31,6432,3469,9901
15,15753,2015-12-31,6422,3269,9691
15,15753,2016-12-31,6406,3075,9481
15,15753,2017-12-31,6435,2872,9307
15,15753,2018-12-31,6407,2659,9066
15,15753,2019-12-31,6370,2538,8908
15,15753,2020-12-31,6381,2451,8832
15,15753,2021-12-31,6456,2438,8894
15,15753,2022-12-31,6526,2425,8951
15,15753,2023-12-31,6594,2412,9006
15,15753,2024-12-31,6668,2404,9072
15,15753,2025-12-31,6752,2394,9146
15,15753,2026-12-31,6814,2396,9210
15,15753,2027-12-31,6896,2398,9294
15,15753,2028-12-31,6962,2401,9363
15,15753,2029-12-31,7020,2415,9435
15,15753,2030-12-31,7070,2438,9508
15,15753,2031-12-31,7139,2442,9581
15,15753,2032-12-31,7181,2470,9651
15,15753,2033-12-31,7227,2486,9713
15,15753,2034-12-31,7280,2508,9788
15,15753,2035-12-31,7331,2517,9848
15,15755,1985-12-31,932,11437,12369
15,15755,1986-12-31,941,11270,12211
15,15755,1987-12-31,969,11106,12075
15,15755,1988-12-31,984,10914,11898
15,15755,1989-12-31,968,10671,11639
15,15755,1990-12-31,990,10475,11465
15,15755,1991-12-31,1008,10254,11262
15,15755,1992-12-31,1019,10076,11095
15,15755,1993-12-31,1035,9889,10924
15,15755,1994-12-31,1056,9698,10754
15,15755,1995-12-31,1090,9535,10625
15,15755,1996-12-31,1120,9347,10467
15,15755,1997-12-31,1118,9156,10274
15,15755,1998-12-31,1146,9007,10153
15,15755,1999-12-31,1166,8818,9984
15,15755,2000-12-31,1184,8639,9823
15,15755,2001-12-31,1205,8467,9672
15,15755,2002-12-31,1215,8286,9501
15,15755,2003-12-31,1227,8095,9322
15,15755,2004-12-31,1237,7927,9164
15,15755,2005-12-31,1229,7750,8979
15,15755,2006-12-31,1262,7625,8887
15,15755,2007-12-31,1254,7423,8677
15,15755,2008-12-31,1281,7250,8531
15,15755,2009-12-31,1284,7096,8380
15,15755,2010-12-31,1311,6959,8270
15,15755,2011-12-31,1330,6804,8134
15,15755,2012-12-31,1326,6642,7968
15,15755,2013-12-31,1334,6506,7840
15,15755,2014-12-31,1331,6356,7687
15,15755,2015-12-31,1354,6191,7545
15,15755,2016-12-31,1382,6043,7425
15,15755,2017-12-31,1403,6038,7441
15,15755,2018-12-31,1428,5870,7298
15,15755,2019-12-31,1454,5777,7231
15,15755,2020-12-31,1477,5734,7211
15,15755,2021-12-31,1558,5704,7262
15,15755,2022-12-31,1636,5672,7308
15,15755,2023-12-31,1711,5642,7353
15,15755,2024-12-31,1743,5616,7359
15,15755,2025-12-31,1771,5614,7385
15,15755,2026-12-31,1791,5599,7390
15,15755,2027-12-31,1801,5608,7409
15,15755,2028-12-31,1823,5626,7449
15,15755,2029-12-31,1835,5664,7499
15,15755,2030-12-31,1853,5689,7542
15,15755,2031-12-31,1873,5740,7613
15,15755,2032-12-31,1886,5780,7666
15,15755,2033-12-31,1897,5845,7742
15,15755,2034-12-31,1905,5871,7776
15,15755,2035-12-31,1924,5919,7843
15,15757,1985-12-31,2611,5941,8552
15,15757,1986-12-31,2651,5864,8515
15,15757,1987-12-31,2685,5791,8476
15,15757,1988-12-31,2743,5726,8469
15,15757,1989-12-31,2762,5653,8415
15,15757,1990-12-31,2816,5593,8409
15,15757,1991-12-31,2857,5457,8314
15,15757,1992-12-31,2917,5389,8306
15,15757,1993-12-31,2958,5311,8269
15,15757,1994-12-31,3014,5234,8248
15,15757,1995-12-31,3069,5158,8227
15,15757,1996-12-31,3098,5088,8186
15,15757,1997-12-31,3166,5005,8171
15,15757,1998-12-31,3240,4953,8193
15,15757,1999-12-31,3286,4876,8162
15,15757,2000-12-31,3358,4803,8161
15,15757,2001-12-31,3448,4728,8176
15,15757,2002-12-31,3523,4643,8166
15,15757,2003-12-31,3567,4558,8125
15,15757,2004-12-31,3612,4500,8112
15,15757,2005-12-31,3656,4410,8066
15,15757,2006-12-31,3703,4350,8053
15,15757,2007-12-31,3737,4274,8011
15,15757,2008-12-31,3794,4206,8000
15,15757,2009-12-31,3833,4138,7971
15,15757,2010-12-31,3865,4068,7933
15,15757,2011-12-31,3914,4007,7921
15,15757,2012-12-31,3972,3941,7913
15,15757,2013-12-31,4023,3887,7910
15,15757,2014-12-31,4064,3830,7894
15,15757,2015-12-31,4065,3794,7859
15,15757,2016-12-31,4110,3813,7923
15,15757,2017-12-31,4177,3734,7911
15,15757,2018-12-31,4236,3702,7938
15,15757,2019-12-31,4302,3716,8018
15,15757,2020-12-31,4357,3729,8086
15,15757,2021-12-31,4433,3710,8143
15,15757,2022-12-31,4505,3690,8195
15,15757,2023-12-31,4575,3670,8245
15,15757,2024-12-31,4639,3666,8305
15,15757,2025-12-31,4692,3659,8351
15,15757,2026-12-31,4740,3659,8399
15,15757,2027-12-31,4794,3656,8450
15,15757,2028-12-31,4842,3679,8521
15,15757,2029-12-31,4891,3687,8578
15,15757,2030-12-31,4927,3718,8645
15,15757,2031-12-31,4961,3746,8707
15,15757,2032-12-31,4992,3767,8759
15,15757,2033-12-31,5034,3801,8835
15,15757,2034-12-31,5066,3832,8898
15,15757,2035-12-31,5094,3861,8955
15,15759,1985-12-31,58558,18567,77125
15,15759,1986-12-31,59960,18422,78382
15,15759,1987-12-31,61361,18280,79641
15,15759,1988-12-31,62865,18160,81025
15,15759,1989-12-31,64323,18021,82344
15,15759,1990-12-31,65921,17909,83830
15,15759,1991-12-31,67282,17732,85014
15,15759,1992-12-31,68938,17627,86565
15,15759,1993-12-31,70563,17511,88074
15,15759,1994-12-31,72289,17378,89667
15,15759,1995-12-31,74100,17269,91369
15,15759,1996-12-31,75920,17154,93074
15,15759,1997-12-31,77732,17037,94769
15,15759,1998-12-31,79587,16914,96501
15,15759,1999-12-31,81388,16789,98177
15,15759,2000-12-31,83171,16685,99856
15,15759,2001-12-31,84926,16563,101489
15,15759,2002-12-31,86673,16459,103132
15,15759,2003-12-31,88409,16315,104724
15,15759,2004-12-31,90068,16184,106252
15,15759,2005-12-31,91653,16071,107724
15,15759,2006-12-31,93337,15965,109302
15,15759,2007-12-31,94987,15851,110838
15,15759,2008-12-31,96629,15753,112382
15,15759,2009-12-31,98248,15673,113921
15,15759,2010-12-31,99920,15616,115536
15,15759,2011-12-31,101470,15536,117006
15,15759,2012-12-31,102984,15470,118454
15,15759,2013-12-31,104447,15408,119855
15,15759,2014-12-31,105898,15399,121297
15,15759,2015-12-31,107328,15318,122646
15,15759,2016-12-31,108745,15325,124070
15,15759,2017-12-31,110265,15301,125566
15,15759,2018-12-31,111815,15420,127235
15,15759,2019-12-31,114019,15327,129346
15,15759,2020-12-31,116031,15074,131105
15,15759,2021-12-31,117064,14995,132059
15,15759,2022-12-31,117983,14912,132895
15,15759,2023-12-31,118884,14832,133716
15,15759,2024-12-31,120134,14789,134923
15,15759,2025-12-31,121456,14750,136206
15,15759,2026-12-31,122767,14749,137516
15,15759,2027-12-31,124033,14765,138798
15,15759,2028-12-31,125224,14813,140037
15,15759,2029-12-31,126316,14895,141211
15,15759,2030-12-31,127342,14996,142338
15,15759,2031-12-31,128282,15116,143398
15,15759,2032-12-31,129213,15238,144451
15,15759,2033-12-31,130111,15351,145462
15,15759,2034-12-31,130966,15465,146431
15,15759,2035-12-31,131757,15580,147337
15,15761,1985-12-31,623,3878,4501
15,15761,1986-12-31,643,3860,4503
15,15761,1987-12-31,642,3815,4457
15,15761,1988-12-31,636,3750,4386
15,15761,1989-12-31,630,3698,4328
15,15761,1990-12-31,655,3662,4317
15,15761,1991-12-31,658,3617,4275
15,15761,1992-12-31,653,3545,4198
15,15761,1993-12-31,648,3506,4154
15,15761,1994-12-31,687,3442,4129
15,15761,1995-12-31,629,3408,4037
15,15761,1996-12-31,631,3354,3985
15,15761,1997-12-31,640,3265,3905
15,15761,1998-12-31,622,3209,3831
15,15761,1999-12-31,622,3136,3758
15,15761,2000-12-31,653,3080,3733
15,15761,2001-12-31,653,3023,3676
15,15761,2002-12-31,658,2962,3620
15,15761,2003-12-31,666,2915,3581
15,15761,2004-12-31,678,2832,3510
15,15761,2005-12-31,703,2791,3494
15,15761,2006-12-31,685,2741,3426
15,15761,2007-12-31,671,2694,3365
15,15761,2008-12-31,658,2652,3310
15,15761,2009-12-31,652,2575,3227
15,15761,2010-12-31,643,2562,3205
15,15761,2011-12-31,640,2525,3165
15,15761,2012-12-31,647,2457,3104
15,15761,2013-12-31,635,2406,3041
15,15761,2014-12-31,637,2395,3032
15,15761,2015-12-31,639,2410,3049
15,15761,2016-12-31,642,2371,3013
15,15761,2017-12-31,646,2256,2902
15,15761,2018-12-31,655,2255,2910
15,15761,2019-12-31,657,2230,2887
15,15761,2020-12-31,662,2218,2880
15,15761,2021-12-31,694,2206,2900
15,15761,2022-12-31,725,2194,2919
15,15761,2023-12-31,755,2182,2937
15,15761,2024-12-31,763,2179,2942
15,15761,2025-12-31,782,2171,2953
15,15761,2026-12-31,781,2173,2954
15,15761,2027-12-31,790,2170,2960
15,15761,2028-12-31,795,2171,2966
15,15761,2029-12-31,802,2183,2985
15,15761,2030-12-31,809,2203,3012
15,15761,2031-12-31,818,2214,3032
15,15761,2032-12-31,822,2222,3044
15,15761,2033-12-31,833,2248,3081
15,15761,2034-12-31,833,2260,3093
15,15761,2035-12-31,842,2281,3123
15,15762,1985-12-31,266,2599,2865
15,15762,1986-12-31,262,2621,2883
15,15762,1987-12-31,278,2607,2885
15,15762,1988-12-31,272,2594,2866
15,15762,1989-12-31,297,2594,2891
15,15762,1990-12-31,289,2590,2879
15,15762,1991-12-31,296,2596,2892
15,15762,1992-12-31,303,2596,2899
15,15762,1993-12-31,308,2583,2891
15,15762,1994-12-31,365,2575,2940
15,15762,1995-12-31,356,2571,2927
15,15762,1996-12-31,360,2584,2944
15,15762,1997-12-31,376,2570,2946
15,15762,1998-12-31,375,2576,2951
15,15762,1999-12-31,370,2570,2940
15,15762,2000-12-31,378,2563,2941
15,15762,2001-12-31,379,2547,2926
15,15762,2002-12-31,381,2535,2916
15,15762,2003-12-31,384,2517,2901
15,15762,2004-12-31,388,2515,2903
15,15762,2005-12-31,426,2494,2920
15,15762,2006-12-31,426,2483,2909
15,15762,2007-12-31,425,2489,2914
15,15762,2008-12-31,429,2465,2894
15,15762,2009-12-31,435,2449,2884
15,15762,2010-12-31,434,2445,2879
15,15762,2011-12-31,439,2469,2908
15,15762,2012-12-31,448,2483,2931
15,15762,2013-12-31,469,2492,2961
15,15762,2014-12-31,470,2492,2962
15,15762,2015-12-31,474,2496,2970
15,15762,2016-12-31,477,2530,3007
15,15762,2017-12-31,480,2526,3006
15,15762,2018-12-31,486,2533,3019
15,15762,2019-12-31,495,2555,3050
15,15762,2020-12-31,504,2573,3077
15,15762,2021-12-31,539,2560,3099
15,15762,2022-12-31,572,2546,3118
15,15762,2023-12-31,606,2532,3138
15,15762,2024-12-31,613,2516,3129
15,15762,2025-12-31,616,2515,3131
15,15762,2026-12-31,624,2518,3142
15,15762,2027-12-31,638,2522,3160
15,15762,2028-12-31,650,2530,3180
15,15762,2029-12-31,659,2535,3194
15,15762,2030-12-31,663,2554,3217
15,15762,2031-12-31,665,2565,3230
15,15762,2032-12-31,670,2593,3263
15,15762,2033-12-31,677,2616,3293
15,15762,2034-12-31,679,2629,3308
15,15762,2035-12-31,682,2650,3332
15,15763,1985-12-31,639,7078,7717
15,15763,1986-12-31,641,7114,7755
15,15763,1987-12-31,654,7113,7767
15,15763,1988-12-31,650,7102,7752
15,15763,1989-12-31,687,7114,7801
15,15763,1990-12-31,690,7089,7779
15,15763,1991-12-31,705,7040,7745
15,15763,1992-12-31,692,7029,7721
15,15763,1993-12-31,712,7021,7733
15,15763,1994-12-31,726,7009,7735
15,15763,1995-12-31,743,7026,7769
15,15763,1996-12-31,752,7014,7766
15,15763,1997-12-31,769,6998,7767
15,15763,1998-12-31,771,6986,7757
15,15763,1999-12-31,776,6993,7769
15,15763,2000-12-31,793,6991,7784
15,15763,2001-12-31,795,7006,7801
15,15763,2002-12-31,802,6979,7781
15,15763,2003-12-31,809,6963,7772
15,15763,2004-12-31,814,6972,7786
15,15763,2005-12-31,821,6985,7806
15,15763,2006-12-31,800,6963,7763
15,15763,2007-12-31,843,6968,7811
15,15763,2008-12-31,819,6957,7776
15,15763,2009-12-31,836,6964,7800
15,15763,2010-12-31,830,6982,7812
15,15763,2011-12-31,823,7004,7827
15,15763,2012-12-31,825,7002,7827
15,15763,2013-12-31,835,7013,7848
15,15763,2014-12-31,853,7075,7928
15,15763,2015-12-31,866,7112,7978
15,15763,2016-12-31,879,7109,7988
15,15763,2017-12-31,888,7215,8103
15,15763,2018-12-31,905,7257,8162
15,15763,2019-12-31,914,7323,8237
15,15763,2020-12-31,920,7385,8305
15,15763,2021-12-31,1016,7348,8364
15,15763,2022-12-31,1110,7307,8417
15,15763,2023-12-31,1201,7268,8469
15,15763,2024-12-31,1235,7247,8482
15,15763,2025-12-31,1256,7228,8484
15,15763,2026-12-31,1273,7213,8486
15,15763,2027-12-31,1287,7236,8523
15,15763,2028-12-31,1297,7250,8547
15,15763,2029-12-31,1312,7288,8600
15,15763,2030-12-31,1319,7344,8663
15,15763,2031-12-31,1330,7387,8717
15,15763,2032-12-31,1340,7457,8797
15,15763,2033-12-31,1352,7494,8846
15,15763,2034-12-31,1355,7570,8925
15,15763,2035-12-31,1368,7622,8990
15,15764,1985-12-31,321,5016,5337
15,15764,1986-12-31,400,5036,5436
15,15764,1987-12-31,405,4987,5392
15,15764,1988-12-31,437,4970,5407
15,15764,1989-12-31,452,4965,5417
15,15764,1990-12-31,544,4954,5498
15,15764,1991-12-31,586,4914,5500
15,15764,1992-12-31,612,4893,5505
15,15764,1993-12-31,600,4867,5467
15,15764,1994-12-31,671,4850,5521
15,15764,1995-12-31,713,4838,5551
15,15764,1996-12-31,721,4812,5533
15,15764,1997-12-31,764,4797,5561
15,15764,1998-12-31,754,4773,5527
15,15764,1999-12-31,791,4724,5515
15,15764,2000-12-31,853,4684,5537
15,15764,2001-12-31,883,4652,5535
15,15764,2002-12-31,914,4619,5533
15,15764,2003-12-31,957,4596,5553
15,15764,2004-12-31,991,4581,5572
15,15764,2005-12-31,1006,4541,5547
15,15764,2006-12-31,1051,4520,5571
15,15764,2007-12-31,1095,4498,5593
15,15764,2008-12-31,1111,4469,5580
15,15764,2009-12-31,1153,4476,5629
15,15764,2010-12-31,1191,4484,5675
15,15764,2011-12-31,1185,4497,5682
15,15764,2012-12-31,1232,4458,5690
15,15764,2013-12-31,1289,4432,5721
15,15764,2014-12-31,1328,4414,5742
15,15764,2015-12-31,1365,4398,5763
15,15764,2016-12-31,1397,4464,5861
15,15764,2017-12-31,1433,4495,5928
15,15764,2018-12-31,1461,4493,5954
15,15764,2019-12-31,1516,4499,6015
15,15764,2020-12-31,1560,4508,6068
15,15764,2021-12-31,1626,4485,6111
15,15764,2022-12-31,1689,4461,6150
15,15764,2023-12-31,1751,4437,6188
15,15764,2024-12-31,1798,4429,6227
15,15764,2025-12-31,1839,4422,6261
15,15764,2026-12-31,1869,4415,6284
15,15764,2027-12-31,1902,4417,6319
15,15764,2028-12-31,1926,4427,6353
15,15764,2029-12-31,1943,4450,6393
15,15764,2030-12-31,1966,4477,6443
15,15764,2031-12-31,1982,4524,6506
15,15764,2032-12-31,1998,4561,6559
15,15764,2033-12-31,2016,4580,6596
15,15764,2034-12-31,2019,4613,6632
15,15764,2035-12-31,2036,4656,6692
15,15774,1985-12-31,627,3294,3921
15,15774,1986-12-31,670,3296,3966
15,15774,1987-12-31,691,3239,3930
15,15774,1988-12-31,684,3208,3892
15,15774,1989-12-31,648,3172,3820
15,15774,1990-12-31,680,3132,3812
15,15774,1991-12-31,657,3102,3759
15,15774,1992-12-31,666,3068,3734
15,15774,1993-12-31,675,3019,3694
15,15774,1994-12-31,625,2992,3617
15,15774,1995-12-31,641,2947,3588
15,15774,1996-12-31,647,2923,3570
15,15774,1997-12-31,644,2875,3519
15,15774,1998-12-31,639,2833,3472
15,15774,1999-12-31,620,2819,3439
15,15774,2000-12-31,634,2710,3344
15,15774,2001-12-31,627,2701,3328
15,15774,2002-12-31,626,2659,3285
15,15774,2003-12-31,633,2600,3233
15,15774,2004-12-31,651,2541,3192
15,15774,2005-12-31,599,2462,3061
15,15774,2006-12-31,641,2439,3080
15,15774,2007-12-31,619,2438,3057
15,15774,2008-12-31,613,2398,3011
15,15774,2009-12-31,615,2359,2974
15,15774,2010-12-31,663,2343,3006
15,15774,2011-12-31,643,2329,2972
15,15774,2012-12-31,636,2322,2958
15,15774,2013-12-31,615,2308,2923
15,15774,2014-12-31,610,2279,2889
15,15774,2015-12-31,596,2196,2792
15,15774,2016-12-31,595,2130,2725
15,15774,2017-12-31,593,2119,2712
15,15774,2018-12-31,604,2113,2717
15,15774,2019-12-31,607,2097,2704
15,15774,2020-12-31,612,2092,2704
15,15774,2021-12-31,645,2078,2723
15,15774,2022-12-31,673,2067,2740
15,15774,2023-12-31,702,2055,2757
15,15774,2024-12-31,714,2042,2756
15,15774,2025-12-31,721,2036,2757
15,15774,2026-12-31,722,2036,2758
15,15774,2027-12-31,732,2039,2771
15,15774,2028-12-31,744,2049,2793
15,15774,2029-12-31,750,2057,2807
15,15774,2030-12-31,759,2073,2832
15,15774,2031-12-31,767,2081,2848
15,15774,2032-12-31,772,2095,2867
15,15774,2033-12-31,785,2120,2905
15,15774,2034-12-31,786,2123,2909
15,15774,2035-12-31,793,2145,2938
15,15776,1985-12-31,503,4175,4678
15,15776,1986-12-31,550,4214,4764
15,15776,1987-12-31,624,4177,4801
15,15776,1988-12-31,669,4193,4862
15,15776,1989-12-31,710,4188,4898
15,15776,1990-12-31,748,4184,4932
15,15776,1991-12-31,775,4156,4931
15,15776,1992-12-31,837,4144,4981
15,15776,1993-12-31,880,4129,5009
15,15776,1994-12-31,938,4114,5052
15,15776,1995-12-31,996,4119,5115
15,15776,1996-12-31,1041,4099,5140
15,15776,1997-12-31,1092,4090,5182
15,15776,1998-12-31,1130,4073,5203
15,15776,1999-12-31,1204,4040,5244
15,15776,2000-12-31,1242,4016,5258
15,15776,2001-12-31,1286,3992,5278
15,15776,2002-12-31,1348,3969,5317
15,15776,2003-12-31,1403,3957,5360
15,15776,2004-12-31,1420,3952,5372
15,15776,2005-12-31,1496,3926,5422
15,15776,2006-12-31,1537,3914,5451
15,15776,2007-12-31,1567,3893,5460
15,15776,2008-12-31,1616,3879,5495
15,15776,2009-12-31,1677,3866,5543
15,15776,2010-12-31,1679,3878,5557
15,15776,2011-12-31,1750,3910,5660
15,15776,2012-12-31,1815,3908,5723
15,15776,2013-12-31,1873,3902,5775
15,15776,2014-12-31,1918,3886,5804
15,15776,2015-12-31,1974,3891,5865
15,15776,2016-12-31,2020,3960,5980
15,15776,2017-12-31,2060,3987,6047
15,15776,2018-12-31,2103,3989,6092
15,15776,2019-12-31,2174,3990,6164
15,15776,2020-12-31,2233,3995,6228
15,15776,2021-12-31,2298,3975,6273
15,15776,2022-12-31,2360,3953,6313
15,15776,2023-12-31,2420,3932,6352
15,15776,2024-12-31,2477,3917,6394
15,15776,2025-12-31,2535,3905,6440
15,15776,2026-12-31,2589,3898,6487
15,15776,2027-12-31,2651,3903,6554
15,15776,2028-12-31,2712,3920,6632
15,15776,2029-12-31,2759,3942,6701
15,15776,2030-12-31,2814,3970,6784
15,15776,2031-12-31,2869,4001,6870
15,15776,2032-12-31,2926,4032,6958
15,15776,2033-12-31,2977,4060,7037
15,15776,2034-12-31,3032,4091,7123
15,15776,2035-12-31,3088,4121,7209
15,15778,1985-12-31,544,4819,5363
15,15778,1986-12-31,540,4777,5317
15,15778,1987-12-31,515,4735,5250
15,15778,1988-12-31,518,4706,5224
15,15778,1989-12-31,561,4648,5209
15,15778,1990-12-31,581,4590,5171
15,15778,1991-12-31,588,4507,5095
15,15778,1992-12-31,602,4450,5052
15,15778,1993-12-31,580,4416,4996
15,15778,1994-12-31,605,4378,4983
15,15778,1995-12-31,585,4326,4911
15,15778,1996-12-31,593,4299,4892
15,15778,1997-12-31,592,4247,4839
15,15778,1998-12-31,599,4207,4806
15,15778,1999-12-31,605,4158,4763
15,15778,2000-12-31,654,4116,4770
15,15778,2001-12-31,658,4068,4726
15,15778,2002-12-31,664,4033,4697
15,15778,2003-12-31,672,3962,4634
15,15778,2004-12-31,695,3928,4623
15,15778,2005-12-31,687,3858,4545
15,15778,2006-12-31,681,3810,4491
15,15778,2007-12-31,678,3786,4464
15,15778,2008-12-31,677,3749,4426
15,15778,2009-12-31,681,3703,4384
15,15778,2010-12-31,689,3636,4325
15,15778,2011-12-31,695,3604,4299
15,15778,2012-12-31,697,3571,4268
15,15778,2013-12-31,696,3544,4240
15,15778,2014-12-31,695,3541,4236
15,15778,2015-12-31,697,3562,4259
15,15778,2016-12-31,703,3518,4221
15,15778,2017-12-31,708,3501,4209
15,15778,2018-12-31,732,3501,4233
15,15778,2019-12-31,739,3485,4224
15,15778,2020-12-31,748,3474,4222
15,15778,2021-12-31,798,3454,4252
15,15778,2022-12-31,844,3435,4279
15,15778,2023-12-31,889,3416,4305
15,15778,2024-12-31,912,3418,4330
15,15778,2025-12-31,926,3400,4326
15,15778,2026-12-31,932,3387,4319
15,15778,2027-12-31,944,3401,4345
15,15778,2028-12-31,942,3409,4351
15,15778,2029-12-31,954,3424,4378
15,15778,2030-12-31,968,3440,4408
15,15778,2031-12-31,976,3471,4447
15,15778,2032-12-31,983,3496,4479
15,15778,2033-12-31,990,3535,4525
15,15778,2034-12-31,998,3546,4544
15,15778,2035-12-31,994,3579,4573
15,15790,1985-12-31,1477,7414,8891
15,15790,1986-12-31,1452,7333,8785
15,15790,1987-12-31,1463,7233,8696
15,15790,1988-12-31,1481,7121,8602
15,15790,1989-12-31,1468,7037,8505
15,15790,1990-12-31,1477,6907,8384
15,15790,1991-12-31,1465,6751,8216
15,15790,1992-12-31,1475,6642,8117
15,15790,1993-12-31,1485,6531,8016
15,15790,1994-12-31,1483,6428,7911
15,15790,1995-12-31,1508,6334,7842
15,15790,1996-12-31,1543,6229,7772
15,15790,1997-12-31,1546,6117,7663
15,15790,1998-12-31,1554,6021,7575
15,15790,1999-12-31,1583,5921,7504
15,15790,2000-12-31,1569,5832,7401
15,15790,2001-12-31,1557,5733,7290
15,15790,2002-12-31,1577,5617,7194
15,15790,2003-12-31,1591,5518,7109
15,15790,2004-12-31,1606,5400,7006
15,15790,2005-12-31,1642,5299,6941
15,15790,2006-12-31,1616,5207,6823
15,15790,2007-12-31,1597,5107,6704
15,15790,2008-12-31,1575,5031,6606
15,15790,2009-12-31,1569,4919,6488
15,15790,2010-12-31,1570,4848,6418
15,15790,2011-12-31,1564,4748,6312
15,15790,2012-12-31,1567,4667,6234
15,15790,2013-12-31,1571,4564,6135
15,15790,2014-12-31,1579,4495,6074
15,15790,2015-12-31,1586,4387,5973
15,15790,2016-12-31,1594,4361,5955
15,15790,2017-12-31,1605,4376,5981
15,15790,2018-12-31,1625,4257,5882
15,15790,2019-12-31,1629,4194,5823
15,15790,2020-12-31,1641,4151,5792
15,15790,2021-12-31,1704,4129,5833
15,15790,2022-12-31,1764,4106,5870
15,15790,2023-12-31,1822,4084,5906
15,15790,2024-12-31,1848,4063,5911
15,15790,2025-12-31,1877,4071,5948
15,15790,2026-12-31,1901,4066,5967
15,15790,2027-12-31,1920,4068,5988
15,15790,2028-12-31,1932,4073,6005
15,15790,2029-12-31,1949,4090,6039
15,15790,2030-12-31,1964,4117,6081
15,15790,2031-12-31,1988,4161,6149
15,15790,2032-12-31,1987,4203,6190
15,15790,2033-12-31,2000,4218,6218
15,15790,2034-12-31,2025,4276,6301
15,15790,2035-12-31,2045,4277,6322
15,15798,1985-12-31,820,4472,5292
15,15798,1986-12-31,829,4389,5218
15,15798,1987-12-31,835,4349,5184
15,15798,1988-12-31,848,4309,5157
15,15798,1989-12-31,850,4257,5107
15,15798,1990-12-31,863,4186,5049
15,15798,1991-12-31,862,4111,4973
15,15798,1992-12-31,898,4051,4949
15,15798,1993-12-31,919,3982,4901
15,15798,1994-12-31,920,3944,4864
15,15798,1995-12-31,928,3890,4818
15,15798,1996-12-31,943,3844,4787
15,15798,1997-12-31,953,3804,4757
15,15798,1998-12-31,959,3735,4694
15,15798,1999-12-31,959,3674,4633
15,15798,2000-12-31,976,3609,4585
15,15798,2001-12-31,1012,3535,4547
15,15798,2002-12-31,996,3436,4432
15,15798,2003-12-31,1003,3394,4397
15,15798,2004-12-31,1049,3336,4385
15,15798,2005-12-31,1003,3258,4261
15,15798,2006-12-31,1025,3208,4233
15,15798,2007-12-31,1060,3143,4203
15,15798,2008-12-31,1085,3091,4176
15,15798,2009-12-31,1080,3049,4129
15,15798,2010-12-31,1083,2985,4068
15,15798,2011-12-31,1084,2952,4036
15,15798,2012-12-31,1083,2910,3993
15,15798,2013-12-31,1084,2887,3971
15,15798,2014-12-31,1086,2873,3959
15,15798,2015-12-31,1100,2869,3969
15,15798,2016-12-31,1112,2828,3940
15,15798,2017-12-31,1124,2729,3853
15,15798,2018-12-31,1127,2724,3851
15,15798,2019-12-31,1136,2692,3828
15,15798,2020-12-31,1148,2673,3821
15,15798,2021-12-31,1189,2659,3848
15,15798,2022-12-31,1228,2644,3872
15,15798,2023-12-31,1266,2630,3896
15,15798,2024-12-31,1286,2617,3903
15,15798,2025-12-31,1300,2612,3912
15,15798,2026-12-31,1318,2612,3930
15,15798,2027-12-31,1334,2612,3946
15,15798,2028-12-31,1347,2622,3969
15,15798,2029-12-31,1354,2636,3990
15,15798,2030-12-31,1372,2647,4019
15,15798,2031-12-31,1375,2663,4038
15,15798,2032-12-31,1388,2694,4082
15,15798,2033-12-31,1399,2700,4099
15,15798,2034-12-31,1408,2733,4141
15,15798,2035-12-31,1416,2751,4167
15,15804,1985-12-31,1141,9640,10781
15,15804,1986-12-31,1155,9574,10729
15,15804,1987-12-31,1156,9494,10650
15,15804,1988-12-31,1173,9407,10580
15,15804,1989-12-31,1196,9284,10480
15,15804,1990-12-31,1237,9209,10446
15,15804,1991-12-31,1219,9081,10300
15,15804,1992-12-31,1268,8982,10250
15,15804,1993-12-31,1280,8907,10187
15,15804,1994-12-31,1313,8832,10145
15,15804,1995-12-31,1347,8764,10111
15,15804,1996-12-31,1361,8671,10032
15,15804,1997-12-31,1402,8580,9982
15,15804,1998-12-31,1430,8498,9928
15,15804,1999-12-31,1438,8393,9831
15,15804,2000-12-31,1454,8305,9759
15,15804,2001-12-31,1454,8232,9686
15,15804,2002-12-31,1476,8150,9626
15,15804,2003-12-31,1484,8072,9556
15,15804,2004-12-31,1505,7991,9496
15,15804,2005-12-31,1531,7916,9447
15,15804,2006-12-31,1555,7846,9401
15,15804,2007-12-31,1571,7776,9347
15,15804,2008-12-31,1566,7701,9267
15,15804,2009-12-31,1572,7612,9184
15,15804,2010-12-31,1568,7578,9146
15,15804,2011-12-31,1575,7533,9108
15,15804,2012-12-31,1599,7461,9060
15,15804,2013-12-31,1622,7411,9033
15,15804,2014-12-31,1640,7404,9044
15,15804,2015-12-31,1664,7333,8997
15,15804,2016-12-31,1683,7308,8991
15,15804,2017-12-31,1709,7282,8991
15,15804,2018-12-31,1729,7322,9051
15,15804,2019-12-31,1749,7336,9085
15,15804,2020-12-31,1770,7349,9119
15,15804,2021-12-31,1872,7312,9184
15,15804,2022-12-31,1970,7272,9242
15,15804,2023-12-31,2066,7233,9299
15,15804,2024-12-31,2105,7206,9311
15,15804,2025-12-31,2137,7189,9326
15,15804,2026-12-31,2167,7196,9363
15,15804,2027-12-31,2184,7200,9384
15,15804,2028-12-31,2202,7219,9421
15,15804,2029-12-31,2223,7248,9471
15,15804,2030-12-31,2244,7293,9537
15,15804,2031-12-31,2263,7371,9634
15,15804,2032-12-31,2286,7408,9694
15,15804,2033-12-31,2301,7472,9773
15,15804,2034-12-31,2307,7513,9820
15,15804,2035-12-31,2321,7585,9906
15,15806,1985-12-31,2101,5281,7382
15,15806,1986-12-31,2169,5387,7556
15,15806,1987-12-31,2207,5492,7699
15,15806,1988-12-31,2267,5591,7858
15,15806,1989-12-31,2326,5700,8026
15,15806,1990-12-31,2389,5816,8205
15,15806,1991-12-31,2442,5867,8309
15,15806,1992-12-31,2506,5948,8454
15,15806,1993-12-31,2566,6037,8603
15,15806,1994-12-31,2630,6131,8761
15,15806,1995-12-31,2720,6208,8928
15,15806,1996-12-31,2757,6300,9057
15,15806,1997-12-31,2829,6386,9215
15,15806,1998-12-31,2910,6491,9401
15,15806,1999-12-31,2995,6587,9582
15,15806,2000-12-31,3096,6695,9791
15,15806,2001-12-31,3195,6791,9986
15,15806,2002-12-31,3270,6871,10141
15,15806,2003-12-31,3321,6956,10277
15,15806,2004-12-31,3382,7048,10430
15,15806,2005-12-31,3451,7124,10575
15,15806,2006-12-31,3514,7233,10747
15,15806,2007-12-31,3568,7319,10887
15,15806,2008-12-31,3617,7412,11029
15,15806,2009-12-31,3697,7515,11212
15,15806,2010-12-31,3769,7626,11395
15,15806,2011-12-31,3815,7723,11538
15,15806,2012-12-31,3858,7835,11693
15,15806,2013-12-31,3919,7956,11875
15,15806,2014-12-31,4045,8082,12127
15,15806,2015-12-31,4092,8233,12325
15,15806,2016-12-31,4141,8358,12499
15,15806,2017-12-31,4186,8494,12680
15,15806,2018-12-31,4238,8702,12940
15,15806,2019-12-31,4332,8864,13196
15,15806,2020-12-31,4418,8978,13396
15,15806,2021-12-31,4561,8932,13493
15,15806,2022-12-31,4696,8883,13579
15,15806,2023-12-31,4827,8836,13663
15,15806,2024-12-31,4923,8802,13725
15,15806,2025-12-31,4985,8783,13768
15,15806,2026-12-31,5038,8783,13821
15,15806,2027-12-31,5098,8789,13887
15,15806,2028-12-31,5153,8824,13977
15,15806,2029-12-31,5189,8857,14046
15,15806,2030-12-31,5241,8930,14171
15,15806,2031-12-31,5271,8989,14260
15,15806,2032-12-31,5301,9064,14365
15,15806,2033-12-31,5345,9117,14462
15,15806,2034-12-31,5386,9198,14584
15,15806,2035-12-31,5411,9271,14682
15,15808,1985-12-31,248,2118,2366
15,15808,1986-12-31,229,2127,2356
15,15808,1987-12-31,234,2165,2399
15,15808,1988-12-31,268,2178,2446
15,15808,1989-12-31,367,2196,2563
15,15808,1990-12-31,360,2195,2555
15,15808,1991-12-31,367,2205,2572
15,15808,1992-12-31,356,2205,2561
15,15808,1993-12-31,366,2220,2586
15,15808,1994-12-31,392,2234,2626
15,15808,1995-12-31,444,2273,2717
15,15808,1996-12-31,455,2244,2699
15,15808,1997-12-31,469,2289,2758
15,15808,1998-12-31,448,2321,2769
15,15808,1999-12-31,492,2349,2841
15,15808,2000-12-31,491,2340,2831
15,15808,2001-12-31,495,2356,2851
15,15808,2002-12-31,496,2357,2853
15,15808,2003-12-31,504,2355,2859
15,15808,2004-12-31,511,2310,2821
15,15808,2005-12-31,525,2329,2854
15,15808,2006-12-31,579,2356,2935
15,15808,2007-12-31,607,2345,2952
15,15808,2008-12-31,550,2336,2886
15,15808,2009-12-31,556,2340,2896
15,15808,2010-12-31,582,2359,2941
15,15808,2011-12-31,603,2422,3025
15,15808,2012-12-31,630,2453,3083
15,15808,2013-12-31,653,2497,3150
15,15808,2014-12-31,674,2514,3188
15,15808,2015-12-31,694,2520,3214
15,15808,2016-12-31,709,2517,3226
15,15808,2017-12-31,714,2524,3238
15,15808,2018-12-31,737,2529,3266
15,15808,2019-12-31,759,2554,3313
15,15808,2020-12-31,778,2573,3351
15,15808,2021-12-31,815,2560,3375
15,15808,2022-12-31,851,2546,3397
15,15808,2023-12-31,886,2532,3418
15,15808,2024-12-31,902,2526,3428
15,15808,2025-12-31,919,2519,3438
15,15808,2026-12-31,936,2520,3456
15,15808,2027-12-31,946,2520,3466
15,15808,2028-12-31,954,2528,3482
15,15808,2029-12-31,965,2540,3505
15,15808,2030-12-31,970,2562,3532
15,15808,2031-12-31,977,2569,3546
15,15808,2032-12-31,987,2594,3581
15,15808,2033-12-31,993,2607,3600
15,15808,2034-12-31,1001,2630,3631
15,15808,2035-12-31,1001,2656,3657
15,15810,1985-12-31,821,4212,5033
15,15810,1986-12-31,819,4183,5002
15,15810,1987-12-31,831,4136,4967
15,15810,1988-12-31,839,4080,4919
15,15810,1989-12-31,828,4013,4841
15,15810,1990-12-31,844,3960,4804
15,15810,1991-12-31,861,3890,4751
15,15810,1992-12-31,852,3832,4684
15,15810,1993-12-31,852,3767,4619
15,15810,1994-12-31,848,3724,4572
15,15810,1995-12-31,866,3647,4513
15,15810,1996-12-31,875,3597,4472
15,15810,1997-12-31,876,3531,4407
15,15810,1998-12-31,873,3478,4351
15,15810,1999-12-31,891,3408,4299
15,15810,2000-12-31,886,3323,4209
15,15810,2001-12-31,885,3252,4137
15,15810,2002-12-31,876,3188,4064
15,15810,2003-12-31,879,3137,4016
15,15810,2004-12-31,871,3080,3951
15,15810,2005-12-31,870,2995,3865
15,15810,2006-12-31,872,2929,3801
15,15810,2007-12-31,874,2867,3741
15,15810,2008-12-31,876,2809,3685
15,15810,2009-12-31,887,2766,3653
15,15810,2010-12-31,888,2733,3621
15,15810,2011-12-31,878,2704,3582
15,15810,2012-12-31,888,2648,3536
15,15810,2013-12-31,878,2595,3473
15,15810,2014-12-31,890,2592,3482
15,15810,2015-12-31,907,2553,3460
15,15810,2016-12-31,916,2530,3446
15,15810,2017-12-31,927,2393,3320
15,15810,2018-12-31,937,2386,3323
15,15810,2019-12-31,939,2360,3299
15,15810,2020-12-31,945,2345,3290
15,15810,2021-12-31,980,2333,3313
15,15810,2022-12-31,1014,2320,3334
15,15810,2023-12-31,1048,2307,3355
15,15810,2024-12-31,1064,2294,3358
15,15810,2025-12-31,1078,2290,3368
15,15810,2026-12-31,1078,2295,3373
15,15810,2027-12-31,1095,2293,3388
15,15810,2028-12-31,1101,2299,3400
15,15810,2029-12-31,1115,2316,3431
15,15810,2030-12-31,1131,2329,3460
15,15810,2031-12-31,1140,2351,3491
15,15810,2032-12-31,1145,2358,3503
15,15810,2033-12-31,1150,2380,3530
15,15810,2034-12-31,1158,2398,3556
15,15810,2035-12-31,1171,2409,3580
15,15814,1985-12-31,2016,6500,8516
15,15814,1986-12-31,2063,6491,8554
15,15814,1987-12-31,2109,6422,8531
15,15814,1988-12-31,2164,6342,8506
15,15814,1989-12-31,2216,6296,8512
15,15814,1990-12-31,2277,6239,8516
15,15814,1991-12-31,2341,6134,8475
15,15814,1992-12-31,2417,6053,8470
15,15814,1993-12-31,2468,5986,8454
15,15814,1994-12-31,2503,5929,8432
15,15814,1995-12-31,2570,5861,8431
15,15814,1996-12-31,2676,5796,8472
15,15814,1997-12-31,2748,5703,8451
15,15814,1998-12-31,2838,5612,8450
15,15814,1999-12-31,2945,5566,8511
15,15814,2000-12-31,3039,5476,8515
15,15814,2001-12-31,3124,5421,8545
15,15814,2002-12-31,3191,5343,8534
15,15814,2003-12-31,3266,5288,8554
15,15814,2004-12-31,3323,5208,8531
15,15814,2005-12-31,3389,5148,8537
15,15814,2006-12-31,3448,5083,8531
15,15814,2007-12-31,3513,5014,8527
15,15814,2008-12-31,3564,4951,8515
15,15814,2009-12-31,3643,4888,8531
15,15814,2010-12-31,3701,4845,8546
15,15814,2011-12-31,3740,4789,8529
15,15814,2012-12-31,3795,4747,8542
15,15814,2013-12-31,3877,4707,8584
15,15814,2014-12-31,3941,4652,8593
15,15814,2015-12-31,4014,4610,8624
15,15814,2016-12-31,4075,4579,8654
15,15814,2017-12-31,4141,4579,8720
15,15814,2018-12-31,4209,4558,8767
15,15814,2019-12-31,4298,4533,8831
15,15814,2020-12-31,4380,4513,8893
15,15814,2021-12-31,4467,4489,8956
15,15814,2022-12-31,4548,4465,9013
15,15814,2023-12-31,4627,4441,9068
15,15814,2024-12-31,4693,4427,9120
15,15814,2025-12-31,4755,4415,9170
15,15814,2026-12-31,4805,4408,9213
15,15814,2027-12-31,4860,4430,9290
15,15814,2028-12-31,4908,4431,9339
15,15814,2029-12-31,4951,4468,9419
15,15814,2030-12-31,4995,4492,9487
15,15814,2031-12-31,5031,4522,9553
15,15814,2032-12-31,5069,4549,9618
15,15814,2033-12-31,5104,4588,9692
15,15814,2034-12-31,5132,4629,9761
15,15814,2035-12-31,5163,4658,9821
15,15816,1985-12-31,558,4965,5523
15,15816,1986-12-31,591,4935,5526
15,15816,1987-12-31,583,4891,5474
15,15816,1988-12-31,582,4858,5440
15,15816,1989-12-31,592,4815,5407
15,15816,1990-12-31,554,4783,5337
15,15816,1991-12-31,569,4714,5283
15,15816,1992-12-31,570,4677,5247
15,15816,1993-12-31,619,4630,5249
15,15816,1994-12-31,556,4593,5149
15,15816,1995-12-31,559,4554,5113
15,15816,1996-12-31,578,4513,5091
15,15816,1997-12-31,590,4488,5078
15,15816,1998-12-31,594,4397,4991
15,15816,1999-12-31,601,4357,4958
15,15816,2000-12-31,623,4300,4923
15,15816,2001-12-31,637,4281,4918
15,15816,2002-12-31,637,4226,4863
15,15816,2003-12-31,649,4192,4841
15,15816,2004-12-31,619,4135,4754
15,15816,2005-12-31,620,4052,4672
15,15816,2006-12-31,645,3985,4630
15,15816,2007-12-31,629,3954,4583
15,15816,2008-12-31,623,3929,4552
15,15816,2009-12-31,617,3902,4519
15,15816,2010-12-31,608,3873,4481
15,15816,2011-12-31,601,3847,4448
15,15816,2012-12-31,600,3814,4414
15,15816,2013-12-31,604,3789,4393
15,15816,2014-12-31,608,3734,4342
15,15816,2015-12-31,607,3724,4331
15,15816,2016-12-31,610,3708,4318
15,15816,2017-12-31,612,3723,4335
15,15816,2018-12-31,617,3718,4335
15,15816,2019-12-31,620,3710,4330
15,15816,2020-12-31,625,3710,4335
15,15816,2021-12-31,675,3691,4366
15,15816,2022-12-31,722,3671,4393
15,15816,2023-12-31,769,3651,4420
15,15816,2024-12-31,790,3638,4428
15,15816,2025-12-31,802,3635,4437
15,15816,2026-12-31,812,3636,4448
15,15816,2027-12-31,820,3644,4464
15,15816,2028-12-31,828,3638,4466
15,15816,2029-12-31,835,3666,4501
15,15816,2030-12-31,835,3694,4529
15,15816,2031-12-31,845,3727,4572
15,15816,2032-12-31,852,3751,4603
15,15816,2033-12-31,856,3785,4641
15,15816,2034-12-31,854,3804,4658
15,15816,2035-12-31,862,3825,4687
15,15820,1985-12-31,934,2611,3545
15,15820,1986-12-31,966,2645,3611
15,15820,1987-12-31,945,2620,3565
15,15820,1988-12-31,928,2591,3519
15,15820,1989-12-31,976,2631,3607
15,15820,1990-12-31,993,2602,3595
15,15820,1991-12-31,1001,2614,3615
15,15820,1992-12-31,979,2609,3588
15,15820,1993-12-31,1000,2587,3587
15,15820,1994-12-31,1007,2587,3594
15,15820,1995-12-31,1021,2595,3616
15,15820,1996-12-31,1029,2591,3620
15,15820,1997-12-31,994,2596,3590
15,15820,1998-12-31,996,2593,3589
15,15820,1999-12-31,1043,2584,3627
15,15820,2000-12-31,1024,2590,3614
15,15820,2001-12-31,1059,2579,3638
15,15820,2002-12-31,1045,2564,3609
15,15820,2003-12-31,1019,2569,3588
15,15820,2004-12-31,1029,2547,3576
15,15820,2005-12-31,1019,2539,3558
15,15820,2006-12-31,1027,2516,3543
15,15820,2007-12-31,1081,2515,3596
15,15820,2008-12-31,1069,2489,3558
15,15820,2009-12-31,1057,2508,3565
15,15820,2010-12-31,1047,2495,3542
15,15820,2011-12-31,1043,2483,3526
15,15820,2012-12-31,1034,2495,3529
15,15820,2013-12-31,1029,2508,3537
15,15820,2014-12-31,1029,2517,3546
15,15820,2015-12-31,1030,2524,3554
15,15820,2016-12-31,1034,2555,3589
15,15820,2017-12-31,1044,2557,3601
15,15820,2018-12-31,1054,2563,3617
15,15820,2019-12-31,1073,2587,3660
15,15820,2020-12-31,1091,2606,3697
15,15820,2021-12-31,1131,2593,3724
15,15820,2022-12-31,1168,2579,3747
15,15820,2023-12-31,1206,2565,3771
15,15820,2024-12-31,1228,2547,3775
15,15820,2025-12-31,1238,2549,3787
15,15820,2026-12-31,1250,2548,3798
15,15820,2027-12-31,1267,2554,3821
15,15820,2028-12-31,1276,2559,3835
15,15820,2029-12-31,1296,2563,3859
15,15820,2030-12-31,1308,2586,3894
15,15820,2031-12-31,1318,2597,3915
15,15820,2032-12-31,1325,2638,3963
15,15820,2033-12-31,1334,2653,3987
15,15820,2034-12-31,1343,2672,4015
15,15820,2035-12-31,1355,2688,4043
15,15822,1985-12-31,732,4752,5484
15,15822,1986-12-31,777,4704,5481
15,15822,1987-12-31,721,4707,5428
15,15822,1988-12-31,794,4684,5478
15,15822,1989-12-31,802,4682,5484
15,15822,1990-12-31,753,4655,5408
15,15822,1991-12-31,819,4624,5443
15,15822,1992-12-31,793,4604,5397
15,15822,1993-12-31,776,4592,5368
15,15822,1994-12-31,822,4615,5437
15,15822,1995-12-31,790,4575,5365
15,15822,1996-12-31,799,4561,5360
15,15822,1997-12-31,796,4561,5357
15,15822,1998-12-31,798,4519,5317
15,15822,1999-12-31,828,4496,5324
15,15822,2000-12-31,845,4473,5318
15,15822,2001-12-31,847,4452,5299
15,15822,2002-12-31,766,4432,5198
15,15822,2003-12-31,778,4396,5174
15,15822,2004-12-31,788,4366,5154
15,15822,2005-12-31,871,4335,5206
15,15822,2006-12-31,825,4307,5132
15,15822,2007-12-31,826,4282,5108
15,15822,2008-12-31,849,4284,5133
15,15822,2009-12-31,838,4279,5117
15,15822,2010-12-31,855,4265,5120
15,15822,2011-12-31,847,4281,5128
15,15822,2012-12-31,828,4289,5117
15,15822,2013-12-31,838,4282,5120
15,15822,2014-12-31,807,4260,5067
15,15822,2015-12-31,810,4252,5062
15,15822,2016-12-31,823,4298,5121
15,15822,2017-12-31,835,4334,5169
15,15822,2018-12-31,854,4325,5179
15,15822,2019-12-31,872,4334,5206
15,15822,2020-12-31,889,4344,5233
15,15822,2021-12-31,948,4322,5270
15,15822,2022-12-31,1005,4298,5303
15,15822,2023-12-31,1061,4275,5336
15,15822,2024-12-31,1080,4260,5340
15,15822,2025-12-31,1098,4254,5352
15,15822,2026-12-31,1110,4255,5365
15,15822,2027-12-31,1121,4257,5378
15,15822,2028-12-31,1142,4276,5418
15,15822,2029-12-31,1154,4302,5456
15,15822,2030-12-31,1160,4318,5478
15,15822,2031-12-31,1167,4356,5523
15,15822,2032-12-31,1180,4391,5571
15,15822,2033-12-31,1185,4433,5618
15,15822,2034-12-31,1193,4463,5656
15,15822,2035-12-31,1203,4500,5703
15,15832,1985-12-31,77,1565,1642
15,15832,1986-12-31,136,1586,1722
15,15832,1987-12-31,108,1566,1674
15,15832,1988-12-31,124,1538,1662
15,15832,1989-12-31,120,1595,1715
15,15832,1990-12-31,120,1536,1656
15,15832,1991-12-31,120,1538,1658
15,15832,1992-12-31,150,1498,1648
15,15832,1993-12-31,150,1491,1641
15,15832,1994-12-31,103,1499,1602
15,15832,1995-12-31,172,1484,1656
15,15832,1996-12-31,174,1493,1667
15,15832,1997-12-31,194,1454,1648
15,15832,1998-12-31,199,1448,1647
15,15832,1999-12-31,167,1442,1609
15,15832,2000-12-31,186,1441,1627
15,15832,2001-12-31,199,1461,1660
15,15832,2002-12-31,210,1440,1650
15,15832,2003-12-31,214,1429,1643
15,15832,2004-12-31,214,1426,1640
15,15832,2005-12-31,209,1379,1588
15,15832,2006-12-31,213,1372,1585
15,15832,2007-12-31,201,1364,1565
15,15832,2008-12-31,234,1346,1580
15,15832,2009-12-31,229,1332,1561
15,15832,2010-12-31,226,1317,1543
15,15832,2011-12-31,260,1308,1568
15,15832,2012-12-31,247,1300,1547
15,15832,2013-12-31,249,1294,1543
15,15832,2014-12-31,254,1287,1541
15,15832,2015-12-31,255,1285,1540
15,15832,2016-12-31,255,1286,1541
15,15832,2017-12-31,254,1286,1540
15,15832,2018-12-31,256,1284,1540
15,15832,2019-12-31,263,1296,1559
15,15832,2020-12-31,270,1306,1576
15,15832,2021-12-31,288,1299,1587
15,15832,2022-12-31,306,1292,1598
15,15832,2023-12-31,322,1285,1607
15,15832,2024-12-31,327,1283,1610
15,15832,2025-12-31,331,1276,1607
15,15832,2026-12-31,333,1277,1610
15,15832,2027-12-31,334,1277,1611
15,15832,2028-12-31,339,1279,1618
15,15832,2029-12-31,344,1288,1632
15,15832,2030-12-31,344,1290,1634
15,15832,2031-12-31,345,1306,1651
15,15832,2032-12-31,349,1317,1666
15,15832,2033-12-31,352,1325,1677
15,15832,2034-12-31,353,1340,1693
15,15832,2035-12-31,355,1346,1701
15,15835,1985-12-31,1676,5832,7508
15,15835,1986-12-31,1672,5761,7433
15,15835,1987-12-31,1681,5710,7391
15,15835,1988-12-31,1681,5666,7347
15,15835,1989-12-31,1687,5603,7290
15,15835,1990-12-31,1701,5569,7270
15,15835,1991-12-31,1709,5439,7148
15,15835,1992-12-31,1722,5375,7097
15,15835,1993-12-31,1748,5303,7051
15,15835,1994-12-31,1755,5241,6996
15,15835,1995-12-31,1748,5182,6930
15,15835,1996-12-31,1798,5138,6936
15,15835,1997-12-31,1852,5071,6923
15,15835,1998-12-31,1902,5010,6912
15,15835,1999-12-31,1933,4949,6882
15,15835,2000-12-31,1945,4887,6832
15,15835,2001-12-31,1938,4824,6762
15,15835,2002-12-31,1924,4771,6695
15,15835,2003-12-31,1941,4694,6635
15,15835,2004-12-31,1944,4690,6634
15,15835,2005-12-31,1956,4614,6570
15,15835,2006-12-31,1964,4517,6481
15,15835,2007-12-31,1963,4445,6408
15,15835,2008-12-31,1985,4413,6398
15,15835,2009-12-31,2023,4343,6366
15,15835,2010-12-31,2032,4285,6317
15,15835,2011-12-31,2024,4236,6260
15,15835,2012-12-31,2013,4191,6204
15,15835,2013-12-31,2016,4136,6152
15,15835,2014-12-31,2019,4111,6130
15,15835,2015-12-31,2028,4094,6122
15,15835,2016-12-31,2033,4086,6119
15,15835,2017-12-31,2049,4048,6097
15,15835,2018-12-31,2072,4046,6118
15,15835,2019-12-31,2091,4040,6131
15,15835,2020-12-31,2114,4042,6156
15,15835,2021-12-31,2179,4021,6200
15,15835,2022-12-31,2240,3999,6239
15,15835,2023-12-31,2299,3978,6277
15,15835,2024-12-31,2334,3962,6296
15,15835,2025-12-31,2365,3950,6315
15,15835,2026-12-31,2387,3958,6345
15,15835,2027-12-31,2413,3955,6368
15,15835,2028-12-31,2443,3974,6417
15,15835,2029-12-31,2466,3981,6447
15,15835,2030-12-31,2482,4014,6496
15,15835,2031-12-31,2502,4029,6531
15,15835,2032-12-31,2514,4070,6584
15,15835,2033-12-31,2535,4102,6637
15,15835,2034-12-31,2550,4131,6681
15,15835,2035-12-31,2567,4155,6722
15,15837,1985-12-31,1045,6093,7138
15,15837,1986-12-31,1087,6101,7188
15,15837,1987-12-31,1143,6100,7243
15,15837,1988-12-31,1173,6088,7261
15,15837,1989-12-31,1207,6067,7274
15,15837,1990-12-31,1245,6045,7290
15,15837,1991-12-31,1279,5991,7270
15,15837,1992-12-31,1317,5981,7298
15,15837,1993-12-31,1345,5961,7306
15,15837,1994-12-31,1383,5966,7349
15,15837,1995-12-31,1430,5960,7390
15,15837,1996-12-31,1481,5928,7409
15,15837,1997-12-31,1511,5914,7425
15,15837,1998-12-31,1548,5906,7454
15,15837,1999-12-31,1659,5891,7550
15,15837,2000-12-31,1692,5879,7571
15,15837,2001-12-31,1743,5864,7607
15,15837,2002-12-31,1755,5844,7599
15,15837,2003-12-31,1779,5815,7594
15,15837,2004-12-31,1813,5803,7616
15,15837,2005-12-31,1862,5821,7683
15,15837,2006-12-31,1895,5804,7699
15,15837,2007-12-31,1928,5779,7707
15,15837,2008-12-31,1964,5774,7738
15,15837,2009-12-31,1993,5803,7796
15,15837,2010-12-31,2036,5776,7812
15,15837,2011-12-31,2078,5783,7861
15,15837,2012-12-31,2153,5779,7932
15,15837,2013-12-31,2185,5822,8007
15,15837,2014-12-31,2205,5819,8024
15,15837,2015-12-31,2237,5817,8054
15,15837,2016-12-31,2264,5816,8080
15,15837,2017-12-31,2291,5949,8240
15,15837,2018-12-31,2320,5946,8266
15,15837,2019-12-31,2394,5975,8369
15,15837,2020-12-31,2459,6002,8461
15,15837,2021-12-31,2551,5972,8523
15,15837,2022-12-31,2638,5939,8577
15,15837,2023-12-31,2722,5907,8629
15,15837,2024-12-31,2785,5894,8679
15,15837,2025-12-31,2834,5869,8703
15,15837,2026-12-31,2872,5857,8729
15,15837,2027-12-31,2912,5866,8778
15,15837,2028-12-31,2943,5893,8836
15,15837,2029-12-31,2973,5921,8894
15,15837,2030-12-31,2988,5962,8950
15,15837,2031-12-31,3012,6006,9018
15,15837,2032-12-31,3041,6049,9090
15,15837,2033-12-31,3061,6095,9156
15,15837,2034-12-31,3076,6138,9214
15,15837,2035-12-31,3105,6189,9294
15,15839,1985-12-31,136,2308,2444
15,15839,1986-12-31,78,2294,2372
15,15839,1987-12-31,86,2282,2368
15,15839,1988-12-31,83,2274,2357
15,15839,1989-12-31,86,2259,2345
15,15839,1990-12-31,124,2248,2372
15,15839,1991-12-31,130,2230,2360
15,15839,1992-12-31,132,2214,2346
15,15839,1993-12-31,132,2192,2324
15,15839,1994-12-31,122,2186,2308
15,15839,1995-12-31,160,2169,2329
15,15839,1996-12-31,161,2151,2312
15,15839,1997-12-31,161,2135,2296
15,15839,1998-12-31,158,2123,2281
15,15839,1999-12-31,161,2132,2293
15,15839,2000-12-31,161,2119,2280
15,15839,2001-12-31,165,2086,2251
15,15839,2002-12-31,165,2086,2251
15,15839,2003-12-31,165,2061,2226
15,15839,2004-12-31,165,2040,2205
15,15839,2005-12-31,157,2023,2180
15,15839,2006-12-31,152,1998,2150
15,15839,2007-12-31,147,1986,2133
15,15839,2008-12-31,191,1982,2173
15,15839,2009-12-31,185,1957,2142
15,15839,2010-12-31,183,1934,2117
15,15839,2011-12-31,170,1927,2097
15,15839,2012-12-31,167,1933,2100
15,15839,2013-12-31,170,1896,2066
15,15839,2014-12-31,167,1887,2054
15,15839,2015-12-31,167,1879,2046
15,15839,2016-12-31,167,1871,2038
15,15839,2017-12-31,165,1865,2030
15,15839,2018-12-31,169,1871,2040
15,15839,2019-12-31,171,1866,2037
15,15839,2020-12-31,173,1866,2039
15,15839,2021-12-31,196,1857,2053
15,15839,2022-12-31,220,1846,2066
15,15839,2023-12-31,243,1836,2079
15,15839,2024-12-31,238,1831,2069
15,15839,2025-12-31,244,1829,2073
15,15839,2026-12-31,246,1821,2067
15,15839,2027-12-31,249,1824,2073
15,15839,2028-12-31,253,1831,2084
15,15839,2029-12-31,256,1841,2097
15,15839,2030-12-31,259,1854,2113
15,15839,2031-12-31,262,1873,2135
15,15839,2032-12-31,269,1882,2151
15,15839,2033-12-31,280,1894,2174
15,15839,2034-12-31,283,1920,2203
15,15839,2035-12-31,286,1926,2212
15,15842,1985-12-31,683,8513,9196
15,15842,1986-12-31,687,8452,9139
15,15842,1987-12-31,694,8388,9082
15,15842,1988-12-31,715,8324,9039
15,15842,1989-12-31,713,8256,8969
15,15842,1990-12-31,720,8144,8864
15,15842,1991-12-31,733,8027,8760
15,15842,1992-12-31,748,7963,8711
15,15842,1993-12-31,755,7887,8642
15,15842,1994-12-31,829,7827,8656
15,15842,1995-12-31,835,7760,8595
15,15842,1996-12-31,817,7673,8490
15,15842,1997-12-31,821,7609,8430
15,15842,1998-12-31,837,7538,8375
15,15842,1999-12-31,834,7466,8300
15,15842,2000-12-31,861,7405,8266
15,15842,2001-12-31,850,7336,8186
15,15842,2002-12-31,879,7274,8153
15,15842,2003-12-31,884,7198,8082
15,15842,2004-12-31,889,7108,7997
15,15842,2005-12-31,904,7032,7936
15,15842,2006-12-31,908,6973,7881
15,15842,2007-12-31,920,6918,7838
15,15842,2008-12-31,933,6846,7779
15,15842,2009-12-31,936,6804,7740
15,15842,2010-12-31,938,6772,7710
15,15842,2011-12-31,960,6733,7693
15,15842,2012-12-31,967,6641,7608
15,15842,2013-12-31,994,6577,7571
15,15842,2014-12-31,1020,6542,7562
15,15842,2015-12-31,1025,6492,7517
15,15842,2016-12-31,1018,6424,7442
15,15842,2017-12-31,1018,6516,7534
15,15842,2018-12-31,1019,6511,7530
15,15842,2019-12-31,1041,6493,7534
15,15842,2020-12-31,1060,6492,7552
15,15842,2021-12-31,1146,6459,7605
15,15842,2022-12-31,1230,6424,7654
15,15842,2023-12-31,1312,6389,7701
15,15842,2024-12-31,1348,6363,7711
15,15842,2025-12-31,1370,6344,7714
15,15842,2026-12-31,1382,6359,7741
15,15842,2027-12-31,1397,6347,7744
15,15842,2028-12-31,1421,6364,7785
15,15842,2029-12-31,1435,6399,7834
15,15842,2030-12-31,1442,6456,7898
15,15842,2031-12-31,1452,6510,7962
15,15842,2032-12-31,1460,6554,8014
15,15842,2033-12-31,1464,6588,8052
15,15842,2034-12-31,1472,6641,8113
15,15842,2035-12-31,1484,6693,8177
15,15861,1985-12-31,855,11093,11948
15,15861,1986-12-31,886,11136,12022
15,15861,1987-12-31,931,11206,12137
15,15861,1988-12-31,963,11271,12234
15,15861,1989-12-31,1031,11278,12309
15,15861,1990-12-31,1077,11320,12397
15,15861,1991-12-31,1116,11337,12453
15,15861,1992-12-31,1142,11397,12539
15,15861,1993-12-31,1186,11469,12655
15,15861,1994-12-31,1254,11498,12752
15,15861,1995-12-31,1313,11549,12862
15,15861,1996-12-31,1337,11588,12925
15,15861,1997-12-31,1406,11644,13050
15,15861,1998-12-31,1451,11717,13168
15,15861,1999-12-31,1499,11767,13266
15,15861,2000-12-31,1591,11820,13411
15,15861,2001-12-31,1636,11880,13516
15,15861,2002-12-31,1654,11914,13568
15,15861,2003-12-31,1711,11942,13653
15,15861,2004-12-31,1735,11988,13723
15,15861,2005-12-31,1804,12035,13839
15,15861,2006-12-31,1822,12081,13903
15,15861,2007-12-31,1867,12126,13993
15,15861,2008-12-31,1910,12208,14118
15,15861,2009-12-31,1953,12300,14253
15,15861,2010-12-31,1995,12364,14359
15,15861,2011-12-31,2048,12455,14503
15,15861,2012-12-31,2115,12546,14661
15,15861,2013-12-31,2165,12631,14796
15,15861,2014-12-31,2213,12744,14957
15,15861,2015-12-31,2241,12864,15105
15,15861,2016-12-31,2274,12996,15270
15,15861,2017-12-31,2311,13171,15482
15,15861,2018-12-31,2345,13361,15706
15,15861,2019-12-31,2417,13503,15920
15,15861,2020-12-31,2479,13614,16093
15,15861,2021-12-31,2665,13545,16210
15,15861,2022-12-31,2842,13471,16313
15,15861,2023-12-31,3015,13398,16413
15,15861,2024-12-31,3102,13356,16458
15,15861,2025-12-31,3153,13328,16481
15,15861,2026-12-31,3200,13328,16528
15,15861,2027-12-31,3236,13355,16591
15,15861,2028-12-31,3264,13385,16649
15,15861,2029-12-31,3303,13450,16753
15,15861,2030-12-31,3321,13534,16855
15,15861,2031-12-31,3349,13638,16987
15,15861,2032-12-31,3379,13746,17125
15,15861,2033-12-31,3401,13853,17254
15,15861,2034-12-31,3423,13958,17381
15,15861,2035-12-31,3443,14061,17504
15,15879,1985-12-31,450,3610,4060
15,15879,1986-12-31,437,3607,4044
15,15879,1987-12-31,446,3558,4004
15,15879,1988-12-31,434,3527,3961
15,15879,1989-12-31,507,3479,3986
15,15879,1990-12-31,442,3432,3874
15,15879,1991-12-31,475,3385,3860
15,15879,1992-12-31,456,3358,3814
15,15879,1993-12-31,479,3326,3805
15,15879,1994-12-31,418,3260,3678
15,15879,1995-12-31,483,3245,3728
15,15879,1996-12-31,423,3200,3623
15,15879,1997-12-31,423,3183,3606
15,15879,1998-12-31,468,3130,3598
15,15879,1999-12-31,409,3066,3475
15,15879,2000-12-31,463,3040,3503
15,15879,2001-12-31,447,2982,3429
15,15879,2002-12-31,456,2951,3407
15,15879,2003-12-31,459,2918,3377
15,15879,2004-12-31,462,2864,3326
15,15879,2005-12-31,418,2822,3240
15,15879,2006-12-31,418,2733,3151
15,15879,2007-12-31,428,2673,3101
15,15879,2008-12-31,433,2638,3071
15,15879,2009-12-31,441,2656,3097
15,15879,2010-12-31,388,2628,3016
15,15879,2011-12-31,401,2592,2993
15,15879,2012-12-31,388,2568,2956
15,15879,2013-12-31,405,2549,2954
15,15879,2014-12-31,408,2524,2932
15,15879,2015-12-31,414,2479,2893
15,15879,2016-12-31,416,2442,2858
15,15879,2017-12-31,417,2413,2830
15,15879,2018-12-31,426,2411,2837
15,15879,2019-12-31,423,2394,2817
15,15879,2020-12-31,422,2387,2809
15,15879,2021-12-31,456,2373,2829
15,15879,2022-12-31,488,2359,2847
15,15879,2023-12-31,517,2347,2864
15,15879,2024-12-31,524,2338,2862
15,15879,2025-12-31,529,2337,2866
15,15879,2026-12-31,540,2335,2875
15,15879,2027-12-31,545,2332,2877
15,15879,2028-12-31,552,2343,2895
15,15879,2029-12-31,555,2347,2902
15,15879,2030-12-31,558,2371,2929
15,15879,2031-12-31,557,2380,2937
15,15879,2032-12-31,561,2403,2964
15,15879,2033-12-31,561,2418,2979
15,15879,2034-12-31,564,2439,3003
15,15879,2035-12-31,567,2458,3025
15,15897,1985-12-31,645,5164,5809
15,15897,1986-12-31,664,5142,5806
15,15897,1987-12-31,665,5081,5746
15,15897,1988-12-31,666,5020,5686
15,15897,1989-12-31,686,4965,5651
15,15897,1990-12-31,693,4935,5628
15,15897,1991-12-31,708,4842,5550
15,15897,1992-12-31,736,4783,5519
15,15897,1993-12-31,751,4722,5473
15,15897,1994-12-31,762,4666,5428
15,15897,1995-12-31,779,4607,5386
15,15897,1996-12-31,794,4550,5344
15,15897,1997-12-31,809,4484,5293
15,15897,1998-12-31,822,4421,5243
15,15897,1999-12-31,837,4361,5198
15,15897,2000-12-31,855,4316,5171
15,15897,2001-12-31,872,4252,5124
15,15897,2002-12-31,893,4193,5086
15,15897,2003-12-31,913,4135,5048
15,15897,2004-12-31,932,4060,4992
15,15897,2005-12-31,945,3993,4938
15,15897,2006-12-31,962,3942,4904
15,15897,2007-12-31,983,3885,4868
15,15897,2008-12-31,1004,3829,4833
15,15897,2009-12-31,1020,3771,4791
15,15897,2010-12-31,1038,3715,4753
15,15897,2011-12-31,1056,3663,4719
15,15897,2012-12-31,1073,3624,4697
15,15897,2013-12-31,1086,3583,4669
15,15897,2014-12-31,1106,3538,4644
15,15897,2015-12-31,1112,3560,4672
15,15897,2016-12-31,1130,3522,4652
15,15897,2017-12-31,1149,3474,4623
15,15897,2018-12-31,1163,3466,4629
15,15897,2019-12-31,1187,3434,4621
15,15897,2020-12-31,1209,3416,4625
15,15897,2021-12-31,1260,3398,4658
15,15897,2022-12-31,1308,3379,4687
15,15897,2023-12-31,1355,3361,4716
15,15897,2024-12-31,1378,3344,4722
15,15897,2025-12-31,1394,3339,4733
15,15897,2026-12-31,1414,3336,4750
15,15897,2027-12-31,1430,3344,4774
15,15897,2028-12-31,1439,3356,4795
15,15897,2029-12-31,1460,3367,4827
15,15897,2030-12-31,1470,3394,4864
15,15897,2031-12-31,1476,3419,4895
15,15897,2032-12-31,1482,3444,4926
15,15897,2033-12-31,1494,3471,4965
15,15897,2034-12-31,1511,3496,5007
15,15897,2035-12-31,1513,3521,5034
17,17001,1985-12-31,316545,29908,346453
17,17001,1986-12-31,319453,30132,349585
17,17001,1987-12-31,322373,30356,352729
17,17001,1988-12-31,325309,30578,355887
17,17001,1989-12-31,328256,30761,359017
17,17001,1990-12-31,331191,30902,362093
17,17001,1991-12-31,334082,31011,365093
17,17001,1992-12-31,337110,31138,368248
17,17001,1993-12-31,340042,31222,371264
17,17001,1994-12-31,343262,31344,374606
17,17001,1995-12-31,346529,31402,377931
17,17001,1996-12-31,349618,31422,381040
17,17001,1997-12-31,352665,31418,384083
17,17001,1998-12-31,354806,31480,386286
17,17001,1999-12-31,357725,31433,389158
17,17001,2000-12-31,360305,31407,391712
17,17001,2001-12-31,362543,31338,393881
17,17001,2002-12-31,364617,31212,395829
17,17001,2003-12-31,366538,31059,397597
17,17001,2004-12-31,368259,30858,399117
17,17001,2005-12-31,369504,30644,400148
17,17001,2006-12-31,371099,30427,401526
17,17001,2007-12-31,372971,30215,403186
17,17001,2008-12-31,374854,29982,404836
17,17001,2009-12-31,376798,29803,406601
17,17001,2010-12-31,379167,29618,408785
17,17001,2011-12-31,381543,29476,411019
17,17001,2012-12-31,384082,29338,413420
17,17001,2013-12-31,386678,29195,415873
17,17001,2014-12-31,389495,29124,418619
17,17001,2015-12-31,392509,29029,421538
17,17001,2016-12-31,396238,28970,425208
17,17001,2017-12-31,400324,29009,429333
17,17001,2018-12-31,405234,29169,434403
17,17001,2019-12-31,413273,27335,440608
17,17001,2020-12-31,420933,25227,446160
17,17001,2021-12-31,425181,24893,450074
17,17001,2022-12-31,429450,24627,454077
17,17001,2023-12-31,434006,24436,458442
17,17001,2024-12-31,439707,24313,464020
17,17001,2025-12-31,445389,24211,469600
17,17001,2026-12-31,450756,24167,474923
17,17001,2027-12-31,455773,24179,479952
17,17001,2028-12-31,460341,24220,484561
17,17001,2029-12-31,464462,24338,488800
17,17001,2030-12-31,468094,24486,492580
17,17001,2031-12-31,471441,24685,496126
17,17001,2032-12-31,474678,24873,499551
17,17001,2033-12-31,477756,25072,502828
17,17001,2034-12-31,480716,25263,505979
17,17001,2035-12-31,483584,25444,509028
17,17013,1985-12-31,11181,20485,31666
17,17013,1986-12-31,11186,20356,31542
17,17013,1987-12-31,11198,20211,31409
17,17013,1988-12-31,11215,20062,31277
17,17013,1989-12-31,11231,19878,31109
17,17013,1990-12-31,11237,19695,30932
17,17013,1991-12-31,11261,19489,30750
17,17013,1992-12-31,11271,19269,30540
17,17013,1993-12-31,11292,19057,30349
17,17013,1994-12-31,11324,18796,30120
17,17013,1995-12-31,11345,18544,29889
17,17013,1996-12-31,11360,18258,29618
17,17013,1997-12-31,11396,17960,29356
17,17013,1998-12-31,11374,17705,29079
17,17013,1999-12-31,11388,17393,28781
17,17013,2000-12-31,11402,17083,28485
17,17013,2001-12-31,11399,16757,28156
17,17013,2002-12-31,11375,16436,27811
17,17013,2003-12-31,11377,16064,27441
17,17013,2004-12-31,11360,15692,27052
17,17013,2005-12-31,11333,15292,26625
17,17013,2006-12-31,11291,14919,26210
17,17013,2007-12-31,11292,14556,25848
17,17013,2008-12-31,11312,14167,25479
17,17013,2009-12-31,11282,13829,25111
17,17013,2010-12-31,11248,13509,24757
17,17013,2011-12-31,11286,13176,24462
17,17013,2012-12-31,11313,12835,24148
17,17013,2013-12-31,11307,12521,23828
17,17013,2014-12-31,11255,12281,23536
17,17013,2015-12-31,11293,11948,23241
17,17013,2016-12-31,11302,11682,22984
17,17013,2017-12-31,11489,11500,22989
17,17013,2018-12-31,11532,11291,22823
17,17013,2019-12-31,11655,11252,22907
17,17013,2020-12-31,11803,11245,23048
17,17013,2021-12-31,12147,11098,23245
17,17013,2022-12-31,12472,10980,23452
17,17013,2023-12-31,12783,10895,23678
17,17013,2024-12-31,12983,10833,23816
17,17013,2025-12-31,13151,10797,23948
17,17013,2026-12-31,13318,10774,24092
17,17013,2027-12-31,13465,10759,24224
17,17013,2028-12-31,13597,10785,24382
17,17013,2029-12-31,13721,10840,24561
17,17013,2030-12-31,13832,10919,24751
17,17013,2031-12-31,13936,11004,24940
17,17013,2032-12-31,14024,11092,25116
17,17013,2033-12-31,14128,11166,25294
17,17013,2034-12-31,14201,11261,25462
17,17013,2035-12-31,14290,11332,25622
17,17042,1985-12-31,19964,20491,40455
17,17042,1986-12-31,19987,20513,40500
17,17042,1987-12-31,19988,20521,40509
17,17042,1988-12-31,20009,20529,40538
17,17042,1989-12-31,20018,20516,40534
17,17042,1990-12-31,20027,20479,40506
17,17042,1991-12-31,20049,20417,40466
17,17042,1992-12-31,20072,20361,40433
17,17042,1993-12-31,20097,20281,40378
17,17042,1994-12-31,20126,20200,40326
17,17042,1995-12-31,20172,20106,40278
17,17042,1996-12-31,20201,19985,40186
17,17042,1997-12-31,20221,19829,40050
17,17042,1998-12-31,20206,19744,39950
17,17042,1999-12-31,20214,19586,39800
17,17042,2000-12-31,20226,19428,39654
17,17042,2001-12-31,20217,19245,39462
17,17042,2002-12-31,20188,19049,39237
17,17042,2003-12-31,20155,18813,38968
17,17042,2004-12-31,20113,18564,38677
17,17042,2005-12-31,20056,18301,38357
17,17042,2006-12-31,19996,18048,38044
17,17042,2007-12-31,19986,17785,37771
17,17042,2008-12-31,19947,17534,37481
17,17042,2009-12-31,19948,17297,37245
17,17042,2010-12-31,19925,17083,37008
17,17042,2011-12-31,19898,16867,36765
17,17042,2012-12-31,19842,16692,36534
17,17042,2013-12-31,19870,16490,36360
17,17042,2014-12-31,19907,16361,36268
17,17042,2015-12-31,19973,16105,36078
17,17042,2016-12-31,20031,15997,36028
17,17042,2017-12-31,20081,15862,35943
17,17042,2018-12-31,20284,15865,36149
17,17042,2019-12-31,20569,15836,36405
17,17042,2020-12-31,20876,15815,36691
17,17042,2021-12-31,21396,15609,37005
17,17042,2022-12-31,21893,15442,37335
17,17042,2023-12-31,22370,15323,37693
17,17042,2024-12-31,22704,15237,37941
17,17042,2025-12-31,23008,15183,38191
17,17042,2026-12-31,23301,15141,38442
17,17042,2027-12-31,23550,15143,38693
17,17042,2028-12-31,23789,15181,38970
17,17042,2029-12-31,24002,15241,39243
17,17042,2030-12-31,24193,15344,39537
17,17042,2031-12-31,24364,15460,39824
17,17042,2032-12-31,24532,15587,40119
17,17042,2033-12-31,24689,15702,40391
17,17042,2034-12-31,24843,15804,40647
17,17042,2035-12-31,24990,15939,40929
17,17050,1985-12-31,7008,8979,15987
17,17050,1986-12-31,7005,8876,15881
17,17050,1987-12-31,7001,8766,15767
17,17050,1988-12-31,6996,8653,15649
17,17050,1989-12-31,6998,8541,15539
17,17050,1990-12-31,6986,8414,15400
17,17050,1991-12-31,6978,8278,15256
17,17050,1992-12-31,6972,8144,15116
17,17050,1993-12-31,6978,8009,14987
17,17050,1994-12-31,6980,7855,14835
17,17050,1995-12-31,6988,7706,14694
17,17050,1996-12-31,6981,7528,14509
17,17050,1997-12-31,6991,7366,14357
17,17050,1998-12-31,6966,7222,14188
17,17050,1999-12-31,6974,7035,14009
17,17050,2000-12-31,6957,6868,13825
17,17050,2001-12-31,6950,6685,13635
17,17050,2002-12-31,6925,6499,13424
17,17050,2003-12-31,6900,6307,13207
17,17050,2004-12-31,6878,6118,12996
17,17050,2005-12-31,6847,5895,12742
17,17050,2006-12-31,6850,5709,12559
17,17050,2007-12-31,6834,5500,12334
17,17050,2008-12-31,6807,5305,12112
17,17050,2009-12-31,6699,5121,11820
17,17050,2010-12-31,6738,4942,11680
17,17050,2011-12-31,6779,4754,11533
17,17050,2012-12-31,6789,4641,11430
17,17050,2013-12-31,6791,4392,11183
17,17050,2014-12-31,6801,4260,11061
17,17050,2015-12-31,6821,4123,10944
17,17050,2016-12-31,6819,4012,10831
17,17050,2017-12-31,6759,3837,10596
17,17050,2018-12-31,6825,3732,10557
17,17050,2019-12-31,6904,3629,10533
17,17050,2020-12-31,6996,3560,10556
17,17050,2021-12-31,7133,3513,10646
17,17050,2022-12-31,7266,3475,10741
17,17050,2023-12-31,7395,3449,10844
17,17050,2024-12-31,7494,3427,10921
17,17050,2025-12-31,7599,3410,11009
17,17050,2026-12-31,7690,3407,11097
17,17050,2027-12-31,7778,3412,11190
17,17050,2028-12-31,7857,3412,11269
17,17050,2029-12-31,7930,3421,11351
17,17050,2030-12-31,7991,3442,11433
17,17050,2031-12-31,8033,3476,11509
17,17050,2032-12-31,8087,3493,11580
17,17050,2033-12-31,8153,3533,11686
17,17050,2034-12-31,8209,3562,11771
17,17050,2035-12-31,8249,3588,11837
17,17088,1985-12-31,4757,11139,15896
17,17088,1986-12-31,4760,11077,15837
17,17088,1987-12-31,4750,10992,15742
17,17088,1988-12-31,4725,10881,15606
17,17088,1989-12-31,4724,10783,15507
17,17088,1990-12-31,4725,10696,15421
17,17088,1991-12-31,4735,10580,15315
17,17088,1992-12-31,4725,10471,15196
17,17088,1993-12-31,4721,10324,15045
17,17088,1994-12-31,4732,10192,14924
17,17088,1995-12-31,4731,10057,14788
17,17088,1996-12-31,4724,9895,14619
17,17088,1997-12-31,4715,9754,14469
17,17088,1998-12-31,4706,9627,14333
17,17088,1999-12-31,4710,9444,14154
17,17088,2000-12-31,4703,9272,13975
17,17088,2001-12-31,4668,9106,13774
17,17088,2002-12-31,4678,8894,13572
17,17088,2003-12-31,4660,8712,13372
17,17088,2004-12-31,4615,8495,13110
17,17088,2005-12-31,4622,8270,12892
17,17088,2006-12-31,4617,8075,12692
17,17088,2007-12-31,4574,7867,12441
17,17088,2008-12-31,4529,7701,12230
17,17088,2009-12-31,4551,7425,11976
17,17088,2010-12-31,4526,7299,11825
17,17088,2011-12-31,4594,7076,11670
17,17088,2012-12-31,4558,6924,11482
17,17088,2013-12-31,4533,6761,11294
17,17088,2014-12-31,4534,6564,11098
17,17088,2015-12-31,4522,6444,10966
17,17088,2016-12-31,4530,6335,10865
17,17088,2017-12-31,4555,6169,10724
17,17088,2018-12-31,4583,6077,10660
17,17088,2019-12-31,4641,5993,10634
17,17088,2020-12-31,4707,5943,10650
17,17088,2021-12-31,4876,5865,10741
17,17088,2022-12-31,5034,5803,10837
17,17088,2023-12-31,5183,5758,10941
17,17088,2024-12-31,5277,5721,10998
17,17088,2025-12-31,5336,5702,11038
17,17088,2026-12-31,5404,5677,11081
17,17088,2027-12-31,5468,5684,11152
17,17088,2028-12-31,5526,5706,11232
17,17088,2029-12-31,5569,5715,11284
17,17088,2030-12-31,5614,5760,11374
17,17088,2031-12-31,5656,5804,11460
17,17088,2032-12-31,5693,5853,11546
17,17088,2033-12-31,5727,5899,11626
17,17088,2034-12-31,5774,5952,11726
17,17088,2035-12-31,5800,5983,11783
17,17174,1985-12-31,38832,12283,51115
17,17174,1986-12-31,39026,12195,51221
17,17174,1987-12-31,39231,12118,51349
17,17174,1988-12-31,39422,12011,51433
17,17174,1989-12-31,39619,11922,51541
17,17174,1990-12-31,39808,11864,51672
17,17174,1991-12-31,40006,11762,51768
17,17174,1992-12-31,40204,11650,51854
17,17174,1993-12-31,40418,11518,51936
17,17174,1994-12-31,40635,11326,51961
17,17174,1995-12-31,40874,11137,52011
17,17174,1996-12-31,41097,10949,52046
17,17174,1997-12-31,41290,10753,52043
17,17174,1998-12-31,41415,10590,52005
17,17174,1999-12-31,41604,10389,51993
17,17174,2000-12-31,41780,10206,51986
17,17174,2001-12-31,41899,10003,51902
17,17174,2002-12-31,42002,9811,51813
17,17174,2003-12-31,42092,9584,51676
17,17174,2004-12-31,42147,9358,51505
17,17174,2005-12-31,42165,9121,51286
17,17174,2006-12-31,42223,8897,51120
17,17174,2007-12-31,42297,8675,50972
17,17174,2008-12-31,42402,8443,50845
17,17174,2009-12-31,42485,8230,50715
17,17174,2010-12-31,42637,8037,50674
17,17174,2011-12-31,42755,7829,50584
17,17174,2012-12-31,42867,7622,50489
17,17174,2013-12-31,43086,7444,50530
17,17174,2014-12-31,43230,7265,50495
17,17174,2015-12-31,43491,7126,50617
17,17174,2016-12-31,43751,6994,50745
17,17174,2017-12-31,44147,6800,50947
17,17174,2018-12-31,44570,6701,51271
17,17174,2019-12-31,45406,6367,51773
17,17174,2020-12-31,46220,6047,52267
17,17174,2021-12-31,46748,5967,52715
17,17174,2022-12-31,47281,5903,53184
17,17174,2023-12-31,47837,5858,53695
17,17174,2024-12-31,48470,5833,54303
17,17174,2025-12-31,49082,5793,54875
17,17174,2026-12-31,49684,5790,55474
17,17174,2027-12-31,50223,5783,56006
17,17174,2028-12-31,50736,5804,56540
17,17174,2029-12-31,51175,5820,56995
17,17174,2030-12-31,51589,5879,57468
17,17174,2031-12-31,51965,5922,57887
17,17174,2032-12-31,52320,5953,58273
17,17174,2033-12-31,52651,5985,58636
17,17174,2034-12-31,52977,6042,59019
17,17174,2035-12-31,53284,6087,59371
17,17272,1985-12-31,4809,13181,17990
17,17272,1986-12-31,4791,13110,17901
17,17272,1987-12-31,4747,13033,17780
17,17272,1988-12-31,4726,12941,17667
17,17272,1989-12-31,4686,12827,17513
17,17272,1990-12-31,4654,12718,17372
17,17272,1991-12-31,4630,12596,17226
17,17272,1992-12-31,4607,12464,17071
17,17272,1993-12-31,4579,12314,16893
17,17272,1994-12-31,4553,12179,16732
17,17272,1995-12-31,4511,12016,16527
17,17272,1996-12-31,4513,11860,16373
17,17272,1997-12-31,4470,11680,16150
17,17272,1998-12-31,4437,11538,15975
17,17272,1999-12-31,4443,11332,15775
17,17272,2000-12-31,4360,11158,15518
17,17272,2001-12-31,4393,10952,15345
17,17272,2002-12-31,4358,10750,15108
17,17272,2003-12-31,4284,10529,14813
17,17272,2004-12-31,4237,10282,14519
17,17272,2005-12-31,4223,10053,14276
17,17272,2006-12-31,4198,9808,14006
17,17272,2007-12-31,4076,9584,13660
17,17272,2008-12-31,4029,9365,13394
17,17272,2009-12-31,4054,9156,13210
17,17272,2010-12-31,4019,8904,12923
17,17272,2011-12-31,3999,8745,12744
17,17272,2012-12-31,3978,8469,12447
17,17272,2013-12-31,3959,8346,12305
17,17272,2014-12-31,3957,8128,12085
17,17272,2015-12-31,3954,7992,11946
17,17272,2016-12-31,3912,7867,11779
17,17272,2017-12-31,3850,7650,11500
17,17272,2018-12-31,3877,7574,11451
17,17272,2019-12-31,3902,7497,11399
17,17272,2020-12-31,3938,7462,11400
17,17272,2021-12-31,4133,7365,11498
17,17272,2022-12-31,4314,7286,11600
17,17272,2023-12-31,4481,7230,11711
17,17272,2024-12-31,4565,7187,11752
17,17272,2025-12-31,4631,7159,11790
17,17272,2026-12-31,4688,7141,11829
17,17272,2027-12-31,4731,7152,11883
17,17272,2028-12-31,4787,7157,11944
17,17272,2029-12-31,4835,7199,12034
17,17272,2030-12-31,4864,7232,12096
17,17272,2031-12-31,4901,7292,12193
17,17272,2032-12-31,4927,7347,12274
17,17272,2033-12-31,4966,7417,12383
17,17272,2034-12-31,4997,7462,12459
17,17272,2035-12-31,5030,7525,12555
17,17380,1985-12-31,56324,6830,63154
17,17380,1986-12-31,56537,6984,63521
17,17380,1987-12-31,56756,7104,63860
17,17380,1988-12-31,56970,7235,64205
17,17380,1989-12-31,57182,7377,64559
17,17380,1990-12-31,57400,7509,64909
17,17380,1991-12-31,57615,7637,65252
17,17380,1992-12-31,57851,7750,65601
17,17380,1993-12-31,58065,7874,65939
17,17380,1994-12-31,58335,7987,66322
17,17380,1995-12-31,58602,8106,66708
17,17380,1996-12-31,58873,8204,67077
17,17380,1997-12-31,59105,8287,67392
17,17380,1998-12-31,59193,8392,67585
17,17380,1999-12-31,59420,8477,67897
17,17380,2000-12-31,59588,8552,68140
17,17380,2001-12-31,59707,8607,68314
17,17380,2002-12-31,59794,8669,68463
17,17380,2003-12-31,59860,8711,68571
17,17380,2004-12-31,59892,8760,68652
17,17380,2005-12-31,59852,8771,68623
17,17380,2006-12-31,59862,8796,68658
17,17380,2007-12-31,59945,8811,68756
17,17380,2008-12-31,60008,8835,68843
17,17380,2009-12-31,60093,8857,68950
17,17380,2010-12-31,60256,8889,69145
17,17380,2011-12-31,60314,8935,69249
17,17380,2012-12-31,60499,8931,69430
17,17380,2013-12-31,60692,8995,69687
17,17380,2014-12-31,60936,9022,69958
17,17380,2015-12-31,61184,9108,70292
17,17380,2016-12-31,61546,9199,70745
17,17380,2017-12-31,61908,9261,71169
17,17380,2018-12-31,62536,9369,71905
17,17380,2019-12-31,63645,9327,72972
17,17380,2020-12-31,64742,9264,74006
17,17380,2021-12-31,65512,9143,74655
17,17380,2022-12-31,66274,9045,75319
17,17380,2023-12-31,67067,8976,76043
17,17380,2024-12-31,67914,8925,76839
17,17380,2025-12-31,68764,8892,77656
17,17380,2026-12-31,69565,8882,78447
17,17380,2027-12-31,70332,8883,79215
17,17380,2028-12-31,71016,8907,79923
17,17380,2029-12-31,71660,8949,80609
17,17380,2030-12-31,72206,9016,81222
17,17380,2031-12-31,72736,9076,81812
17,17380,2032-12-31,73229,9159,82388
17,17380,2033-12-31,73702,9226,82928
17,17380,2034-12-31,74152,9302,83454
17,17380,2035-12-31,74586,9360,83946
17,17388,1985-12-31,2371,9910,12281
17,17388,1986-12-31,2345,9780,12125
17,17388,1987-12-31,2356,9666,12022
17,17388,1988-12-31,2348,9536,11884
17,17388,1989-12-31,2334,9389,11723
17,17388,1990-12-31,2323,9249,11572
17,17388,1991-12-31,2301,9100,11401
17,17388,1992-12-31,2294,8927,11221
17,17388,1993-12-31,2290,8748,11038
17,17388,1994-12-31,2297,8577,10874
17,17388,1995-12-31,2273,8396,10669
17,17388,1996-12-31,2289,8203,10492
17,17388,1997-12-31,2283,8028,10311
17,17388,1998-12-31,2295,7850,10145
17,17388,1999-12-31,2281,7636,9917
17,17388,2000-12-31,2285,7447,9732
17,17388,2001-12-31,2288,7241,9529
17,17388,2002-12-31,2266,7024,9290
17,17388,2003-12-31,2239,6798,9037
17,17388,2004-12-31,2196,6565,8761
17,17388,2005-12-31,2156,6338,8494
17,17388,2006-12-31,2208,6117,8325
17,17388,2007-12-31,2181,5891,8072
17,17388,2008-12-31,2147,5676,7823
17,17388,2009-12-31,2140,5460,7600
17,17388,2010-12-31,2119,5246,7365
17,17388,2011-12-31,2109,5061,7170
17,17388,2012-12-31,2109,4882,6991
17,17388,2013-12-31,2104,4630,6734
17,17388,2014-12-31,2107,4468,6575
17,17388,2015-12-31,2102,4301,6403
17,17388,2016-12-31,2114,4163,6277
17,17388,2017-12-31,2123,4026,6149
17,17388,2018-12-31,2151,3852,6003
17,17388,2019-12-31,2171,3745,5916
17,17388,2020-12-31,2197,3685,5882
17,17388,2021-12-31,2296,3636,5932
17,17388,2022-12-31,2388,3597,5985
17,17388,2023-12-31,2473,3570,6043
17,17388,2024-12-31,2518,3547,6065
17,17388,2025-12-31,2551,3532,6083
17,17388,2026-12-31,2574,3525,6099
17,17388,2027-12-31,2610,3537,6147
17,17388,2028-12-31,2636,3538,6174
17,17388,2029-12-31,2663,3557,6220
17,17388,2030-12-31,2677,3575,6252
17,17388,2031-12-31,2704,3597,6301
17,17388,2032-12-31,2717,3628,6345
17,17388,2033-12-31,2732,3654,6386
17,17388,2034-12-31,2755,3683,6438
17,17388,2035-12-31,2777,3709,6486
17,17433,1985-12-31,10236,19958,30194
17,17433,1986-12-31,10233,19717,29950
17,17433,1987-12-31,10224,19468,29692
17,17433,1988-12-31,10234,19204,29438
17,17433,1989-12-31,10245,18935,29180
17,17433,1990-12-31,10249,18650,28899
17,17433,1991-12-31,10239,18358,28597
17,17433,1992-12-31,10263,18020,28283
17,17433,1993-12-31,10262,17679,27941
17,17433,1994-12-31,10272,17326,27598
17,17433,1995-12-31,10276,16942,27218
17,17433,1996-12-31,10287,16551,26838
17,17433,1997-12-31,10300,16153,26453
17,17433,1998-12-31,10273,15787,26060
17,17433,1999-12-31,10276,15369,25645
17,17433,2000-12-31,10279,14940,25219
17,17433,2001-12-31,10265,14533,24798
17,17433,2002-12-31,10251,14113,24364
17,17433,2003-12-31,10216,13671,23887
17,17433,2004-12-31,10209,13215,23424
17,17433,2005-12-31,10137,12751,22888
17,17433,2006-12-31,10136,12285,22421
17,17433,2007-12-31,10100,11830,21930
17,17433,2008-12-31,10107,11393,21500
17,17433,2009-12-31,10066,10984,21050
17,17433,2010-12-31,10038,10548,20586
17,17433,2011-12-31,10077,10178,20255
17,17433,2012-12-31,10077,9767,19844
17,17433,2013-12-31,10095,9395,19490
17,17433,2014-12-31,10110,8992,19102
17,17433,2015-12-31,10074,8640,18714
17,17433,2016-12-31,10116,8326,18442
17,17433,2017-12-31,10231,8013,18244
17,17433,2018-12-31,10221,7707,17928
17,17433,2019-12-31,10337,7468,17805
17,17433,2020-12-31,10475,7319,17794
17,17433,2021-12-31,10724,7222,17946
17,17433,2022-12-31,10961,7145,18106
17,17433,2023-12-31,11190,7090,18280
17,17433,2024-12-31,11361,7046,18407
17,17433,2025-12-31,11506,7012,18518
17,17433,2026-12-31,11643,7001,18644
17,17433,2027-12-31,11774,7007,18781
17,17433,2028-12-31,11900,7004,18904
17,17433,2029-12-31,11993,7046,19039
17,17433,2030-12-31,12098,7084,19182
17,17433,2031-12-31,12172,7152,19324
17,17433,2032-12-31,12262,7212,19474
17,17433,2033-12-31,12335,7250,19585
17,17433,2034-12-31,12425,7316,19741
17,17433,2035-12-31,12486,7358,19844
17,17442,1985-12-31,1151,5955,7106
17,17442,1986-12-31,1103,6069,7172
17,17442,1987-12-31,1114,6177,7291
17,17442,1988-12-31,1093,6293,7386
17,17442,1989-12-31,1111,6398,7509
17,17442,1990-12-31,1115,6502,7617
17,17442,1991-12-31,1105,6603,7708
17,17442,1992-12-31,1097,6693,7790
17,17442,1993-12-31,1095,6797,7892
17,17442,1994-12-31,1073,6881,7954
17,17442,1995-12-31,1075,6959,8034
17,17442,1996-12-31,1064,7043,8107
17,17442,1997-12-31,1068,7129,8197
17,17442,1998-12-31,1045,7203,8248
17,17442,1999-12-31,1033,7270,8303
17,17442,2000-12-31,1035,7334,8369
17,17442,2001-12-31,1030,7387,8417
17,17442,2002-12-31,1010,7408,8418
17,17442,2003-12-31,996,7450,8446
17,17442,2004-12-31,986,7481,8467
17,17442,2005-12-31,1000,7485,8485
17,17442,2006-12-31,1007,7503,8510
17,17442,2007-12-31,998,7505,8503
17,17442,2008-12-31,971,7499,8470
17,17442,2009-12-31,1023,7513,8536
17,17442,2010-12-31,1016,7536,8552
17,17442,2011-12-31,998,7578,8576
17,17442,2012-12-31,983,7583,8566
17,17442,2013-12-31,968,7628,8596
17,17442,2014-12-31,968,7658,8626
17,17442,2015-12-31,954,7685,8639
17,17442,2016-12-31,951,7776,8727
17,17442,2017-12-31,954,7852,8806
17,17442,2018-12-31,964,7924,8888
17,17442,2019-12-31,983,8052,9035
17,17442,2020-12-31,1000,8167,9167
17,17442,2021-12-31,1187,8060,9247
17,17442,2022-12-31,1356,7974,9330
17,17442,2023-12-31,1506,7913,9419
17,17442,2024-12-31,1551,7871,9422
17,17442,2025-12-31,1576,7839,9415
17,17442,2026-12-31,1600,7830,9430
17,17442,2027-12-31,1622,7824,9446
17,17442,2028-12-31,1634,7843,9477
17,17442,2029-12-31,1651,7874,9525
17,17442,2030-12-31,1675,7933,9608
17,17442,2031-12-31,1691,7996,9687
17,17442,2032-12-31,1706,8055,9761
17,17442,2033-12-31,1709,8128,9837
17,17442,2034-12-31,1717,8178,9895
17,17442,2035-12-31,1725,8239,9964
17,17444,1985-12-31,4421,12519,16940
17,17444,1986-12-31,4488,12449,16937
17,17444,1987-12-31,4545,12366,16911
17,17444,1988-12-31,4619,12241,16860
17,17444,1989-12-31,4685,12141,16826
17,17444,1990-12-31,4748,12019,16767
17,17444,1991-12-31,4809,11889,16698
17,17444,1992-12-31,4868,11759,16627
17,17444,1993-12-31,4933,11611,16544
17,17444,1994-12-31,5000,11449,16449
17,17444,1995-12-31,5073,11316,16389
17,17444,1996-12-31,5128,11163,16291
17,17444,1997-12-31,5200,10977,16177
17,17444,1998-12-31,5257,10814,16071
17,17444,1999-12-31,5318,10624,15942
17,17444,2000-12-31,5364,10454,15818
17,17444,2001-12-31,5425,10245,15670
17,17444,2002-12-31,5463,10022,15485
17,17444,2003-12-31,5512,9812,15324
17,17444,2004-12-31,5556,9574,15130
17,17444,2005-12-31,5583,9338,14921
17,17444,2006-12-31,5642,9130,14772
17,17444,2007-12-31,5679,8890,14569
17,17444,2008-12-31,5717,8655,14372
17,17444,2009-12-31,5733,8435,14168
17,17444,2010-12-31,5813,8246,14059
17,17444,2011-12-31,5889,8032,13921
17,17444,2012-12-31,5951,7879,13830
17,17444,2013-12-31,5995,7632,13627
17,17444,2014-12-31,6085,7418,13503
17,17444,2015-12-31,6186,7322,13508
17,17444,2016-12-31,6230,7165,13395
17,17444,2017-12-31,6281,6993,13274
17,17444,2018-12-31,6348,6897,13245
17,17444,2019-12-31,6498,6870,13368
17,17444,2020-12-31,6638,6852,13490
17,17444,2021-12-31,6843,6763,13606
17,17444,2022-12-31,7037,6690,13727
17,17444,2023-12-31,7220,6639,13859
17,17444,2024-12-31,7352,6594,13946
17,17444,2025-12-31,7459,6564,14023
17,17444,2026-12-31,7554,6549,14103
17,17444,2027-12-31,7633,6555,14188
17,17444,2028-12-31,7723,6580,14303
17,17444,2029-12-31,7786,6601,14387
17,17444,2030-12-31,7850,6644,14494
17,17444,2031-12-31,7908,6684,14592
17,17444,2032-12-31,7962,6738,14700
17,17444,2033-12-31,8019,6790,14809
17,17444,2034-12-31,8062,6850,14912
17,17444,2035-12-31,8103,6894,14997
17,17446,1985-12-31,2021,2960,4981
17,17446,1986-12-31,1941,2922,4863
17,17446,1987-12-31,1900,2915,4815
17,17446,1988-12-31,1864,2901,4765
17,17446,1989-12-31,1824,2876,4700
17,17446,1990-12-31,1795,2851,4646
17,17446,1991-12-31,1792,2821,4613
17,17446,1992-12-31,1749,2802,4551
17,17446,1993-12-31,1700,2754,4454
17,17446,1994-12-31,1700,2732,4432
17,17446,1995-12-31,1609,2697,4306
17,17446,1996-12-31,1601,2689,4290
17,17446,1997-12-31,1567,2635,4202
17,17446,1998-12-31,1491,2570,4061
17,17446,1999-12-31,1480,2545,4025
17,17446,2000-12-31,1443,2506,3949
17,17446,2001-12-31,1375,2467,3842
17,17446,2002-12-31,1362,2417,3779
17,17446,2003-12-31,1306,2386,3692
17,17446,2004-12-31,1280,2319,3599
17,17446,2005-12-31,1194,2258,3452
17,17446,2006-12-31,1207,2221,3428
17,17446,2007-12-31,1166,2188,3354
17,17446,2008-12-31,1125,2158,3283
17,17446,2009-12-31,1098,2106,3204
17,17446,2010-12-31,1069,2012,3081
17,17446,2011-12-31,1050,1944,2994
17,17446,2012-12-31,1003,1901,2904
17,17446,2013-12-31,984,1872,2856
17,17446,2014-12-31,966,1850,2816
17,17446,2015-12-31,927,1824,2751
17,17446,2016-12-31,854,1806,2660
17,17446,2017-12-31,819,1794,2613
17,17446,2018-12-31,823,1784,2607
17,17446,2019-12-31,805,1760,2565
17,17446,2020-12-31,796,1748,2544
17,17446,2021-12-31,841,1725,2566
17,17446,2022-12-31,882,1707,2589
17,17446,2023-12-31,920,1694,2614
17,17446,2024-12-31,931,1681,2612
17,17446,2025-12-31,939,1670,2609
17,17446,2026-12-31,949,1668,2617
17,17446,2027-12-31,963,1670,2633
17,17446,2028-12-31,972,1675,2647
17,17446,2029-12-31,982,1680,2662
17,17446,2030-12-31,997,1697,2694
17,17446,2031-12-31,1000,1715,2715
17,17446,2032-12-31,1005,1724,2729
17,17446,2033-12-31,1021,1728,2749
17,17446,2034-12-31,1032,1748,2780
17,17446,2035-12-31,1037,1761,2798
17,17486,1985-12-31,11200,18807,30007
17,17486,1986-12-31,11217,18662,29879
17,17486,1987-12-31,11234,18508,29742
17,17486,1988-12-31,11250,18305,29555
17,17486,1989-12-31,11260,18122,29382
17,17486,1990-12-31,11273,17896,29169
17,17486,1991-12-31,11284,17678,28962
17,17486,1992-12-31,11305,17442,28747
17,17486,1993-12-31,11321,17187,28508
17,17486,1994-12-31,11344,16945,28289
17,17486,1995-12-31,11386,16684,28070
17,17486,1996-12-31,11401,16406,27807
17,17486,1997-12-31,11420,16107,27527
17,17486,1998-12-31,11397,15844,27241
17,17486,1999-12-31,11429,15527,26956
17,17486,2000-12-31,11440,15228,26668
17,17486,2001-12-31,11431,14889,26320
17,17486,2002-12-31,11427,14559,25986
17,17486,2003-12-31,11416,14201,25617
17,17486,2004-12-31,11397,13845,25242
17,17486,2005-12-31,11380,13437,24817
17,17486,2006-12-31,11342,13081,24423
17,17486,2007-12-31,11325,12698,24023
17,17486,2008-12-31,11346,12351,23697
17,17486,2009-12-31,11328,11997,23325
17,17486,2010-12-31,11285,11662,22947
17,17486,2011-12-31,11316,11356,22672
17,17486,2012-12-31,11353,11050,22403
17,17486,2013-12-31,11350,10729,22079
17,17486,2014-12-31,11316,10432,21748
17,17486,2015-12-31,11383,10175,21558
17,17486,2016-12-31,11402,9933,21335
17,17486,2017-12-31,11470,9670,21140
17,17486,2018-12-31,11564,9460,21024
17,17486,2019-12-31,11789,9251,21040
17,17486,2020-12-31,12004,9110,21114
17,17486,2021-12-31,12306,8989,21295
17,17486,2022-12-31,12591,8893,21484
17,17486,2023-12-31,12866,8825,21691
17,17486,2024-12-31,13071,8771,21842
17,17486,2025-12-31,13255,8732,21987
17,17486,2026-12-31,13408,8707,22115
17,17486,2027-12-31,13560,8703,22263
17,17486,2028-12-31,13696,8718,22414
17,17486,2029-12-31,13822,8757,22579
17,17486,2030-12-31,13929,8826,22755
17,17486,2031-12-31,14032,8908,22940
17,17486,2032-12-31,14124,8961,23085
17,17486,2033-12-31,14208,9041,23249
17,17486,2034-12-31,14306,9098,23404
17,17486,2035-12-31,14386,9173,23559
17,17495,1985-12-31,0,0,0
17,17495,1986-12-31,0,0,0
17,17495,1987-12-31,0,0,0
17,17495,1988-12-31,0,0,0
17,17495,1989-12-31,0,0,0
17,17495,1990-12-31,0,0,0
17,17495,1991-12-31,0,0,0
17,17495,1992-12-31,0,0,0
17,17495,1993-12-31,0,0,0
17,17495,1994-12-31,0,0,0
17,17495,1995-12-31,0,0,0
17,17495,1996-12-31,0,0,0
17,17495,1997-12-31,0,0,0
17,17495,1998-12-31,0,0,0
17,17495,1999-12-31,3436,4729,8165
17,17495,2000-12-31,3460,4612,8072
17,17495,2001-12-31,3499,4443,7942
17,17495,2002-12-31,3525,4271,7796
17,17495,2003-12-31,3562,4120,7682
17,17495,2004-12-31,3573,3961,7534
17,17495,2005-12-31,3584,3798,7382
17,17495,2006-12-31,3607,3632,7239
17,17495,2007-12-31,3609,3468,7077
17,17495,2008-12-31,3618,3329,6947
17,17495,2009-12-31,3665,3171,6836
17,17495,2010-12-31,3712,3035,6747
17,17495,2011-12-31,3762,2879,6641
17,17495,2012-12-31,3786,2753,6539
17,17495,2013-12-31,3833,2586,6419
17,17495,2014-12-31,3839,2471,6310
17,17495,2015-12-31,3922,2360,6282
17,17495,2016-12-31,3958,2234,6192
17,17495,2017-12-31,3980,2145,6125
17,17495,2018-12-31,4007,2015,6022
17,17495,2019-12-31,4081,1994,6075
17,17495,2020-12-31,4153,1975,6128
17,17495,2021-12-31,4232,1949,6181
17,17495,2022-12-31,4307,1928,6235
17,17495,2023-12-31,4381,1914,6295
17,17495,2024-12-31,4446,1900,6346
17,17495,2025-12-31,4506,1893,6399
17,17495,2026-12-31,4562,1882,6444
17,17495,2027-12-31,4605,1867,6472
17,17495,2028-12-31,4660,1878,6538
17,17495,2029-12-31,4702,1888,6590
17,17495,2030-12-31,4741,1901,6642
17,17495,2031-12-31,4771,1911,6682
17,17495,2032-12-31,4794,1923,6717
17,17495,2033-12-31,4837,1947,6784
17,17495,2034-12-31,4858,1953,6811
17,17495,2035-12-31,4887,1982,6869
17,17513,1985-12-31,6759,15084,21843
17,17513,1986-12-31,6781,14978,21759
17,17513,1987-12-31,6804,14876,21680
17,17513,1988-12-31,6825,14742,21567
17,17513,1989-12-31,6847,14596,21443
17,17513,1990-12-31,6878,14435,21313
17,17513,1991-12-31,6893,14271,21164
17,17513,1992-12-31,6921,14084,21005
17,17513,1993-12-31,6936,13897,20833
17,17513,1994-12-31,6959,13711,20670
17,17513,1995-12-31,7010,13485,20495
17,17513,1996-12-31,7048,13308,20356
17,17513,1997-12-31,7047,13054,20101
17,17513,1998-12-31,7066,12842,19908
17,17513,1999-12-31,7098,12593,19691
17,17513,2000-12-31,7087,12353,19440
17,17513,2001-12-31,7125,12111,19236
17,17513,2002-12-31,7127,11843,18970
17,17513,2003-12-31,7130,11552,18682
17,17513,2004-12-31,7144,11265,18409
17,17513,2005-12-31,7124,10955,18079
17,17513,2006-12-31,7142,10690,17832
17,17513,2007-12-31,7163,10413,17576
17,17513,2008-12-31,7155,10144,17299
17,17513,2009-12-31,7123,9865,16988
17,17513,2010-12-31,7151,9608,16759
17,17513,2011-12-31,7170,9387,16557
17,17513,2012-12-31,7200,9103,16303
17,17513,2013-12-31,7234,8890,16124
17,17513,2014-12-31,7283,8604,15887
17,17513,2015-12-31,7327,8427,15754
17,17513,2016-12-31,7377,8206,15583
17,17513,2017-12-31,7345,8092,15437
17,17513,2018-12-31,7430,7895,15325
17,17513,2019-12-31,7492,7804,15296
17,17513,2020-12-31,7565,7759,15324
17,17513,2021-12-31,7797,7658,15455
17,17513,2022-12-31,8017,7576,15593
17,17513,2023-12-31,8225,7518,15743
17,17513,2024-12-31,8351,7474,15825
17,17513,2025-12-31,8469,7456,15925
17,17513,2026-12-31,8570,7443,16013
17,17513,2027-12-31,8665,7445,16110
17,17513,2028-12-31,8752,7465,16217
17,17513,2029-12-31,8840,7490,16330
17,17513,2030-12-31,8899,7527,16426
17,17513,2031-12-31,8963,7574,16537
17,17513,2032-12-31,9027,7648,16675
17,17513,2033-12-31,9092,7700,16792
17,17513,2034-12-31,9141,7757,16898
17,17513,2035-12-31,9187,7822,17009
17,17524,1985-12-31,5616,14475,20091
17,17524,1986-12-31,5586,14471,20057
17,17524,1987-12-31,5566,14441,20007
17,17524,1988-12-31,5575,14427,20002
17,17524,1989-12-31,5553,14408,19961
17,17524,1990-12-31,5525,14403,19928
17,17524,1991-12-31,5510,14367,19877
17,17524,1992-12-31,5482,14301,19783
17,17524,1993-12-31,5450,14237,19687
17,17524,1994-12-31,5449,14133,19582
17,17524,1995-12-31,5436,14027,19463
17,17524,1996-12-31,5422,13908,19330
17,17524,1997-12-31,5391,13774,19165
17,17524,1998-12-31,5365,13670,19035
17,17524,1999-12-31,5344,13536,18880
17,17524,2000-12-31,5337,13402,18739
17,17524,2001-12-31,5320,13256,18576
17,17524,2002-12-31,5296,13087,18383
17,17524,2003-12-31,5269,12913,18182
17,17524,2004-12-31,5198,12726,17924
17,17524,2005-12-31,5183,12533,17716
17,17524,2006-12-31,5162,12314,17476
17,17524,2007-12-31,5143,12125,17268
17,17524,2008-12-31,5047,11945,16992
17,17524,2009-12-31,5021,11753,16774
17,17524,2010-12-31,5020,11586,16606
17,17524,2011-12-31,5067,11406,16473
17,17524,2012-12-31,5017,11263,16280
17,17524,2013-12-31,4967,11106,16073
17,17524,2014-12-31,4942,10997,15939
17,17524,2015-12-31,4949,10855,15804
17,17524,2016-12-31,4929,10713,15642
17,17524,2017-12-31,4943,10673,15616
17,17524,2018-12-31,4963,10592,15555
17,17524,2019-12-31,5052,10546,15598
17,17524,2020-12-31,5138,10543,15681
17,17524,2021-12-31,5410,10405,15815
17,17524,2022-12-31,5662,10294,15956
17,17524,2023-12-31,5894,10215,16109
17,17524,2024-12-31,6010,10152,16162
17,17524,2025-12-31,6101,10107,16208
17,17524,2026-12-31,6172,10080,16252
17,17524,2027-12-31,6247,10081,16328
17,17524,2028-12-31,6308,10121,16429
17,17524,2029-12-31,6367,10154,16521
17,17524,2030-12-31,6411,10234,16645
17,17524,2031-12-31,6448,10303,16751
17,17524,2032-12-31,6503,10401,16904
17,17524,2033-12-31,6541,10466,17007
17,17524,2034-12-31,6584,10539,17123
17,17524,2035-12-31,6624,10625,17249
17,17541,1985-12-31,7209,26230,33439
17,17541,1986-12-31,7224,25988,33212
17,17541,1987-12-31,7249,25706,32955
17,17541,1988-12-31,7268,25438,32706
17,17541,1989-12-31,7282,25126,32408
17,17541,1990-12-31,7309,24789,32098
17,17541,1991-12-31,7320,24449,31769
17,17541,1992-12-31,7336,24084,31420
17,17541,1993-12-31,7354,23706,31060
17,17541,1994-12-31,7374,23339,30713
17,17541,1995-12-31,7407,22932,30339
17,17541,1996-12-31,7428,22515,29943
17,17541,1997-12-31,7450,22037,29487
17,17541,1998-12-31,7455,21661,29116
17,17541,1999-12-31,7467,21186,28653
17,17541,2000-12-31,7465,20718,28183
17,17541,2001-12-31,7500,20241,27741
17,17541,2002-12-31,7510,19730,27240
17,17541,2003-12-31,7499,19206,26705
17,17541,2004-12-31,7480,18664,26144
17,17541,2005-12-31,7495,18105,25600
17,17541,2006-12-31,7469,17568,25037
17,17541,2007-12-31,7474,17025,24499
17,17541,2008-12-31,7475,16493,23968
17,17541,2009-12-31,7449,16011,23460
17,17541,2010-12-31,7469,15531,23000
17,17541,2011-12-31,7475,15018,22493
17,17541,2012-12-31,7568,14561,22129
17,17541,2013-12-31,7554,14131,21685
17,17541,2014-12-31,7557,13722,21279
17,17541,2015-12-31,7549,13242,20791
17,17541,2016-12-31,7595,12864,20459
17,17541,2017-12-31,7642,12488,20130
17,17541,2018-12-31,7706,12202,19908
17,17541,2019-12-31,7827,11954,19781
17,17541,2020-12-31,7953,11802,19755
17,17541,2021-12-31,8294,11630,19924
17,17541,2022-12-31,8600,11502,20102
17,17541,2023-12-31,8882,11413,20295
17,17541,2024-12-31,9033,11346,20379
17,17541,2025-12-31,9168,11288,20456
17,17541,2026-12-31,9284,11283,20567
17,17541,2027-12-31,9372,11268,20640
17,17541,2028-12-31,9466,11286,20752
17,17541,2029-12-31,9545,11346,20891
17,17541,2030-12-31,9618,11413,21031
17,17541,2031-12-31,9689,11506,21195
17,17541,2032-12-31,9765,11586,21351
17,17541,2033-12-31,9820,11669,21489
17,17541,2034-12-31,9890,11757,21647
17,17541,2035-12-31,9952,11832,21784
17,17614,1985-12-31,16072,9317,25389
17,17614,1986-12-31,16151,10172,26323
17,17614,1987-12-31,16222,11077,27299
17,17614,1988-12-31,16287,11920,28207
17,17614,1989-12-31,16351,12798,29149
17,17614,1990-12-31,16418,13654,30072
17,17614,1991-12-31,16498,14504,31002
17,17614,1992-12-31,16562,15363,31925
17,17614,1993-12-31,16633,16204,32837
17,17614,1994-12-31,16718,17042,33760
17,17614,1995-12-31,16782,17893,34675
17,17614,1996-12-31,16866,18692,35558
17,17614,1997-12-31,16947,19470,36417
17,17614,1998-12-31,16978,20296,37274
17,17614,1999-12-31,17056,21064,38120
17,17614,2000-12-31,17096,21808,38904
17,17614,2001-12-31,17149,22544,39693
17,17614,2002-12-31,17169,23210,40379
17,17614,2003-12-31,17205,23849,41054
17,17614,2004-12-31,17223,24460,41683
17,17614,2005-12-31,17218,25020,42238
17,17614,2006-12-31,17227,25569,42796
17,17614,2007-12-31,17267,26124,43391
17,17614,2008-12-31,17269,26661,43930
17,17614,2009-12-31,17341,27186,44527
17,17614,2010-12-31,17391,27744,45135
17,17614,2011-12-31,17407,28287,45694
17,17614,2012-12-31,17413,28836,46249
17,17614,2013-12-31,17454,29384,46838
17,17614,2014-12-31,17536,29973,47509
17,17614,2015-12-31,17618,30554,48172
17,17614,2016-12-31,17731,31167,48898
17,17614,2017-12-31,17820,31865,49685
17,17614,2018-12-31,18077,32698,50775
17,17614,2019-12-31,18378,32993,51371
17,17614,2020-12-31,18662,33294,51956
17,17614,2021-12-31,19552,32859,52411
17,17614,2022-12-31,20370,32508,52878
17,17614,2023-12-31,21128,32258,53386
17,17614,2024-12-31,21542,32038,53580
17,17614,2025-12-31,21859,31929,53788
17,17614,2026-12-31,22143,31864,54007
17,17614,2027-12-31,22389,31863,54252
17,17614,2028-12-31,22616,31934,54550
17,17614,2029-12-31,22818,32086,54904
17,17614,2030-12-31,22992,32311,55303
17,17614,2031-12-31,23152,32568,55720
17,17614,2032-12-31,23310,32826,56136
17,17614,2033-12-31,23465,33093,56558
17,17614,2034-12-31,23612,33328,56940
17,17614,2035-12-31,23757,33586,57343
17,17616,1985-12-31,3602,18815,22417
17,17616,1986-12-31,3609,19099,22708
17,17616,1987-12-31,3638,19382,23020
17,17616,1988-12-31,3653,19641,23294
17,17616,1989-12-31,3679,19911,23590
17,17616,1990-12-31,3700,20159,23859
17,17616,1991-12-31,3716,20386,24102
17,17616,1992-12-31,3725,20611,24336
17,17616,1993-12-31,3756,20813,24569
17,17616,1994-12-31,3802,21020,24822
17,17616,1995-12-31,3812,21199,25011
17,17616,1996-12-31,3840,21315,25155
17,17616,1997-12-31,3854,21462,25316
17,17616,1998-12-31,3870,11236,15106
17,17616,1999-12-31,3897,10990,14887
17,17616,2000-12-31,3912,10788,14700
17,17616,2001-12-31,3896,10550,14446
17,17616,2002-12-31,3921,10301,14222
17,17616,2003-12-31,3940,10046,13986
17,17616,2004-12-31,3958,9778,13736
17,17616,2005-12-31,3961,9505,13466
17,17616,2006-12-31,3971,9222,13193
17,17616,2007-12-31,3937,8975,12912
17,17616,2008-12-31,3965,8697,12662
17,17616,2009-12-31,3990,8432,12422
17,17616,2010-12-31,3983,8205,12188
17,17616,2011-12-31,4054,7938,11992
17,17616,2012-12-31,4101,7718,11819
17,17616,2013-12-31,4099,7523,11622
17,17616,2014-12-31,4107,7273,11380
17,17616,2015-12-31,4117,7096,11213
17,17616,2016-12-31,4150,6942,11092
17,17616,2017-12-31,4180,6763,10943
17,17616,2018-12-31,4217,6598,10815
17,17616,2019-12-31,4294,6346,10640
17,17616,2020-12-31,4370,6198,10568
17,17616,2021-12-31,4543,6116,10659
17,17616,2022-12-31,4703,6050,10753
17,17616,2023-12-31,4853,6004,10857
17,17616,2024-12-31,4946,5967,10913
17,17616,2025-12-31,5003,5935,10938
17,17616,2026-12-31,5075,5932,11007
17,17616,2027-12-31,5126,5929,11055
17,17616,2028-12-31,5178,5941,11119
17,17616,2029-12-31,5228,5962,11190
17,17616,2030-12-31,5263,5999,11262
17,17616,2031-12-31,5307,6063,11370
17,17616,2032-12-31,5341,6093,11434
17,17616,2033-12-31,5370,6132,11502
17,17616,2034-12-31,5407,6203,11610
17,17616,2035-12-31,5438,6230,11668
17,17653,1985-12-31,13664,14124,27788
17,17653,1986-12-31,13578,14047,27625
17,17653,1987-12-31,13517,13930,27447
17,17653,1988-12-31,13442,13856,27298
17,17653,1989-12-31,13377,13748,27125
17,17653,1990-12-31,13303,13612,26915
17,17653,1991-12-31,13230,13479,26709
17,17653,1992-12-31,13171,13345,26516
17,17653,1993-12-31,13093,13196,26289
17,17653,1994-12-31,13046,13034,26080
17,17653,1995-12-31,12989,12870,25859
17,17653,1996-12-31,12944,12690,25634
17,17653,1997-12-31,12866,12513,25379
17,17653,1998-12-31,12781,12339,25120
17,17653,1999-12-31,12723,12134,24857
17,17653,2000-12-31,12645,11939,24584
17,17653,2001-12-31,12576,11726,24302
17,17653,2002-12-31,12501,11501,24002
17,17653,2003-12-31,12319,11255,23574
17,17653,2004-12-31,12267,11008,23275
17,17653,2005-12-31,12165,10761,22926
17,17653,2006-12-31,12036,10501,22537
17,17653,2007-12-31,11966,10251,22217
17,17653,2008-12-31,11900,9996,21896
17,17653,2009-12-31,11812,9780,21592
17,17653,2010-12-31,11675,9547,21222
17,17653,2011-12-31,11632,9372,21004
17,17653,2012-12-31,11585,9114,20699
17,17653,2013-12-31,11508,8951,20459
17,17653,2014-12-31,11406,8678,20084
17,17653,2015-12-31,11343,8539,19882
17,17653,2016-12-31,11341,8362,19703
17,17653,2017-12-31,11366,8278,19644
17,17653,2018-12-31,11359,8108,19467
17,17653,2019-12-31,11427,7960,19387
17,17653,2020-12-31,11541,7852,19393
17,17653,2021-12-31,11815,7744,19559
17,17653,2022-12-31,12074,7659,19733
17,17653,2023-12-31,12323,7600,19923
17,17653,2024-12-31,12501,7550,20051
17,17653,2025-12-31,12663,7524,20187
17,17653,2026-12-31,12823,7496,20319
17,17653,2027-12-31,12963,7497,20460
17,17653,2028-12-31,13094,7507,20601
17,17653,2029-12-31,13208,7534,20742
17,17653,2030-12-31,13316,7575,20891
17,17653,2031-12-31,13407,7623,21030
17,17653,2032-12-31,13502,7681,21183
17,17653,2033-12-31,13583,7733,21316
17,17653,2034-12-31,13668,7784,21452
17,17653,2035-12-31,13751,7844,21595
17,17662,1985-12-31,4616,35633,40249
17,17662,1986-12-31,4666,35688,40354
17,17662,1987-12-31,4686,35743,40429
17,17662,1988-12-31,4732,35765,40497
17,17662,1989-12-31,4777,35749,40526
17,17662,1990-12-31,4838,35685,40523
17,17662,1991-12-31,4880,35610,40490
17,17662,1992-12-31,4940,35519,40459
17,17662,1993-12-31,4987,35396,40383
17,17662,1994-12-31,5017,35323,40340
17,17662,1995-12-31,5063,35180,40243
17,17662,1996-12-31,5105,35003,40108
17,17662,1997-12-31,5186,34777,39963
17,17662,1998-12-31,5225,34648,39873
17,17662,1999-12-31,5276,25939,31215
17,17662,2000-12-31,5300,25359,30659
17,17662,2001-12-31,5312,24722,30034
17,17662,2002-12-31,5293,24089,29382
17,17662,2003-12-31,5364,23415,28779
17,17662,2004-12-31,5379,22725,28104
17,17662,2005-12-31,5401,22014,27415
17,17662,2006-12-31,5435,21336,26771
17,17662,2007-12-31,5416,20660,26076
17,17662,2008-12-31,5419,19986,25405
17,17662,2009-12-31,5435,19344,24779
17,17662,2010-12-31,5496,18730,24226
17,17662,2011-12-31,5542,18137,23679
17,17662,2012-12-31,5585,17567,23152
17,17662,2013-12-31,5643,16990,22633
17,17662,2014-12-31,5688,16449,22137
17,17662,2015-12-31,5740,15888,21628
17,17662,2016-12-31,5794,15350,21144
17,17662,2017-12-31,5855,14895,20750
17,17662,2018-12-31,5924,14530,20454
17,17662,2019-12-31,6039,14077,20116
17,17662,2020-12-31,6150,13817,19967
17,17662,2021-12-31,6504,13634,20138
17,17662,2022-12-31,6829,13488,20317
17,17662,2023-12-31,7128,13385,20513
17,17662,2024-12-31,7273,13317,20590
17,17662,2025-12-31,7384,13274,20658
17,17662,2026-12-31,7473,13226,20699
17,17662,2027-12-31,7556,13235,20791
17,17662,2028-12-31,7635,13276,20911
17,17662,2029-12-31,7702,13326,21028
17,17662,2030-12-31,7773,13425,21198
17,17662,2031-12-31,7814,13512,21326
17,17662,2032-12-31,7864,13614,21478
17,17662,2033-12-31,7920,13726,21646
17,17662,2034-12-31,7974,13828,21802
17,17662,2035-12-31,8025,13940,21965
17,17665,1985-12-31,0,0,0
17,17665,1986-12-31,0,0,0
17,17665,1987-12-31,0,0,0
17,17665,1988-12-31,0,0,0
17,17665,1989-12-31,0,0,0
17,17665,1990-12-31,0,0,0
17,17665,1991-12-31,0,0,0
17,17665,1992-12-31,0,0,0
17,17665,1993-12-31,0,0,0
17,17665,1994-12-31,0,0,0
17,17665,1995-12-31,0,0,0
17,17665,1996-12-31,0,0,0
17,17665,1997-12-31,0,0,0
17,17665,1998-12-31,1471,9107,10578
17,17665,1999-12-31,1494,8820,10314
17,17665,2000-12-31,1432,8547,9979
17,17665,2001-12-31,1414,8260,9674
17,17665,2002-12-31,1402,7948,9350
17,17665,2003-12-31,1407,7631,9038
17,17665,2004-12-31,1378,7331,8709
17,17665,2005-12-31,1357,7007,8364
17,17665,2006-12-31,1364,6695,8059
17,17665,2007-12-31,1353,6400,7753
17,17665,2008-12-31,1322,6099,7421
17,17665,2009-12-31,1378,5808,7186
17,17665,2010-12-31,1360,5527,6887
17,17665,2011-12-31,1328,5254,6582
17,17665,2012-12-31,1301,5003,6304
17,17665,2013-12-31,1297,4696,5993
17,17665,2014-12-31,1271,4467,5738
17,17665,2015-12-31,1274,4234,5508
17,17665,2016-12-31,1272,3990,5262
17,17665,2017-12-31,1276,3761,5037
17,17665,2018-12-31,1282,3553,4835
17,17665,2019-12-31,1305,3570,4875
17,17665,2020-12-31,1328,3588,4916
17,17665,2021-12-31,1417,3541,4958
17,17665,2022-12-31,1499,3503,5002
17,17665,2023-12-31,1574,3476,5050
17,17665,2024-12-31,1611,3460,5071
17,17665,2025-12-31,1634,3433,5067
17,17665,2026-12-31,1649,3439,5088
17,17665,2027-12-31,1670,3437,5107
17,17665,2028-12-31,1687,3436,5123
17,17665,2029-12-31,1705,3458,5163
17,17665,2030-12-31,1721,3479,5200
17,17665,2031-12-31,1729,3510,5239
17,17665,2032-12-31,1741,3547,5288
17,17665,2033-12-31,1747,3560,5307
17,17665,2034-12-31,1760,3581,5341
17,17665,2035-12-31,1773,3612,5385
17,17777,1985-12-31,10747,12600,23347
17,17777,1986-12-31,10848,12802,23650
17,17777,1987-12-31,10919,12990,23909
17,17777,1988-12-31,11005,13191,24196
17,17777,1989-12-31,11114,13342,24456
17,17777,1990-12-31,11206,13503,24709
17,17777,1991-12-31,11286,13656,24942
17,17777,1992-12-31,11390,13806,25196
17,17777,1993-12-31,11483,13949,25432
17,17777,1994-12-31,11586,14088,25674
17,17777,1995-12-31,11684,14227,25911
17,17777,1996-12-31,11781,14315,26096
17,17777,1997-12-31,11872,14418,26290
17,17777,1998-12-31,11924,14542,26466
17,17777,1999-12-31,12026,14605,26631
17,17777,2000-12-31,12108,14688,26796
17,17777,2001-12-31,12179,14743,26922
17,17777,2002-12-31,12246,14807,27053
17,17777,2003-12-31,12304,14804,27108
17,17777,2004-12-31,12368,14804,27172
17,17777,2005-12-31,12418,14783,27201
17,17777,2006-12-31,12439,14783,27222
17,17777,2007-12-31,12472,14765,27237
17,17777,2008-12-31,12551,14745,27296
17,17777,2009-12-31,12673,14727,27400
17,17777,2010-12-31,12712,14715,27427
17,17777,2011-12-31,12740,14736,27476
17,17777,2012-12-31,12799,14755,27554
17,17777,2013-12-31,12808,14773,27581
17,17777,2014-12-31,12928,14820,27748
17,17777,2015-12-31,13067,14840,27907
17,17777,2016-12-31,13151,14878,28029
17,17777,2017-12-31,13239,15006,28245
17,17777,2018-12-31,13493,15149,28642
17,17777,2019-12-31,13756,15265,29021
17,17777,2020-12-31,14008,15355,29363
17,17777,2021-12-31,14465,15155,29620
17,17777,2022-12-31,14891,14993,29884
17,17777,2023-12-31,15294,14877,30171
17,17777,2024-12-31,15569,14778,30347
17,17777,2025-12-31,15793,14722,30515
17,17777,2026-12-31,15998,14697,30695
17,17777,2027-12-31,16186,14700,30886
17,17777,2028-12-31,16337,14712,31049
17,17777,2029-12-31,16486,14787,31273
17,17777,2030-12-31,16622,14872,31494
17,17777,2031-12-31,16735,15007,31742
17,17777,2032-12-31,16841,15140,31981
17,17777,2033-12-31,16951,15268,32219
17,17777,2034-12-31,17067,15365,32432
17,17777,2035-12-31,17154,15468,32622
17,17867,1985-12-31,3439,8857,12296
17,17867,1986-12-31,3458,8817,12275
17,17867,1987-12-31,3489,8760,12249
17,17867,1988-12-31,3517,8749,12266
17,17867,1989-12-31,3536,8715,12251
17,17867,1990-12-31,3562,8652,12214
17,17867,1991-12-31,3596,8605,12201
17,17867,1992-12-31,3628,8553,12181
17,17867,1993-12-31,3662,8467,12129
17,17867,1994-12-31,3688,8389,12077
17,17867,1995-12-31,3724,8330,12054
17,17867,1996-12-31,3757,8253,12010
17,17867,1997-12-31,3795,8131,11926
17,17867,1998-12-31,3797,8080,11877
17,17867,1999-12-31,3828,7974,11802
17,17867,2000-12-31,3852,7869,11721
17,17867,2001-12-31,3904,7769,11673
17,17867,2002-12-31,3924,7642,11566
17,17867,2003-12-31,3902,7516,11418
17,17867,2004-12-31,3901,7388,11289
17,17867,2005-12-31,3902,7253,11155
17,17867,2006-12-31,3925,7089,11014
17,17867,2007-12-31,3921,6985,10906
17,17867,2008-12-31,3937,6841,10778
17,17867,2009-12-31,3976,6746,10722
17,17867,2010-12-31,4012,6581,10593
17,17867,2011-12-31,4035,6444,10479
17,17867,2012-12-31,4066,6346,10412
17,17867,2013-12-31,4105,6228,10333
17,17867,2014-12-31,4119,6093,10212
17,17867,2015-12-31,4161,6029,10190
17,17867,2016-12-31,4200,5963,10163
17,17867,2017-12-31,4244,5896,10140
17,17867,2018-12-31,4296,5861,10157
17,17867,2019-12-31,4375,5880,10255
17,17867,2020-12-31,4450,5901,10351
17,17867,2021-12-31,4616,5824,10440
17,17867,2022-12-31,4771,5762,10533
17,17867,2023-12-31,4917,5717,10634
17,17867,2024-12-31,5008,5684,10692
17,17867,2025-12-31,5078,5661,10739
17,17867,2026-12-31,5136,5642,10778
17,17867,2027-12-31,5187,5651,10838
17,17867,2028-12-31,5239,5668,10907
17,17867,2029-12-31,5295,5696,10991
17,17867,2030-12-31,5332,5731,11063
17,17867,2031-12-31,5379,5762,11141
17,17867,2032-12-31,5406,5802,11208
17,17867,2033-12-31,5449,5846,11295
17,17867,2034-12-31,5477,5897,11374
17,17867,2035-12-31,5507,5943,11450
17,17873,1985-12-31,22760,10566,33326
17,17873,1986-12-31,23843,10590,34433
17,17873,1987-12-31,24924,10614,35538
17,17873,1988-12-31,25993,10643,36636
17,17873,1989-12-31,27066,10666,37732
17,17873,1990-12-31,28118,10664,38782
17,17873,1991-12-31,29187,10663,39850
17,17873,1992-12-31,30254,10663,40917
17,17873,1993-12-31,31311,10602,41913
17,17873,1994-12-31,32393,10602,42995
17,17873,1995-12-31,33473,10568,44041
17,17873,1996-12-31,34532,10527,45059
17,17873,1997-12-31,35612,10479,46091
17,17873,1998-12-31,36571,10437,47008
17,17873,1999-12-31,37618,10374,47992
17,17873,2000-12-31,38627,10302,48929
17,17873,2001-12-31,39569,10238,49807
17,17873,2002-12-31,40520,10141,50661
17,17873,2003-12-31,41430,10033,51463
17,17873,2004-12-31,42320,9935,52255
17,17873,2005-12-31,43144,9833,52977
17,17873,2006-12-31,43998,9695,53693
17,17873,2007-12-31,44895,9583,54478
17,17873,2008-12-31,45779,9470,55249
17,17873,2009-12-31,46660,9365,56025
17,17873,2010-12-31,47597,9251,56848
17,17873,2011-12-31,48499,9179,57678
17,17873,2012-12-31,49425,9050,58475
17,17873,2013-12-31,50366,9001,59367
17,17873,2014-12-31,51397,8911,60308
17,17873,2015-12-31,52376,8817,61193
17,17873,2016-12-31,53466,8795,62261
17,17873,2017-12-31,54578,8837,63415
17,17873,2018-12-31,55894,8758,64652
17,17873,2019-12-31,57787,8402,66189
17,17873,2020-12-31,59390,8039,67429
17,17873,2021-12-31,60088,7932,68020
17,17873,2022-12-31,60777,7848,68625
17,17873,2023-12-31,61498,7787,69285
17,17873,2024-12-31,62359,7748,70107
17,17873,2025-12-31,63184,7712,70896
17,17873,2026-12-31,63951,7696,71647
17,17873,2027-12-31,64672,7691,72363
17,17873,2028-12-31,65313,7715,73028
17,17873,2029-12-31,65896,7745,73641
17,17873,2030-12-31,66420,7805,74225
17,17873,2031-12-31,66894,7881,74775
17,17873,2032-12-31,67354,7934,75288
17,17873,2033-12-31,67797,7993,75790
17,17873,2034-12-31,68207,8044,76251
17,17873,2035-12-31,68621,8095,76716
17,17877,1985-12-31,12228,3622,15850
17,17877,1986-12-31,12185,3605,15790
17,17877,1987-12-31,12128,3567,15695
17,17877,1988-12-31,12092,3551,15643
17,17877,1989-12-31,12035,3514,15549
17,17877,1990-12-31,11982,3478,15460
17,17877,1991-12-31,11957,3452,15409
17,17877,1992-12-31,11909,3405,15314
17,17877,1993-12-31,11868,3368,15236
17,17877,1994-12-31,11835,3339,15174
17,17877,1995-12-31,11806,3268,15074
17,17877,1996-12-31,11762,3231,14993
17,17877,1997-12-31,11729,3160,14889
17,17877,1998-12-31,11656,3138,14794
17,17877,1999-12-31,11619,3096,14715
17,17877,2000-12-31,11579,3022,14601
17,17877,2001-12-31,11505,2964,14469
17,17877,2002-12-31,11440,2896,14336
17,17877,2003-12-31,11385,2852,14237
17,17877,2004-12-31,11296,2800,14096
17,17877,2005-12-31,11210,2699,13909
17,17877,2006-12-31,11127,2647,13774
17,17877,2007-12-31,11056,2580,13636
17,17877,2008-12-31,11010,2541,13551
17,17877,2009-12-31,10951,2467,13418
17,17877,2010-12-31,10878,2401,13279
17,17877,2011-12-31,10836,2300,13136
17,17877,2012-12-31,10819,2252,13071
17,17877,2013-12-31,10783,2211,12994
17,17877,2014-12-31,10720,2192,12912
17,17877,2015-12-31,10671,2170,12841
17,17877,2016-12-31,10685,2080,12765
17,17877,2017-12-31,10739,2030,12769
17,17877,2018-12-31,10705,2029,12734
17,17877,2019-12-31,10791,1989,12780
17,17877,2020-12-31,10912,1941,12853
17,17877,2021-12-31,11048,1915,12963
17,17877,2022-12-31,11183,1895,13078
17,17877,2023-12-31,11324,1880,13204
17,17877,2024-12-31,11466,1863,13329
17,17877,2025-12-31,11606,1856,13462
17,17877,2026-12-31,11733,1854,13587
17,17877,2027-12-31,11865,1847,13712
17,17877,2028-12-31,11985,1852,13837
17,17877,2029-12-31,12089,1864,13953
17,17877,2030-12-31,12178,1882,14060
17,17877,2031-12-31,12263,1900,14163
17,17877,2032-12-31,12343,1908,14251
17,17877,2033-12-31,12428,1923,14351
17,17877,2034-12-31,12494,1936,14430
17,17877,2035-12-31,12581,1948,14529
18,18001,1985-12-31,85034,13186,98220
18,18001,1986-12-31,87860,13565,101425
18,18001,1987-12-31,90678,13951,104629
18,18001,1988-12-31,93364,14311,107675
18,18001,1989-12-31,96059,14662,110721
18,18001,1990-12-31,98659,14997,113656
18,18001,1991-12-31,101184,15314,116498
18,18001,1992-12-31,103611,15636,119247
18,18001,1993-12-31,106064,15936,122000
18,18001,1994-12-31,108347,16198,124545
18,18001,1995-12-31,110661,16427,127088
18,18001,1996-12-31,113138,16628,129766
18,18001,1997-12-31,114441,17046,131487
18,18001,1998-12-31,117197,17282,134479
18,18001,1999-12-31,120309,17431,137740
18,18001,2000-12-31,123617,17498,141115
18,18001,2001-12-31,127065,17482,144547
18,18001,2002-12-31,130388,17445,147833
18,18001,2003-12-31,133299,17445,150744
18,18001,2004-12-31,135728,17519,153247
18,18001,2005-12-31,137463,17563,155026
18,18001,2006-12-31,139007,17716,156723
18,18001,2007-12-31,140240,17927,158167
18,18001,2008-12-31,141359,18144,159503
18,18001,2009-12-31,142339,18382,160721
18,18001,2010-12-31,143214,18649,161863
18,18001,2011-12-31,144050,18887,162937
18,18001,2012-12-31,144755,19130,163885
18,18001,2013-12-31,145432,19366,164798
18,18001,2014-12-31,146041,19598,165639
18,18001,2015-12-31,146531,19828,166359
18,18001,2016-12-31,147113,20044,167157
18,18001,2017-12-31,147561,20241,167802
18,18001,2018-12-31,147939,20407,168346
18,18001,2019-12-31,150300,20464,170764
18,18001,2020-12-31,152536,20475,173011
18,18001,2021-12-31,154331,20508,174839
18,18001,2022-12-31,156114,20592,176706
18,18001,2023-12-31,157923,20717,178640
18,18001,2024-12-31,159820,20864,180684
18,18001,2025-12-31,161597,21046,182643
18,18001,2026-12-31,163321,21252,184573
18,18001,2027-12-31,164920,21508,186428
18,18001,2028-12-31,166380,21776,188156
18,18001,2029-12-31,167736,22117,189853
18,18001,2030-12-31,168938,22479,191417
18,18001,2031-12-31,170081,22879,192960
18,18001,2032-12-31,171124,23276,194400
18,18001,2033-12-31,172141,23657,195798
18,18001,2034-12-31,173068,24062,197130
18,18001,2035-12-31,173937,24455,198392
18,18029,1985-12-31,2526,7743,10269
18,18029,1986-12-31,2533,7665,10198
18,18029,1987-12-31,2535,7573,10108
18,18029,1988-12-31,2558,7478,10036
18,18029,1989-12-31,2541,7366,9907
18,18029,1990-12-31,2520,7255,9775
18,18029,1991-12-31,2518,7124,9642
18,18029,1992-12-31,2524,6986,9510
18,18029,1993-12-31,2502,6846,9348
18,18029,1994-12-31,2485,6674,9159
18,18029,1995-12-31,2484,6508,8992
18,18029,1996-12-31,2467,6296,8763
18,18029,1997-12-31,2426,6182,8608
18,18029,1998-12-31,2416,6039,8455
18,18029,1999-12-31,2411,5837,8248
18,18029,2000-12-31,2425,5621,8046
18,18029,2001-12-31,2465,5369,7834
18,18029,2002-12-31,2451,5134,7585
18,18029,2003-12-31,2451,4896,7347
18,18029,2004-12-31,2441,4697,7138
18,18029,2005-12-31,2447,4531,6978
18,18029,2006-12-31,2415,4374,6789
18,18029,2007-12-31,2393,4180,6573
18,18029,2008-12-31,2360,4039,6399
18,18029,2009-12-31,2328,3894,6222
18,18029,2010-12-31,2307,3759,6066
18,18029,2011-12-31,2302,3611,5913
18,18029,2012-12-31,2261,3467,5728
18,18029,2013-12-31,2208,3310,5518
18,18029,2014-12-31,2182,3168,5350
18,18029,2015-12-31,2149,3027,5176
18,18029,2016-12-31,2078,2871,4949
18,18029,2017-12-31,2060,2761,4821
18,18029,2018-12-31,2060,2615,4675
18,18029,2019-12-31,2088,2403,4491
18,18029,2020-12-31,2117,2279,4396
18,18029,2021-12-31,2160,2282,4442
18,18029,2022-12-31,2198,2291,4489
18,18029,2023-12-31,2233,2305,4538
18,18029,2024-12-31,2262,2327,4589
18,18029,2025-12-31,2281,2339,4620
18,18029,2026-12-31,2309,2352,4661
18,18029,2027-12-31,2330,2381,4711
18,18029,2028-12-31,2358,2414,4772
18,18029,2029-12-31,2380,2452,4832
18,18029,2030-12-31,2397,2493,4890
18,18029,2031-12-31,2410,2539,4949
18,18029,2032-12-31,2417,2576,4993
18,18029,2033-12-31,2441,2617,5058
18,18029,2034-12-31,2449,2653,5102
18,18029,2035-12-31,2463,2708,5171
18,18094,1985-12-31,3336,10691,14027
18,18094,1986-12-31,3473,10629,14102
18,18094,1987-12-31,3626,10492,14118
18,18094,1988-12-31,3773,10401,14174
18,18094,1989-12-31,3912,10279,14191
18,18094,1990-12-31,4034,10144,14178
18,18094,1991-12-31,4176,9970,14146
18,18094,1992-12-31,4305,9807,14112
18,18094,1993-12-31,4423,9606,14029
18,18094,1994-12-31,4557,9402,13959
18,18094,1995-12-31,4674,9193,13867
18,18094,1996-12-31,4807,8935,13742
18,18094,1997-12-31,4882,8824,13706
18,18094,1998-12-31,5033,8619,13652
18,18094,1999-12-31,5193,8356,13549
18,18094,2000-12-31,5351,8067,13418
18,18094,2001-12-31,5533,7756,13289
18,18094,2002-12-31,5711,7444,13155
18,18094,2003-12-31,5854,7151,13005
18,18094,2004-12-31,5974,6901,12875
18,18094,2005-12-31,6066,6668,12734
18,18094,2006-12-31,6160,6453,12613
18,18094,2007-12-31,6225,6244,12469
18,18094,2008-12-31,6297,6057,12354
18,18094,2009-12-31,6355,5878,12233
18,18094,2010-12-31,6408,5699,12107
18,18094,2011-12-31,6466,5519,11985
18,18094,2012-12-31,6517,5331,11848
18,18094,2013-12-31,6570,5148,11718
18,18094,2014-12-31,6608,4984,11592
18,18094,2015-12-31,6649,4786,11435
18,18094,2016-12-31,6701,4604,11305
18,18094,2017-12-31,6741,4443,11184
18,18094,2018-12-31,6753,4268,11021
18,18094,2019-12-31,6866,4236,11102
18,18094,2020-12-31,6973,4208,11181
18,18094,2021-12-31,7084,4213,11297
18,18094,2022-12-31,7188,4230,11418
18,18094,2023-12-31,7286,4256,11542
18,18094,2024-12-31,7378,4288,11666
18,18094,2025-12-31,7458,4330,11788
18,18094,2026-12-31,7548,4369,11917
18,18094,2027-12-31,7617,4412,12029
18,18094,2028-12-31,7688,4485,12173
18,18094,2029-12-31,7747,4535,12282
18,18094,2030-12-31,7806,4604,12410
18,18094,2031-12-31,7850,4695,12545
18,18094,2032-12-31,7900,4760,12660
18,18094,2033-12-31,7951,4833,12784
18,18094,2034-12-31,7984,4911,12895
18,18094,2035-12-31,8025,4975,13000
18,18150,1985-12-31,3616,2297,5913
18,18150,1986-12-31,4079,2676,6755
18,18150,1987-12-31,4533,3129,7662
18,18150,1988-12-31,4974,3589,8563
18,18150,1989-12-31,5423,4046,9469
18,18150,1990-12-31,5864,4496,10360
18,18150,1991-12-31,6283,4962,11245
18,18150,1992-12-31,6728,5409,12137
18,18150,1993-12-31,7141,5854,12995
18,18150,1994-12-31,7548,6292,13840
18,18150,1995-12-31,7981,6708,14689
18,18150,1996-12-31,8392,7106,15498
18,18150,1997-12-31,8744,7588,16332
18,18150,1998-12-31,9190,8047,17237
18,18150,1999-12-31,9665,8410,18075
18,18150,2000-12-31,10134,8732,18866
18,18150,2001-12-31,10635,9016,19651
18,18150,2002-12-31,11093,9273,20366
18,18150,2003-12-31,11545,9536,21081
18,18150,2004-12-31,11973,9847,21820
18,18150,2005-12-31,12329,10160,22489
18,18150,2006-12-31,12648,10503,23151
18,18150,2007-12-31,12974,10866,23840
18,18150,2008-12-31,13251,11238,24489
18,18150,2009-12-31,13512,11606,25118
18,18150,2010-12-31,13782,11985,25767
18,18150,2011-12-31,14011,12382,26393
18,18150,2012-12-31,14250,12755,27005
18,18150,2013-12-31,14470,13144,27614
18,18150,2014-12-31,14682,13520,28202
18,18150,2015-12-31,14883,13909,28792
18,18150,2016-12-31,15080,14293,29373
18,18150,2017-12-31,15263,14629,29892
18,18150,2018-12-31,15434,14965,30399
18,18150,2019-12-31,15914,14864,30778
18,18150,2020-12-31,16314,14837,31151
18,18150,2021-12-31,16624,14856,31480
18,18150,2022-12-31,16901,14916,31817
18,18150,2023-12-31,17157,15007,32164
18,18150,2024-12-31,17388,15134,32522
18,18150,2025-12-31,17602,15260,32862
18,18150,2026-12-31,17790,15407,33197
18,18150,2027-12-31,17963,15586,33549
18,18150,2028-12-31,18134,15779,33913
18,18150,2029-12-31,18280,16014,34294
18,18150,2030-12-31,18407,16273,34680
18,18150,2031-12-31,18535,16563,35098
18,18150,2032-12-31,18649,16822,35471
18,18150,2033-12-31,18753,17119,35872
18,18150,2034-12-31,18869,17382,36251
18,18150,2035-12-31,18966,17668,36634
18,18205,1985-12-31,2217,1948,4165
18,18205,1986-12-31,2335,1943,4278
18,18205,1987-12-31,2469,1974,4443
18,18205,1988-12-31,2593,1997,4590
18,18205,1989-12-31,2715,2035,4750
18,18205,1990-12-31,2833,2059,4892
18,18205,1991-12-31,2948,2076,5024
18,18205,1992-12-31,3066,2115,5181
18,18205,1993-12-31,3175,2143,5318
18,18205,1994-12-31,3280,2136,5416
18,18205,1995-12-31,3404,2145,5549
18,18205,1996-12-31,3503,2153,5656
18,18205,1997-12-31,3570,2196,5766
18,18205,1998-12-31,3728,2212,5940
18,18205,1999-12-31,3845,2224,6069
18,18205,2000-12-31,3983,2212,6195
18,18205,2001-12-31,4118,2187,6305
18,18205,2002-12-31,4275,2182,6457
18,18205,2003-12-31,4392,2163,6555
18,18205,2004-12-31,4498,2151,6649
18,18205,2005-12-31,4594,2164,6758
18,18205,2006-12-31,4667,2156,6823
18,18205,2007-12-31,4720,2172,6892
18,18205,2008-12-31,4803,2187,6990
18,18205,2009-12-31,4866,2200,7066
18,18205,2010-12-31,4921,2223,7144
18,18205,2011-12-31,4972,2234,7206
18,18205,2012-12-31,5001,2232,7233
18,18205,2013-12-31,5071,2246,7317
18,18205,2014-12-31,5116,2280,7396
18,18205,2015-12-31,5152,2302,7454
18,18205,2016-12-31,5199,2324,7523
18,18205,2017-12-31,5260,2335,7595
18,18205,2018-12-31,5261,2332,7593
18,18205,2019-12-31,5349,2334,7683
18,18205,2020-12-31,5432,2340,7772
18,18205,2021-12-31,5510,2344,7854
18,18205,2022-12-31,5585,2353,7938
18,18205,2023-12-31,5658,2367,8025
18,18205,2024-12-31,5720,2375,8095
18,18205,2025-12-31,5796,2402,8198
18,18205,2026-12-31,5852,2430,8282
18,18205,2027-12-31,5910,2456,8366
18,18205,2028-12-31,5966,2492,8458
18,18205,2029-12-31,6016,2518,8534
18,18205,2030-12-31,6062,2567,8629
18,18205,2031-12-31,6103,2596,8699
18,18205,2032-12-31,6137,2656,8793
18,18205,2033-12-31,6175,2690,8865
18,18205,2034-12-31,6203,2730,8933
18,18205,2035-12-31,6241,2784,9025
18,18247,1985-12-31,13311,7754,21065
18,18247,1986-12-31,13411,7804,21215
18,18247,1987-12-31,13493,7809,21302
18,18247,1988-12-31,13570,7826,21396
18,18247,1989-12-31,13645,7819,21464
18,18247,1990-12-31,13701,7801,21502
18,18247,1991-12-31,13748,7774,21522
18,18247,1992-12-31,13788,7736,21524
18,18247,1993-12-31,13840,7693,21533
18,18247,1994-12-31,13854,7652,21506
18,18247,1995-12-31,13897,7574,21471
18,18247,1996-12-31,13947,7497,21444
18,18247,1997-12-31,13865,7502,21367
18,18247,1998-12-31,13949,7462,21411
18,18247,1999-12-31,14089,7350,21439
18,18247,2000-12-31,14240,7200,21440
18,18247,2001-12-31,14402,7035,21437
18,18247,2002-12-31,14550,6864,21414
18,18247,2003-12-31,14651,6700,21351
18,18247,2004-12-31,14700,6591,21291
18,18247,2005-12-31,14675,6465,21140
18,18247,2006-12-31,14634,6392,21026
18,18247,2007-12-31,14577,6354,20931
18,18247,2008-12-31,14506,6288,20794
18,18247,2009-12-31,14420,6233,20653
18,18247,2010-12-31,14326,6163,20489
18,18247,2011-12-31,14234,6133,20367
18,18247,2012-12-31,14137,6087,20224
18,18247,2013-12-31,14036,6036,20072
18,18247,2014-12-31,13939,5995,19934
18,18247,2015-12-31,13840,5924,19764
18,18247,2016-12-31,13756,5849,19605
18,18247,2017-12-31,13651,5779,19430
18,18247,2018-12-31,13522,5772,19294
18,18247,2019-12-31,13457,5799,19256
18,18247,2020-12-31,13467,5817,19284
18,18247,2021-12-31,13658,5826,19484
18,18247,2022-12-31,13843,5849,19692
18,18247,2023-12-31,14022,5885,19907
18,18247,2024-12-31,14204,5928,20132
18,18247,2025-12-31,14374,5976,20350
18,18247,2026-12-31,14524,6035,20559
18,18247,2027-12-31,14669,6101,20770
18,18247,2028-12-31,14797,6183,20980
18,18247,2029-12-31,14919,6274,21193
18,18247,2030-12-31,15035,6380,21415
18,18247,2031-12-31,15126,6475,21601
18,18247,2032-12-31,15210,6589,21799
18,18247,2033-12-31,15293,6680,21973
18,18247,2034-12-31,15388,6807,22195
18,18247,2035-12-31,15452,6904,22356
18,18256,1985-12-31,6226,5861,12087
18,18256,1986-12-31,6382,6053,12435
18,18256,1987-12-31,6503,6220,12723
18,18256,1988-12-31,6634,6403,13037
18,18256,1989-12-31,6750,6555,13305
18,18256,1990-12-31,6881,6702,13583
18,18256,1991-12-31,6991,6842,13833
18,18256,1992-12-31,7098,6990,14088
18,18256,1993-12-31,7209,7127,14336
18,18256,1994-12-31,7300,7247,14547
18,18256,1995-12-31,7410,7354,14764
18,18256,1996-12-31,7514,7452,14966
18,18256,1997-12-31,7555,7628,15183
18,18256,1998-12-31,7687,7738,15425
18,18256,1999-12-31,7844,7823,15667
18,18256,2000-12-31,8021,7833,15854
18,18256,2001-12-31,8201,7836,16037
18,18256,2002-12-31,8356,7822,16178
18,18256,2003-12-31,8497,7832,16329
18,18256,2004-12-31,8614,7826,16440
18,18256,2005-12-31,8684,7883,16567
18,18256,2006-12-31,8735,7950,16685
18,18256,2007-12-31,8770,8055,16825
18,18256,2008-12-31,8792,8158,16950
18,18256,2009-12-31,8813,8274,17087
18,18256,2010-12-31,8825,8363,17188
18,18256,2011-12-31,8858,8479,17337
18,18256,2012-12-31,8858,8593,17451
18,18256,2013-12-31,8862,8706,17568
18,18256,2014-12-31,8868,8800,17668
18,18256,2015-12-31,8865,8897,17762
18,18256,2016-12-31,8876,8980,17856
18,18256,2017-12-31,8874,9085,17959
18,18256,2018-12-31,8858,9178,18036
18,18256,2019-12-31,9005,9246,18251
18,18256,2020-12-31,9144,9320,18464
18,18256,2021-12-31,9325,9334,18659
18,18256,2022-12-31,9488,9371,18859
18,18256,2023-12-31,9636,9429,19065
18,18256,2024-12-31,9767,9497,19264
18,18256,2025-12-31,9876,9574,19450
18,18256,2026-12-31,9975,9675,19650
18,18256,2027-12-31,10078,9795,19873
18,18256,2028-12-31,10175,9901,20076
18,18256,2029-12-31,10236,10058,20294
18,18256,2030-12-31,10313,10221,20534
18,18256,2031-12-31,10395,10399,20794
18,18256,2032-12-31,10454,10570,21024
18,18256,2033-12-31,10537,10746,21283
18,18256,2034-12-31,10580,10910,21490
18,18256,2035-12-31,10624,11075,21699
18,18410,1985-12-31,2251,11465,13716
18,18410,1986-12-31,2265,11640,13905
18,18410,1987-12-31,2300,11794,14094
18,18410,1988-12-31,2319,11927,14246
18,18410,1989-12-31,2315,12056,14371
18,18410,1990-12-31,2331,12175,14506
18,18410,1991-12-31,2344,12277,14621
18,18410,1992-12-31,2353,12352,14705
18,18410,1993-12-31,2349,12421,14770
18,18410,1994-12-31,2383,12463,14846
18,18410,1995-12-31,2427,12465,14892
18,18410,1996-12-31,2440,12451,14891
18,18410,1997-12-31,2423,12608,15031
18,18410,1998-12-31,2438,12646,15084
18,18410,1999-12-31,2464,12591,15055
18,18410,2000-12-31,2514,12504,15018
18,18410,2001-12-31,2544,12344,14888
18,18410,2002-12-31,2573,12186,14759
18,18410,2003-12-31,2599,12044,14643
18,18410,2004-12-31,2610,11955,14565
18,18410,2005-12-31,2611,11880,14491
18,18410,2006-12-31,2608,11869,14477
18,18410,2007-12-31,2612,11883,14495
18,18410,2008-12-31,2580,11923,14503
18,18410,2009-12-31,2578,11962,14540
18,18410,2010-12-31,2564,11996,14560
18,18410,2011-12-31,2562,12040,14602
18,18410,2012-12-31,2553,12086,14639
18,18410,2013-12-31,2539,12120,14659
18,18410,2014-12-31,2511,12148,14659
18,18410,2015-12-31,2529,12193,14722
18,18410,2016-12-31,2498,12222,14720
18,18410,2017-12-31,2490,12240,14730
18,18410,2018-12-31,2467,12247,14714
18,18410,2019-12-31,2535,12127,14662
18,18410,2020-12-31,2609,12083,14692
18,18410,2021-12-31,2745,12099,14844
18,18410,2022-12-31,2856,12147,15003
18,18410,2023-12-31,2945,12222,15167
18,18410,2024-12-31,2998,12314,15312
18,18410,2025-12-31,3040,12414,15454
18,18410,2026-12-31,3076,12549,15625
18,18410,2027-12-31,3098,12676,15774
18,18410,2028-12-31,3131,12854,15985
18,18410,2029-12-31,3150,13024,16174
18,18410,2030-12-31,3176,13228,16404
18,18410,2031-12-31,3184,13443,16627
18,18410,2032-12-31,3225,13681,16906
18,18410,2033-12-31,3232,13895,17127
18,18410,2034-12-31,3251,14120,17371
18,18410,2035-12-31,3273,14329,17602
18,18460,1985-12-31,1378,6887,8265
18,18460,1986-12-31,1414,7013,8427
18,18460,1987-12-31,1392,7153,8545
18,18460,1988-12-31,1371,7283,8654
18,18460,1989-12-31,1369,7407,8776
18,18460,1990-12-31,1364,7520,8884
18,18460,1991-12-31,1341,7631,8972
18,18460,1992-12-31,1341,7731,9072
18,18460,1993-12-31,1316,7813,9129
18,18460,1994-12-31,1320,7897,9217
18,18460,1995-12-31,1297,7949,9246
18,18460,1996-12-31,1274,7972,9246
18,18460,1997-12-31,1256,8113,9369
18,18460,1998-12-31,1261,8185,9446
18,18460,1999-12-31,1243,8199,9442
18,18460,2000-12-31,1244,8173,9417
18,18460,2001-12-31,1255,8111,9366
18,18460,2002-12-31,1248,8050,9298
18,18460,2003-12-31,1258,8038,9296
18,18460,2004-12-31,1241,7996,9237
18,18460,2005-12-31,1228,7998,9226
18,18460,2006-12-31,1215,8009,9224
18,18460,2007-12-31,1213,8051,9264
18,18460,2008-12-31,1184,8157,9341
18,18460,2009-12-31,1173,8199,9372
18,18460,2010-12-31,1144,8265,9409
18,18460,2011-12-31,1134,8326,9460
18,18460,2012-12-31,1159,8396,9555
18,18460,2013-12-31,1126,8471,9597
18,18460,2014-12-31,1064,8525,9589
18,18460,2015-12-31,1024,8580,9604
18,18460,2016-12-31,1009,8627,9636
18,18460,2017-12-31,999,8681,9680
18,18460,2018-12-31,1001,8722,9723
18,18460,2019-12-31,1003,8835,9838
18,18460,2020-12-31,1010,8942,9952
18,18460,2021-12-31,1102,8955,10057
18,18460,2022-12-31,1174,8991,10165
18,18460,2023-12-31,1230,9046,10276
18,18460,2024-12-31,1248,9110,10358
18,18460,2025-12-31,1272,9181,10453
18,18460,2026-12-31,1278,9287,10565
18,18460,2027-12-31,1292,9382,10674
18,18460,2028-12-31,1303,9509,10812
18,18460,2029-12-31,1306,9649,10955
18,18460,2030-12-31,1316,9807,11123
18,18460,2031-12-31,1331,9976,11307
18,18460,2032-12-31,1338,10137,11475
18,18460,2033-12-31,1340,10302,11642
18,18460,2034-12-31,1354,10474,11828
18,18460,2035-12-31,1366,10641,12007
18,18479,1985-12-31,1420,1567,2987
18,18479,1986-12-31,1454,1595,3049
18,18479,1987-12-31,1480,1635,3115
18,18479,1988-12-31,1515,1650,3165
18,18479,1989-12-31,1535,1664,3199
18,18479,1990-12-31,1559,1680,3239
18,18479,1991-12-31,1591,1685,3276
18,18479,1992-12-31,1604,1702,3306
18,18479,1993-12-31,1627,1713,3340
18,18479,1994-12-31,1686,1706,3392
18,18479,1995-12-31,1686,1718,3404
18,18479,1996-12-31,1681,1706,3387
18,18479,1997-12-31,1716,1732,3448
18,18479,1998-12-31,1745,1738,3483
18,18479,1999-12-31,1773,1724,3497
18,18479,2000-12-31,1808,1726,3534
18,18479,2001-12-31,1878,1697,3575
18,18479,2002-12-31,1908,1666,3574
18,18479,2003-12-31,1929,1660,3589
18,18479,2004-12-31,1951,1640,3591
18,18479,2005-12-31,1982,1645,3627
18,18479,2006-12-31,1967,1642,3609
18,18479,2007-12-31,1982,1628,3610
18,18479,2008-12-31,1993,1648,3641
18,18479,2009-12-31,1998,1636,3634
18,18479,2010-12-31,2008,1647,3655
18,18479,2011-12-31,2003,1649,3652
18,18479,2012-12-31,1993,1666,3659
18,18479,2013-12-31,1990,1651,3641
18,18479,2014-12-31,2006,1659,3665
18,18479,2015-12-31,2054,1678,3732
18,18479,2016-12-31,2014,1716,3730
18,18479,2017-12-31,1994,1700,3694
18,18479,2018-12-31,2007,1691,3698
18,18479,2019-12-31,2029,1689,3718
18,18479,2020-12-31,2050,1697,3747
18,18479,2021-12-31,2086,1700,3786
18,18479,2022-12-31,2120,1706,3826
18,18479,2023-12-31,2151,1717,3868
18,18479,2024-12-31,2180,1722,3902
18,18479,2025-12-31,2212,1737,3949
18,18479,2026-12-31,2228,1759,3987
18,18479,2027-12-31,2249,1777,4026
18,18479,2028-12-31,2263,1788,4051
18,18479,2029-12-31,2285,1825,4110
18,18479,2030-12-31,2308,1853,4161
18,18479,2031-12-31,2324,1887,4211
18,18479,2032-12-31,2343,1912,4255
18,18479,2033-12-31,2341,1962,4303
18,18479,2034-12-31,2354,1982,4336
18,18479,2035-12-31,2366,2004,4370
18,18592,1985-12-31,11492,20209,31701
18,18592,1986-12-31,11665,20180,31845
18,18592,1987-12-31,11838,20124,31962
18,18592,1988-12-31,12033,20040,32073
18,18592,1989-12-31,12185,19921,32106
18,18592,1990-12-31,12335,19778,32113
18,18592,1991-12-31,12486,19631,32117
18,18592,1992-12-31,12612,19431,32043
18,18592,1993-12-31,12742,19223,31965
18,18592,1994-12-31,12862,18966,31828
18,18592,1995-12-31,12990,18695,31685
18,18592,1996-12-31,13149,18366,31515
18,18592,1997-12-31,13141,18298,31439
18,18592,1998-12-31,13307,18008,31315
18,18592,1999-12-31,13525,17672,31197
18,18592,2000-12-31,13787,17201,30988
18,18592,2001-12-31,14020,16705,30725
18,18592,2002-12-31,14268,16188,30456
18,18592,2003-12-31,14450,15736,30186
18,18592,2004-12-31,14591,15349,29940
18,18592,2005-12-31,14657,14995,29652
18,18592,2006-12-31,14695,14712,29407
18,18592,2007-12-31,14716,14480,29196
18,18592,2008-12-31,14734,14250,28984
18,18592,2009-12-31,14723,14038,28761
18,18592,2010-12-31,14719,13831,28550
18,18592,2011-12-31,14700,13634,28334
18,18592,2012-12-31,14684,13417,28101
18,18592,2013-12-31,14660,13186,27846
18,18592,2014-12-31,14633,12966,27599
18,18592,2015-12-31,14600,12733,27333
18,18592,2016-12-31,14570,12515,27085
18,18592,2017-12-31,14537,12304,26841
18,18592,2018-12-31,14464,12053,26517
18,18592,2019-12-31,14590,11739,26329
18,18592,2020-12-31,14729,11553,26282
18,18592,2021-12-31,14986,11568,26554
18,18592,2022-12-31,15224,11614,26838
18,18592,2023-12-31,15445,11686,27131
18,18592,2024-12-31,15632,11781,27413
18,18592,2025-12-31,15817,11880,27697
18,18592,2026-12-31,15975,12001,27976
18,18592,2027-12-31,16146,12126,28272
18,18592,2028-12-31,16267,12294,28561
18,18592,2029-12-31,16408,12453,28861
18,18592,2030-12-31,16505,12650,29155
18,18592,2031-12-31,16639,12890,29529
18,18592,2032-12-31,16743,13108,29851
18,18592,2033-12-31,16830,13317,30147
18,18592,2034-12-31,16931,13505,30436
18,18592,2035-12-31,17018,13715,30733
18,18610,1985-12-31,3092,141,3233
18,18610,1986-12-31,3215,352,3567
18,18610,1987-12-31,3350,580,3930
18,18610,1988-12-31,3490,790,4280
18,18610,1989-12-31,3608,1028,4636
18,18610,1990-12-31,3723,1230,4953
18,18610,1991-12-31,3830,1438,5268
18,18610,1992-12-31,3970,1671,5641
18,18610,1993-12-31,4112,1890,6002
18,18610,1994-12-31,4234,2114,6348
18,18610,1995-12-31,4326,2322,6648
18,18610,1996-12-31,4439,2527,6966
18,18610,1997-12-31,4524,2754,7278
18,18610,1998-12-31,4659,2967,7626
18,18610,1999-12-31,4781,3156,7937
18,18610,2000-12-31,4970,3324,8294
18,18610,2001-12-31,5126,3500,8626
18,18610,2002-12-31,5315,3643,8958
18,18610,2003-12-31,5475,3781,9256
18,18610,2004-12-31,5576,3939,9515
18,18610,2005-12-31,5650,4084,9734
18,18610,2006-12-31,5731,4272,10003
18,18610,2007-12-31,5793,4449,10242
18,18610,2008-12-31,5879,4630,10509
18,18610,2009-12-31,5941,4831,10772
18,18610,2010-12-31,5976,5022,10998
18,18610,2011-12-31,6033,5198,11231
18,18610,2012-12-31,6084,5413,11497
18,18610,2013-12-31,6125,5583,11708
18,18610,2014-12-31,6155,5768,11923
18,18610,2015-12-31,6216,5960,12176
18,18610,2016-12-31,6239,6140,12379
18,18610,2017-12-31,6280,6323,12603
18,18610,2018-12-31,6292,6505,12797
18,18610,2019-12-31,6510,6439,12949
18,18610,2020-12-31,6693,6406,13099
18,18610,2021-12-31,6823,6414,13237
18,18610,2022-12-31,6939,6440,13379
18,18610,2023-12-31,7045,6480,13525
18,18610,2024-12-31,7135,6531,13666
18,18610,2025-12-31,7216,6590,13806
18,18610,2026-12-31,7312,6649,13961
18,18610,2027-12-31,7379,6721,14100
18,18610,2028-12-31,7444,6813,14257
18,18610,2029-12-31,7499,6902,14401
18,18610,2030-12-31,7557,7033,14590
18,18610,2031-12-31,7594,7138,14732
18,18610,2032-12-31,7655,7257,14912
18,18610,2033-12-31,7698,7379,15077
18,18610,2034-12-31,7743,7498,15241
18,18610,2035-12-31,7775,7612,15387
18,18753,1985-12-31,10583,14631,25214
18,18753,1986-12-31,11106,15254,26360
18,18753,1987-12-31,11642,15827,27469
18,18753,1988-12-31,12167,16389,28556
18,18753,1989-12-31,12676,16953,29629
18,18753,1990-12-31,13178,17484,30662
18,18753,1991-12-31,13659,18033,31692
18,18753,1992-12-31,14144,18528,32672
18,18753,1993-12-31,14625,19011,33636
18,18753,1994-12-31,15098,19461,34559
18,18753,1995-12-31,15556,19844,35400
18,18753,1996-12-31,16019,20187,36206
18,18753,1997-12-31,16359,20822,37181
18,18753,1998-12-31,16876,21229,38105
18,18753,1999-12-31,17464,21544,39008
18,18753,2000-12-31,18075,21658,39733
18,18753,2001-12-31,18710,21718,40428
18,18753,2002-12-31,19332,21785,41117
18,18753,2003-12-31,19869,21874,41743
18,18753,2004-12-31,20352,22049,42401
18,18753,2005-12-31,20717,22251,42968
18,18753,2006-12-31,21031,22575,43606
18,18753,2007-12-31,21310,22949,44259
18,18753,2008-12-31,21587,23339,44926
18,18753,2009-12-31,21826,23756,45582
18,18753,2010-12-31,22053,24215,46268
18,18753,2011-12-31,22263,24639,46902
18,18753,2012-12-31,22470,25051,47521
18,18753,2013-12-31,22655,25463,48118
18,18753,2014-12-31,22837,25847,48684
18,18753,2015-12-31,22985,26222,49207
18,18753,2016-12-31,23150,26632,49782
18,18753,2017-12-31,23315,26965,50280
18,18753,2018-12-31,23432,27287,50719
18,18753,2019-12-31,24190,27524,51714
18,18753,2020-12-31,24938,27655,52593
18,18753,2021-12-31,25452,27697,53149
18,18753,2022-12-31,25910,27807,53717
18,18753,2023-12-31,26326,27978,54304
18,18753,2024-12-31,26700,28161,54861
18,18753,2025-12-31,27037,28410,55447
18,18753,2026-12-31,27362,28681,56043
18,18753,2027-12-31,27635,29013,56648
18,18753,2028-12-31,27900,29405,57305
18,18753,2029-12-31,28143,29846,57989
18,18753,2030-12-31,28359,30329,58688
18,18753,2031-12-31,28529,30851,59380
18,18753,2032-12-31,28719,31383,60102
18,18753,2033-12-31,28877,31927,60804
18,18753,2034-12-31,29032,32449,61481
18,18753,2035-12-31,29177,33002,62179
18,18756,1985-12-31,1071,3831,4902
18,18756,1986-12-31,1173,4047,5220
18,18756,1987-12-31,1226,4243,5469
18,18756,1988-12-31,1295,4442,5737
18,18756,1989-12-31,1369,4620,5989
18,18756,1990-12-31,1424,4818,6242
18,18756,1991-12-31,1505,5008,6513
18,18756,1992-12-31,1577,5190,6767
18,18756,1993-12-31,1634,5363,6997
18,18756,1994-12-31,1675,5514,7189
18,18756,1995-12-31,1741,5657,7398
18,18756,1996-12-31,1797,5791,7588
18,18756,1997-12-31,1847,6009,7856
18,18756,1998-12-31,1912,6156,8068
18,18756,1999-12-31,1999,6277,8276
18,18756,2000-12-31,2060,6377,8437
18,18756,2001-12-31,2148,6422,8570
18,18756,2002-12-31,2185,6485,8670
18,18756,2003-12-31,2266,6536,8802
18,18756,2004-12-31,2320,6614,8934
18,18756,2005-12-31,2363,6717,9080
18,18756,2006-12-31,2424,6826,9250
18,18756,2007-12-31,2493,6935,9428
18,18756,2008-12-31,2521,7070,9591
18,18756,2009-12-31,2558,7212,9770
18,18756,2010-12-31,2610,7351,9961
18,18756,2011-12-31,2633,7488,10121
18,18756,2012-12-31,2648,7633,10281
18,18756,2013-12-31,2685,7772,10457
18,18756,2014-12-31,2695,7914,10609
18,18756,2015-12-31,2721,8047,10768
18,18756,2016-12-31,2755,8178,10933
18,18756,2017-12-31,2775,8310,11085
18,18756,2018-12-31,2782,8432,11214
18,18756,2019-12-31,2818,8541,11359
18,18756,2020-12-31,2851,8652,11503
18,18756,2021-12-31,2960,8665,11625
18,18756,2022-12-31,3049,8700,11749
18,18756,2023-12-31,3124,8753,11877
18,18756,2024-12-31,3160,8813,11973
18,18756,2025-12-31,3204,8881,12085
18,18756,2026-12-31,3235,8970,12205
18,18756,2027-12-31,3258,9092,12350
18,18756,2028-12-31,3298,9181,12479
18,18756,2029-12-31,3317,9319,12636
18,18756,2030-12-31,3345,9476,12821
18,18756,2031-12-31,3371,9644,13015
18,18756,2032-12-31,3394,9815,13209
18,18756,2033-12-31,3409,9965,13374
18,18756,2034-12-31,3427,10121,13548
18,18756,2035-12-31,3448,10275,13723
18,18785,1985-12-31,0,0,0
18,18785,1986-12-31,0,0,0
18,18785,1987-12-31,0,0,0
18,18785,1988-12-31,0,0,0
18,18785,1989-12-31,0,0,0
18,18785,1990-12-31,0,0,0
18,18785,1991-12-31,0,0,0
18,18785,1992-12-31,0,0,0
18,18785,1993-12-31,0,0,0
18,18785,1994-12-31,0,0,0
18,18785,1995-12-31,0,0,0
18,18785,1996-12-31,0,0,0
18,18785,1997-12-31,2179,6535,8714
18,18785,1998-12-31,2279,6344,8623
18,18785,1999-12-31,2370,6120,8490
18,18785,2000-12-31,2508,5870,8378
18,18785,2001-12-31,2598,5606,8204
18,18785,2002-12-31,2728,5336,8064
18,18785,2003-12-31,2846,5096,7942
18,18785,2004-12-31,2929,4882,7811
18,18785,2005-12-31,2988,4682,7670
18,18785,2006-12-31,3076,4503,7579
18,18785,2007-12-31,3152,4326,7478
18,18785,2008-12-31,3176,4123,7299
18,18785,2009-12-31,3247,3979,7226
18,18785,2010-12-31,3326,3819,7145
18,18785,2011-12-31,3343,3660,7003
18,18785,2012-12-31,3435,3495,6930
18,18785,2013-12-31,3451,3343,6794
18,18785,2014-12-31,3509,3163,6672
18,18785,2015-12-31,3563,3019,6582
18,18785,2016-12-31,3599,2830,6429
18,18785,2017-12-31,3637,2703,6340
18,18785,2018-12-31,3672,2544,6216
18,18785,2019-12-31,3743,2537,6280
18,18785,2020-12-31,3815,2531,6346
18,18785,2021-12-31,3878,2534,6412
18,18785,2022-12-31,3936,2544,6480
18,18785,2023-12-31,3991,2560,6551
18,18785,2024-12-31,4039,2580,6619
18,18785,2025-12-31,4092,2606,6698
18,18785,2026-12-31,4129,2627,6756
18,18785,2027-12-31,4178,2661,6839
18,18785,2028-12-31,4209,2693,6902
18,18785,2029-12-31,4250,2727,6977
18,18785,2030-12-31,4277,2770,7047
18,18785,2031-12-31,4307,2810,7117
18,18785,2032-12-31,4331,2846,7177
18,18785,2033-12-31,4362,2895,7257
18,18785,2034-12-31,4382,2970,7352
18,18785,2035-12-31,4407,3012,7419
18,18860,1985-12-31,3326,4070,7396
18,18860,1986-12-31,3291,5415,8706
18,18860,1987-12-31,3278,6799,10077
18,18860,1988-12-31,3247,8167,11414
18,18860,1989-12-31,3226,9554,12780
18,18860,1990-12-31,3220,10952,14172
18,18860,1991-12-31,3194,12356,15550
18,18860,1992-12-31,3166,13736,16902
18,18860,1993-12-31,3156,15109,18265
18,18860,1994-12-31,3115,16447,19562
18,18860,1995-12-31,3090,17735,20825
18,18860,1996-12-31,3070,18979,22049
18,18860,1997-12-31,3012,11431,14443
18,18860,1998-12-31,2998,11114,14112
18,18860,1999-12-31,2997,10734,13731
18,18860,2000-12-31,3008,10306,13314
18,18860,2001-12-31,3007,9839,12846
18,18860,2002-12-31,3002,9357,12359
18,18860,2003-12-31,2980,8937,11917
18,18860,2004-12-31,2965,8548,11513
18,18860,2005-12-31,2925,8208,11133
18,18860,2006-12-31,2880,7907,10787
18,18860,2007-12-31,2847,7621,10468
18,18860,2008-12-31,2801,7318,10119
18,18860,2009-12-31,2753,7042,9795
18,18860,2010-12-31,2715,6760,9475
18,18860,2011-12-31,2677,6491,9168
18,18860,2012-12-31,2609,6213,8822
18,18860,2013-12-31,2579,5943,8522
18,18860,2014-12-31,2545,5657,8202
18,18860,2015-12-31,2496,5363,7859
18,18860,2016-12-31,2440,5081,7521
18,18860,2017-12-31,2358,4805,7163
18,18860,2018-12-31,2336,4551,6887
18,18860,2019-12-31,2326,4642,6968
18,18860,2020-12-31,2332,4716,7048
18,18860,2021-12-31,2399,4723,7122
18,18860,2022-12-31,2457,4742,7199
18,18860,2023-12-31,2506,4771,7277
18,18860,2024-12-31,2533,4808,7341
18,18860,2025-12-31,2563,4851,7414
18,18860,2026-12-31,2585,4892,7477
18,18860,2027-12-31,2620,4941,7561
18,18860,2028-12-31,2646,5008,7654
18,18860,2029-12-31,2669,5086,7755
18,18860,2030-12-31,2693,5171,7864
18,18860,2031-12-31,2703,5248,7951
18,18860,2032-12-31,2719,5337,8056
18,18860,2033-12-31,2741,5424,8165
18,18860,2034-12-31,2752,5501,8253
18,18860,2035-12-31,2764,5572,8336
19,19001,1985-12-31,171626,21323,192949
19,19001,1986-12-31,174225,22290,196515
19,19001,1987-12-31,176942,23271,200213
19,19001,1988-12-31,179680,24207,203887
19,19001,1989-12-31,182468,25169,207637
19,19001,1990-12-31,182035,26387,208422
19,19001,1991-12-31,183187,27450,210637
19,19001,1992-12-31,186225,28360,214585
19,19001,1993-12-31,188683,29474,218157
19,19001,1994-12-31,192654,30354,223008
19,19001,1995-12-31,196171,31284,227455
19,19001,1996-12-31,199764,32199,231963
19,19001,1997-12-31,203131,33189,236320
19,19001,1998-12-31,209124,33910,243034
19,19001,1999-12-31,207981,35238,243219
19,19001,2000-12-31,213885,35907,249792
19,19001,2001-12-31,219914,36627,256541
19,19001,2002-12-31,223123,37556,260679
19,19001,2003-12-31,226171,38486,264657
19,19001,2004-12-31,229158,39410,268568
19,19001,2005-12-31,231958,40303,272261
19,19001,2006-12-31,234936,41201,276137
19,19001,2007-12-31,234180,42465,276645
19,19001,2008-12-31,239013,43102,282115
19,19001,2009-12-31,241783,43968,285751
19,19001,2010-12-31,244614,44798,289412
19,19001,2011-12-31,247337,45651,292988
19,19001,2012-12-31,249951,46480,296431
19,19001,2013-12-31,252519,47300,299819
19,19001,2014-12-31,255150,48117,303267
19,19001,2015-12-31,257837,48945,306782
19,19001,2016-12-31,260610,49799,310409
19,19001,2017-12-31,263403,50651,314054
19,19001,2018-12-31,266561,51498,318059
19,19001,2019-12-31,267100,54891,321991
19,19001,2020-12-31,267389,58088,325477
19,19001,2021-12-31,269271,58868,328139
19,19001,2022-12-31,271119,59631,330750
19,19001,2023-12-31,273004,60378,333382
19,19001,2024-12-31,273861,61073,334934
19,19001,2025-12-31,274312,61772,336084
19,19001,2026-12-31,274732,62457,337189
19,19001,2027-12-31,275270,63107,338377
19,19001,2028-12-31,275848,63739,339587
19,19001,2029-12-31,276541,64347,340888
19,19001,2030-12-31,277304,64926,342230
19,19001,2031-12-31,278134,65478,343612
19,19001,2032-12-31,278878,66026,344904
19,19001,2033-12-31,279539,66565,346104
19,19001,2034-12-31,280168,67082,347250
19,19001,2035-12-31,280671,67603,348274
19,19022,1985-12-31,1743,18788,20531
19,19022,1986-12-31,1742,18640,20382
19,19022,1987-12-31,1725,18516,20241
19,19022,1988-12-31,1703,18402,20105
19,19022,1989-12-31,1681,18296,19977
19,19022,1990-12-31,1636,18387,20023
19,19022,1991-12-31,1582,18371,19953
19,19022,1992-12-31,1573,18268,19841
19,19022,1993-12-31,1554,18279,19833
19,19022,1994-12-31,1570,18165,19735
19,19022,1995-12-31,1536,18082,19618
19,19022,1996-12-31,1536,18018,19554
19,19022,1997-12-31,1556,17999,19555
19,19022,1998-12-31,1548,17831,19379
19,19022,1999-12-31,1490,17984,19474
19,19022,2000-12-31,1528,17803,19331
19,19022,2001-12-31,1541,17647,19188
19,19022,2002-12-31,1528,17630,19158
19,19022,2003-12-31,1508,17599,19107
19,19022,2004-12-31,1495,17560,19055
19,19022,2005-12-31,1478,17518,18996
19,19022,2006-12-31,1484,17480,18964
19,19022,2007-12-31,1432,17617,19049
19,19022,2008-12-31,1459,17473,18932
19,19022,2009-12-31,1431,17422,18853
19,19022,2010-12-31,1407,17371,18778
19,19022,2011-12-31,1384,17357,18741
19,19022,2012-12-31,1381,17292,18673
19,19022,2013-12-31,1362,17248,18610
19,19022,2014-12-31,1359,17198,18557
19,19022,2015-12-31,1354,17167,18521
19,19022,2016-12-31,1355,17135,18490
19,19022,2017-12-31,1357,17073,18430
19,19022,2018-12-31,1346,17103,18449
19,19022,2019-12-31,1307,16956,18263
19,19022,2020-12-31,1283,16894,18177
19,19022,2021-12-31,1205,17117,18322
19,19022,2022-12-31,1129,17339,18468
19,19022,2023-12-31,1058,17557,18615
19,19022,2024-12-31,1013,17776,18789
19,19022,2025-12-31,985,17979,18964
19,19022,2026-12-31,972,18175,19147
19,19022,2027-12-31,960,18374,19334
19,19022,2028-12-31,954,18565,19519
19,19022,2029-12-31,956,18724,19680
19,19022,2030-12-31,963,18893,19856
19,19022,2031-12-31,966,19048,20014
19,19022,2032-12-31,968,19202,20170
19,19022,2033-12-31,966,19367,20333
19,19022,2034-12-31,967,19528,20495
19,19022,2035-12-31,970,19656,20626
19,19050,1985-12-31,1294,16060,17354
19,19050,1986-12-31,1326,16251,17577
19,19050,1987-12-31,1394,16445,17839
19,19050,1988-12-31,1415,16654,18069
19,19050,1989-12-31,1464,16869,18333
19,19050,1990-12-31,1488,17279,18767
19,19050,1991-12-31,1526,17559,19085
19,19050,1992-12-31,1573,17755,19328
19,19050,1993-12-31,1613,18072,19685
19,19050,1994-12-31,1672,18251,19923
19,19050,1995-12-31,1722,18462,20184
19,19050,1996-12-31,1746,18673,20419
19,19050,1997-12-31,1811,18909,20720
19,19050,1998-12-31,1859,19016,20875
19,19050,1999-12-31,1891,19442,21333
19,19050,2000-12-31,1968,19532,21500
19,19050,2001-12-31,2047,19662,21709
19,19050,2002-12-31,2086,19920,22006
19,19050,2003-12-31,2132,20194,22326
19,19050,2004-12-31,2176,20442,22618
19,19050,2005-12-31,2209,20623,22832
19,19050,2006-12-31,2238,20841,23079
19,19050,2007-12-31,2250,21229,23479
19,19050,2008-12-31,2304,21329,23633
19,19050,2009-12-31,2343,21523,23866
19,19050,2010-12-31,2381,21740,24121
19,19050,2011-12-31,2439,21949,24388
19,19050,2012-12-31,2465,22174,24639
19,19050,2013-12-31,2490,22375,24865
19,19050,2014-12-31,2531,22564,25095
19,19050,2015-12-31,2568,22759,25327
19,19050,2016-12-31,2598,22984,25582
19,19050,2017-12-31,2672,23233,25905
19,19050,2018-12-31,2700,23444,26144
19,19050,2019-12-31,2705,23671,26376
19,19050,2020-12-31,2707,23881,26588
19,19050,2021-12-31,2603,24197,26800
19,19050,2022-12-31,2503,24510,27013
19,19050,2023-12-31,2410,24818,27228
19,19050,2024-12-31,2376,25116,27492
19,19050,2025-12-31,2366,25384,27750
19,19050,2026-12-31,2370,25665,28035
19,19050,2027-12-31,2380,25936,28316
19,19050,2028-12-31,2376,26191,28567
19,19050,2029-12-31,2382,26443,28825
19,19050,2030-12-31,2396,26684,29080
19,19050,2031-12-31,2396,26909,29305
19,19050,2032-12-31,2399,27135,29534
19,19050,2033-12-31,2416,27360,29776
19,19050,2034-12-31,2415,27577,29992
19,19050,2035-12-31,2421,27790,30211
19,19075,1985-12-31,2687,15289,17976
19,19075,1986-12-31,2761,15221,17982
19,19075,1987-12-31,2842,15182,18024
19,19075,1988-12-31,2951,15152,18103
19,19075,1989-12-31,3022,15137,18159
19,19075,1990-12-31,3052,15290,18342
19,19075,1991-12-31,3109,15332,18441
19,19075,1992-12-31,3201,15305,18506
19,19075,1993-12-31,3277,15377,18654
19,19075,1994-12-31,3377,15342,18719
19,19075,1995-12-31,3472,15330,18802
19,19075,1996-12-31,3568,15335,18903
19,19075,1997-12-31,3654,15357,19011
19,19075,1998-12-31,3779,15273,19052
19,19075,1999-12-31,3800,15464,19264
19,19075,2000-12-31,3930,15376,19306
19,19075,2001-12-31,4068,15298,19366
19,19075,2002-12-31,4164,15329,19493
19,19075,2003-12-31,4250,15361,19611
19,19075,2004-12-31,4334,15381,19715
19,19075,2005-12-31,4412,15400,19812
19,19075,2006-12-31,4491,15436,19927
19,19075,2007-12-31,4502,15597,20099
19,19075,2008-12-31,4618,15507,20125
19,19075,2009-12-31,4698,15525,20223
19,19075,2010-12-31,4783,15546,20329
19,19075,2011-12-31,4873,15565,20438
19,19075,2012-12-31,4952,15580,20532
19,19075,2013-12-31,5025,15596,20621
19,19075,2014-12-31,5095,15587,20682
19,19075,2015-12-31,5129,15611,20740
19,19075,2016-12-31,5217,15634,20851
19,19075,2017-12-31,5337,15673,21010
19,19075,2018-12-31,5393,15715,21108
19,19075,2019-12-31,5409,15861,21270
19,19075,2020-12-31,5420,16017,21437
19,19075,2021-12-31,5379,16229,21608
19,19075,2022-12-31,5341,16439,21780
19,19075,2023-12-31,5308,16645,21953
19,19075,2024-12-31,5308,16860,22168
19,19075,2025-12-31,5305,17058,22363
19,19075,2026-12-31,5311,17242,22553
19,19075,2027-12-31,5316,17426,22742
19,19075,2028-12-31,5334,17597,22931
19,19075,2029-12-31,5346,17771,23117
19,19075,2030-12-31,5364,17892,23256
19,19075,2031-12-31,5375,18063,23438
19,19075,2032-12-31,5384,18217,23601
19,19075,2033-12-31,5406,18357,23763
19,19075,2034-12-31,5411,18507,23918
19,19075,2035-12-31,5427,18643,24070
19,19100,1985-12-31,6604,58230,64834
19,19100,1986-12-31,6530,57666,64196
19,19100,1987-12-31,6457,57128,63585
19,19100,1988-12-31,6397,56636,63033
19,19100,1989-12-31,6340,56152,62492
19,19100,1990-12-31,6172,56318,62490
19,19100,1991-12-31,6062,56111,62173
19,19100,1992-12-31,6029,55636,61665
19,19100,1993-12-31,5981,55535,61516
19,19100,1994-12-31,5969,55056,61025
19,19100,1995-12-31,5929,54669,60598
19,19100,1996-12-31,5900,54309,60209
19,19100,1997-12-31,5867,54088,59955
19,19100,1998-12-31,5891,53444,59335
19,19100,1999-12-31,5749,53773,59522
19,19100,2000-12-31,5774,43619,49393
19,19100,2001-12-31,5796,42729,48525
19,19100,2002-12-31,5755,42147,47902
19,19100,2003-12-31,5729,41548,47277
19,19100,2004-12-31,5682,40957,46639
19,19100,2005-12-31,5625,40335,45960
19,19100,2006-12-31,5582,39750,45332
19,19100,2007-12-31,5465,39517,44982
19,19100,2008-12-31,5455,38688,44143
19,19100,2009-12-31,5424,38090,43514
19,19100,2010-12-31,5397,37491,42888
19,19100,2011-12-31,5341,36903,42244
19,19100,2012-12-31,5308,36323,41631
19,19100,2013-12-31,5270,35735,41005
19,19100,2014-12-31,5161,35151,40312
19,19100,2015-12-31,5109,34599,39708
19,19100,2016-12-31,5067,34097,39164
19,19100,2017-12-31,5061,33596,38657
19,19100,2018-12-31,5020,33028,38048
19,19100,2019-12-31,4928,32399,37327
19,19100,2020-12-31,4876,32118,36994
19,19100,2021-12-31,4747,32542,37289
19,19100,2022-12-31,4622,32964,37586
19,19100,2023-12-31,4507,33378,37885
19,19100,2024-12-31,4401,33794,38195
19,19100,2025-12-31,4317,34171,38488
19,19100,2026-12-31,4260,34552,38812
19,19100,2027-12-31,4205,34923,39128
19,19100,2028-12-31,4170,35265,39435
19,19100,2029-12-31,4166,35594,39760
19,19100,2030-12-31,4157,35922,40079
19,19100,2031-12-31,4156,36220,40376
19,19100,2032-12-31,4156,36504,40660
19,19100,2033-12-31,4163,36813,40976
19,19100,2034-12-31,4168,37113,41281
19,19100,2035-12-31,4175,37385,41560
19,19110,1985-12-31,858,40502,41360
19,19110,1986-12-31,813,40191,41004
19,19110,1987-12-31,825,39891,40716
19,19110,1988-12-31,854,39637,40491
19,19110,1989-12-31,857,39400,40257
19,19110,1990-12-31,835,16942,17777
19,19110,1991-12-31,843,17506,18349
19,19110,1992-12-31,863,17981,18844
19,19110,1993-12-31,865,18584,19449
19,19110,1994-12-31,886,19035,19921
19,19110,1995-12-31,917,19515,20432
19,19110,1996-12-31,910,20017,20927
19,19110,1997-12-31,920,20544,21464
19,19110,1998-12-31,953,20894,21847
19,19110,1999-12-31,960,21638,22598
19,19110,2000-12-31,974,21967,22941
19,19110,2001-12-31,992,22313,23305
19,19110,2002-12-31,1008,22831,23839
19,19110,2003-12-31,1031,23319,24350
19,19110,2004-12-31,1027,23818,24845
19,19110,2005-12-31,1039,24276,25315
19,19110,2006-12-31,1065,24755,25820
19,19110,2007-12-31,1080,25465,26545
19,19110,2008-12-31,1078,25783,26861
19,19110,2009-12-31,1091,26229,27320
19,19110,2010-12-31,1099,26680,27779
19,19110,2011-12-31,1123,27122,28245
19,19110,2012-12-31,1138,27567,28705
19,19110,2013-12-31,1169,28012,29181
19,19110,2014-12-31,1152,28408,29560
19,19110,2015-12-31,1161,28861,30022
19,19110,2016-12-31,1228,29322,30550
19,19110,2017-12-31,1234,29758,30992
19,19110,2018-12-31,1218,30218,31436
19,19110,2019-12-31,1220,30534,31754
19,19110,2020-12-31,1222,30827,32049
19,19110,2021-12-31,1077,31234,32311
19,19110,2022-12-31,929,31639,32568
19,19110,2023-12-31,791,32036,32827
19,19110,2024-12-31,742,32452,33194
19,19110,2025-12-31,738,32844,33582
19,19110,2026-12-31,745,33206,33951
19,19110,2027-12-31,740,33556,34296
19,19110,2028-12-31,739,33892,34631
19,19110,2029-12-31,721,34215,34936
19,19110,2030-12-31,731,34515,35246
19,19110,2031-12-31,726,34815,35541
19,19110,2032-12-31,749,35106,35855
19,19110,2033-12-31,752,35372,36124
19,19110,2034-12-31,741,35655,36396
19,19110,2035-12-31,750,35923,36673
19,19130,1985-12-31,1181,36424,37605
19,19130,1986-12-31,1204,36387,37591
19,19130,1987-12-31,1258,36378,37636
19,19130,1988-12-31,1281,36386,37667
19,19130,1989-12-31,1311,36404,37715
19,19130,1990-12-31,1300,36822,38122
19,19130,1991-12-31,1367,37014,38381
19,19130,1992-12-31,1397,37018,38415
19,19130,1993-12-31,1375,37272,38647
19,19130,1994-12-31,1394,37261,38655
19,19130,1995-12-31,1415,37309,38724
19,19130,1996-12-31,1489,37378,38867
19,19130,1997-12-31,1529,37546,39075
19,19130,1998-12-31,1606,37409,39015
19,19130,1999-12-31,1572,37946,39518
19,19130,2000-12-31,1649,37790,39439
19,19130,2001-12-31,1711,37676,39387
19,19130,2002-12-31,1733,37830,39563
19,19130,2003-12-31,1762,37958,39720
19,19130,2004-12-31,1810,38105,39915
19,19130,2005-12-31,1835,38220,40055
19,19130,2006-12-31,1859,38347,40206
19,19130,2007-12-31,1859,38816,40675
19,19130,2008-12-31,1862,38707,40569
19,19130,2009-12-31,1907,38805,40712
19,19130,2010-12-31,1934,38906,40840
19,19130,2011-12-31,1987,39015,41002
19,19130,2012-12-31,2021,39088,41109
19,19130,2013-12-31,2066,39192,41258
19,19130,2014-12-31,2102,39282,41384
19,19130,2015-12-31,2139,39396,41535
19,19130,2016-12-31,2164,39540,41704
19,19130,2017-12-31,2190,39689,41879
19,19130,2018-12-31,2202,39812,42014
19,19130,2019-12-31,2207,40232,42439
19,19130,2020-12-31,2209,40624,42833
19,19130,2021-12-31,2022,41161,43183
19,19130,2022-12-31,1833,41694,43527
19,19130,2023-12-31,1655,42218,43873
19,19130,2024-12-31,1591,42748,44339
19,19130,2025-12-31,1581,43256,44837
19,19130,2026-12-31,1579,43729,45308
19,19130,2027-12-31,1576,44185,45761
19,19130,2028-12-31,1578,44633,46211
19,19130,2029-12-31,1586,45047,46633
19,19130,2030-12-31,1592,45451,47043
19,19130,2031-12-31,1593,45826,47419
19,19130,2032-12-31,1602,46207,47809
19,19130,2033-12-31,1605,46588,48193
19,19130,2034-12-31,1607,46955,48562
19,19130,2035-12-31,1612,47296,48908
19,19137,1985-12-31,1168,12028,13196
19,19137,1986-12-31,1212,12866,14078
19,19137,1987-12-31,1226,13712,14938
19,19137,1988-12-31,1238,14569,15807
19,19137,1989-12-31,1268,15395,16663
19,19137,1990-12-31,1257,16412,17669
19,19137,1991-12-31,1269,17300,18569
19,19137,1992-12-31,1312,18105,19417
19,19137,1993-12-31,1334,19018,20352
19,19137,1994-12-31,1396,19803,21199
19,19137,1995-12-31,1431,20594,22025
19,19137,1996-12-31,1478,21383,22861
19,19137,1997-12-31,1515,22222,23737
19,19137,1998-12-31,1584,22872,24456
19,19137,1999-12-31,1572,23937,25509
19,19137,2000-12-31,1600,24555,26155
19,19137,2001-12-31,1668,25193,26861
19,19137,2002-12-31,1733,25989,27722
19,19137,2003-12-31,1745,26763,28508
19,19137,2004-12-31,1766,27550,29316
19,19137,2005-12-31,1803,28301,30104
19,19137,2006-12-31,1849,29064,30913
19,19137,2007-12-31,1810,30098,31908
19,19137,2008-12-31,1867,30664,32531
19,19137,2009-12-31,1915,31392,33307
19,19137,2010-12-31,1903,32113,34016
19,19137,2011-12-31,1913,32829,34742
19,19137,2012-12-31,1961,33543,35504
19,19137,2013-12-31,2012,34242,36254
19,19137,2014-12-31,2055,34937,36992
19,19137,2015-12-31,2090,35640,37730
19,19137,2016-12-31,2124,36359,38483
19,19137,2017-12-31,2165,37082,39247
19,19137,2018-12-31,2174,37772,39946
19,19137,2019-12-31,2178,38720,40898
19,19137,2020-12-31,2181,39589,41770
19,19137,2021-12-31,1992,40120,42112
19,19137,2022-12-31,1807,40640,42447
19,19137,2023-12-31,1634,41150,42784
19,19137,2024-12-31,1574,41613,43187
19,19137,2025-12-31,1557,42086,43643
19,19137,2026-12-31,1549,42564,44113
19,19137,2027-12-31,1557,43014,44571
19,19137,2028-12-31,1560,43437,44997
19,19137,2029-12-31,1566,43872,45438
19,19137,2030-12-31,1569,44264,45833
19,19137,2031-12-31,1575,44639,46214
19,19137,2032-12-31,1582,45019,46601
19,19137,2033-12-31,1586,45375,46961
19,19137,2034-12-31,1588,45742,47330
19,19137,2035-12-31,1599,46089,47688
19,19142,1985-12-31,2998,28906,31904
19,19142,1986-12-31,3060,29340,32400
19,19142,1987-12-31,3133,29781,32914
19,19142,1988-12-31,3187,30249,33436
19,19142,1989-12-31,3264,30704,33968
19,19142,1990-12-31,3282,31525,34807
19,19142,1991-12-31,3335,32122,35457
19,19142,1992-12-31,3384,32559,35943
19,19142,1993-12-31,3432,33210,36642
19,19142,1994-12-31,3505,33617,37122
19,19142,1995-12-31,3607,34081,37688
19,19142,1996-12-31,3712,34556,38268
19,19142,1997-12-31,3789,35100,38889
19,19142,1998-12-31,3919,35362,39281
19,19142,1999-12-31,3925,36283,40208
19,19142,2000-12-31,4042,36516,40558
19,19142,2001-12-31,4166,36805,40971
19,19142,2002-12-31,4228,37341,41569
19,19142,2003-12-31,4302,37815,42117
19,19142,2004-12-31,4387,38303,42690
19,19142,2005-12-31,4445,38797,43242
19,19142,2006-12-31,4541,39296,43837
19,19142,2007-12-31,4547,16604,21151
19,19142,2008-12-31,4594,17313,21907
19,19142,2009-12-31,4702,18087,22789
19,19142,2010-12-31,4789,18872,23661
19,19142,2011-12-31,4875,19637,24512
19,19142,2012-12-31,4955,20401,25356
19,19142,2013-12-31,5008,21136,26144
19,19142,2014-12-31,5026,21872,26898
19,19142,2015-12-31,5068,22619,27687
19,19142,2016-12-31,5132,23383,28515
19,19142,2017-12-31,5200,24137,29337
19,19142,2018-12-31,5297,24884,30181
19,19142,2019-12-31,5308,24835,30143
19,19142,2020-12-31,5315,24901,30216
19,19142,2021-12-31,5227,25230,30457
19,19142,2022-12-31,5142,25557,30699
19,19142,2023-12-31,5066,25878,30944
19,19142,2024-12-31,5049,26186,31235
19,19142,2025-12-31,5046,26483,31529
19,19142,2026-12-31,5051,26787,31838
19,19142,2027-12-31,5062,27071,32133
19,19142,2028-12-31,5069,27356,32425
19,19142,2029-12-31,5076,27606,32682
19,19142,2030-12-31,5109,27866,32975
19,19142,2031-12-31,5122,28095,33217
19,19142,2032-12-31,5132,28326,33458
19,19142,2033-12-31,5148,28562,33710
19,19142,2034-12-31,5165,28781,33946
19,19142,2035-12-31,5162,29008,34170
19,19212,1985-12-31,10482,11487,21969
19,19212,1986-12-31,10531,11482,22013
19,19212,1987-12-31,10584,11461,22045
19,19212,1988-12-31,10644,11456,22100
19,19212,1989-12-31,10703,11457,22160
19,19212,1990-12-31,10598,11597,22195
19,19212,1991-12-31,10570,11650,22220
19,19212,1992-12-31,10638,11649,22287
19,19212,1993-12-31,10692,11718,22410
19,19212,1994-12-31,10833,11704,22537
19,19212,1995-12-31,10938,11727,22665
19,19212,1996-12-31,11057,11737,22794
19,19212,1997-12-31,11146,11803,22949
19,19212,1998-12-31,11393,11739,23132
19,19212,1999-12-31,11248,11910,23158
19,19212,2000-12-31,11468,11861,23329
19,19212,2001-12-31,11710,11813,23523
19,19212,2002-12-31,11802,11858,23660
19,19212,2003-12-31,11891,11894,23785
19,19212,2004-12-31,11971,11933,23904
19,19212,2005-12-31,12049,11972,24021
19,19212,2006-12-31,12115,12013,24128
19,19212,2007-12-31,12017,12134,24151
19,19212,2008-12-31,12198,12118,24316
19,19212,2009-12-31,12263,12121,24384
19,19212,2010-12-31,12323,12152,24475
19,19212,2011-12-31,12384,12189,24573
19,19212,2012-12-31,12462,12201,24663
19,19212,2013-12-31,12505,12222,24727
19,19212,2014-12-31,12588,12266,24854
19,19212,2015-12-31,12644,12270,24914
19,19212,2016-12-31,12708,12359,25067
19,19212,2017-12-31,12737,12328,25065
19,19212,2018-12-31,12880,12406,25286
19,19212,2019-12-31,12670,12672,25342
19,19212,2020-12-31,12530,12910,25440
19,19212,2021-12-31,12560,13083,25643
19,19212,2022-12-31,12594,13253,25847
19,19212,2023-12-31,12634,13419,26053
19,19212,2024-12-31,12641,13582,26223
19,19212,2025-12-31,12653,13748,26401
19,19212,2026-12-31,12659,13894,26553
19,19212,2027-12-31,12678,14051,26729
19,19212,2028-12-31,12706,14188,26894
19,19212,2029-12-31,12748,14315,27063
19,19212,2030-12-31,12766,14424,27190
19,19212,2031-12-31,12807,14570,27377
19,19212,2032-12-31,12843,14690,27533
19,19212,2033-12-31,12879,14811,27690
19,19212,2034-12-31,12915,14914,27829
19,19212,2035-12-31,12932,15042,27974
19,19256,1985-12-31,2409,45556,47965
19,19256,1986-12-31,2434,45553,47987
19,19256,1987-12-31,2419,45564,47983
19,19256,1988-12-31,2456,45618,48074
19,19256,1989-12-31,2483,45681,48164
19,19256,1990-12-31,2464,46230,48694
19,19256,1991-12-31,2468,46479,48947
19,19256,1992-12-31,2452,46522,48974
19,19256,1993-12-31,2496,46898,49394
19,19256,1994-12-31,2535,46926,49461
19,19256,1995-12-31,2541,47039,49580
19,19256,1996-12-31,2583,47145,49728
19,19256,1997-12-31,2603,47380,49983
19,19256,1998-12-31,2661,47228,49889
19,19256,1999-12-31,2595,47938,50533
19,19256,2000-12-31,2708,47779,50487
19,19256,2001-12-31,2761,47664,50425
19,19256,2002-12-31,2747,47884,50631
19,19256,2003-12-31,2774,48093,50867
19,19256,2004-12-31,2794,48299,51093
19,19256,2005-12-31,2823,48465,51288
19,19256,2006-12-31,2851,48658,51509
19,19256,2007-12-31,2787,49270,52057
19,19256,2008-12-31,2840,49166,52006
19,19256,2009-12-31,2845,49319,52164
19,19256,2010-12-31,2853,49489,52342
19,19256,2011-12-31,2872,49648,52520
19,19256,2012-12-31,2881,49794,52675
19,19256,2013-12-31,2883,49948,52831
19,19256,2014-12-31,2910,50097,53007
19,19256,2015-12-31,2935,50276,53211
19,19256,2016-12-31,2968,50478,53446
19,19256,2017-12-31,2969,50656,53625
19,19256,2018-12-31,3003,50888,53891
19,19256,2019-12-31,3009,50831,53840
19,19256,2020-12-31,3012,50757,53769
19,19256,2021-12-31,2770,51428,54198
19,19256,2022-12-31,2535,52094,54629
19,19256,2023-12-31,2316,52748,55064
19,19256,2024-12-31,2252,53418,55670
19,19256,2025-12-31,2226,54036,56262
19,19256,2026-12-31,2228,54637,56865
19,19256,2027-12-31,2230,55202,57432
19,19256,2028-12-31,2232,55758,57990
19,19256,2029-12-31,2239,56277,58516
19,19256,2030-12-31,2250,56798,59048
19,19256,2031-12-31,2247,57248,59495
19,19256,2032-12-31,2259,57736,59995
19,19256,2033-12-31,2272,58204,60476
19,19256,2034-12-31,2268,58661,60929
19,19256,2035-12-31,2275,59089,61364
19,19290,1985-12-31,0,0,0
19,19290,1986-12-31,0,0,0
19,19290,1987-12-31,0,0,0
19,19290,1988-12-31,0,0,0
19,19290,1989-12-31,0,0,0
19,19290,1990-12-31,0,0,0
19,19290,1991-12-31,0,0,0
19,19290,1992-12-31,0,0,0
19,19290,1993-12-31,1153,4948,6101
19,19290,1994-12-31,1158,4880,6038
19,19290,1995-12-31,1164,4840,6004
19,19290,1996-12-31,1171,4792,5963
19,19290,1997-12-31,1179,4756,5935
19,19290,1998-12-31,1214,4684,5898
19,19290,1999-12-31,1192,4694,5886
19,19290,2000-12-31,1161,4623,5784
19,19290,2001-12-31,1178,4562,5740
19,19290,2002-12-31,1185,4531,5716
19,19290,2003-12-31,1184,4486,5670
19,19290,2004-12-31,1201,4439,5640
19,19290,2005-12-31,1203,4414,5617
19,19290,2006-12-31,1177,4366,5543
19,19290,2007-12-31,1202,4384,5586
19,19290,2008-12-31,1219,4322,5541
19,19290,2009-12-31,1234,4309,5543
19,19290,2010-12-31,1224,4254,5478
19,19290,2011-12-31,1225,4200,5425
19,19290,2012-12-31,1210,4169,5379
19,19290,2013-12-31,1219,4107,5326
19,19290,2014-12-31,1216,4029,5245
19,19290,2015-12-31,1220,4016,5236
19,19290,2016-12-31,1220,4003,5223
19,19290,2017-12-31,1228,3948,5176
19,19290,2018-12-31,1224,3978,5202
19,19290,2019-12-31,1226,4028,5254
19,19290,2020-12-31,1228,4075,5303
19,19290,2021-12-31,1217,4129,5346
19,19290,2022-12-31,1207,4182,5389
19,19290,2023-12-31,1197,4235,5432
19,19290,2024-12-31,1191,4287,5478
19,19290,2025-12-31,1185,4338,5523
19,19290,2026-12-31,1192,4383,5575
19,19290,2027-12-31,1189,4433,5622
19,19290,2028-12-31,1193,4471,5664
19,19290,2029-12-31,1198,4518,5716
19,19290,2030-12-31,1202,4552,5754
19,19290,2031-12-31,1212,4604,5816
19,19290,2032-12-31,1215,4634,5849
19,19290,2033-12-31,1215,4662,5877
19,19290,2034-12-31,1220,4705,5925
19,19290,2035-12-31,1220,4727,5947
19,19300,1985-12-31,0,0,0
19,19300,1986-12-31,0,0,0
19,19300,1987-12-31,0,0,0
19,19300,1988-12-31,0,0,0
19,19300,1989-12-31,0,0,0
19,19300,1990-12-31,0,0,0
19,19300,1991-12-31,0,0,0
19,19300,1992-12-31,0,0,0
19,19300,1993-12-31,0,0,0
19,19300,1994-12-31,0,0,0
19,19300,1995-12-31,0,0,0
19,19300,1996-12-31,0,0,0
19,19300,1997-12-31,0,0,0
19,19300,1998-12-31,0,0,0
19,19300,1999-12-31,0,0,0
19,19300,2000-12-31,0,0,0
19,19300,2001-12-31,0,0,0
19,19300,2002-12-31,0,0,0
19,19300,2003-12-31,0,0,0
19,19300,2004-12-31,0,0,0
19,19300,2005-12-31,0,0,0
19,19300,2006-12-31,0,0,0
19,19300,2007-12-31,7510,16127,23637
19,19300,2008-12-31,7485,15769,23254
19,19300,2009-12-31,7376,15495,22871
19,19300,2010-12-31,7267,15226,22493
19,19300,2011-12-31,7185,14958,22143
19,19300,2012-12-31,7045,14690,21735
19,19300,2013-12-31,6972,14418,21390
19,19300,2014-12-31,6866,14146,21012
19,19300,2015-12-31,6745,13882,20627
19,19300,2016-12-31,6630,13657,20287
19,19300,2017-12-31,6556,13378,19934
19,19300,2018-12-31,6480,13191,19671
19,19300,2019-12-31,6530,13320,19850
19,19300,2020-12-31,6587,13433,20020
19,19300,2021-12-31,6569,13611,20180
19,19300,2022-12-31,6553,13787,20340
19,19300,2023-12-31,6542,13960,20502
19,19300,2024-12-31,6537,14151,20688
19,19300,2025-12-31,6556,14308,20864
19,19300,2026-12-31,6560,14459,21019
19,19300,2027-12-31,6567,14628,21195
19,19300,2028-12-31,6593,14770,21363
19,19300,2029-12-31,6599,14909,21508
19,19300,2030-12-31,6619,15031,21650
19,19300,2031-12-31,6644,15182,21826
19,19300,2032-12-31,6657,15294,21951
19,19300,2033-12-31,6670,15423,22093
19,19300,2034-12-31,6687,15525,22212
19,19300,2035-12-31,6710,15669,22379
19,19318,1985-12-31,8260,19175,27435
19,19318,1986-12-31,8409,18905,27314
19,19318,1987-12-31,8573,18653,27226
19,19318,1988-12-31,8748,18395,27143
19,19318,1989-12-31,8939,18152,27091
19,19318,1990-12-31,8940,18151,27091
19,19318,1991-12-31,9031,18001,27032
19,19318,1992-12-31,9226,17762,26988
19,19318,1993-12-31,9380,17652,27032
19,19318,1994-12-31,9600,17408,27008
19,19318,1995-12-31,9803,17201,27004
19,19318,1996-12-31,10014,17012,27026
19,19318,1997-12-31,10213,16860,27073
19,19318,1998-12-31,10537,16589,27126
19,19318,1999-12-31,10525,16630,27155
19,19318,2000-12-31,10847,16331,27178
19,19318,2001-12-31,11186,16087,27273
19,19318,2002-12-31,11374,15947,27321
19,19318,2003-12-31,11571,15795,27366
19,19318,2004-12-31,11747,15646,27393
19,19318,2005-12-31,11916,15480,27396
19,19318,2006-12-31,12091,15339,27430
19,19318,2007-12-31,12070,15325,27395
19,19318,2008-12-31,12325,15098,27423
19,19318,2009-12-31,12486,14948,27434
19,19318,2010-12-31,12664,14800,27464
19,19318,2011-12-31,12798,14645,27443
19,19318,2012-12-31,12978,14497,27475
19,19318,2013-12-31,13119,14350,27469
19,19318,2014-12-31,13281,14195,27476
19,19318,2015-12-31,13421,14049,27470
19,19318,2016-12-31,13602,13903,27505
19,19318,2017-12-31,13728,13797,27525
19,19318,2018-12-31,13932,13684,27616
19,19318,2019-12-31,13960,13659,27619
19,19318,2020-12-31,13975,13721,27696
19,19318,2021-12-31,14015,13902,27917
19,19318,2022-12-31,14057,14082,28139
19,19318,2023-12-31,14104,14259,28363
19,19318,2024-12-31,14129,14445,28574
19,19318,2025-12-31,14153,14605,28758
19,19318,2026-12-31,14176,14774,28950
19,19318,2027-12-31,14202,14941,29143
19,19318,2028-12-31,14225,15095,29320
19,19318,2029-12-31,14258,15230,29488
19,19318,2030-12-31,14306,15367,29673
19,19318,2031-12-31,14362,15502,29864
19,19318,2032-12-31,14389,15618,30007
19,19318,2033-12-31,14421,15747,30168
19,19318,2034-12-31,14463,15874,30337
19,19318,2035-12-31,14489,15999,30488
19,19355,1985-12-31,1749,14385,16134
19,19355,1986-12-31,1750,14785,16535
19,19355,1987-12-31,1697,15189,16886
19,19355,1988-12-31,1688,15603,17291
19,19355,1989-12-31,1678,16006,17684
19,19355,1990-12-31,1642,16595,18237
19,19355,1991-12-31,1593,17080,18673
19,19355,1992-12-31,1578,17466,19044
19,19355,1993-12-31,1569,17954,19523
19,19355,1994-12-31,1578,18325,19903
19,19355,1995-12-31,1576,18723,20299
19,19355,1996-12-31,1548,19123,20671
19,19355,1997-12-31,1541,19541,21082
19,19355,1998-12-31,1548,19856,21404
19,19355,1999-12-31,1508,20470,21978
19,19355,2000-12-31,1475,20746,22221
19,19355,2001-12-31,1494,21029,22523
19,19355,2002-12-31,1483,21433,22916
19,19355,2003-12-31,1474,21840,23314
19,19355,2004-12-31,1479,22255,23734
19,19355,2005-12-31,1449,22649,24098
19,19355,2006-12-31,1430,23044,24474
19,19355,2007-12-31,1430,23645,25075
19,19355,2008-12-31,1418,23897,25315
19,19355,2009-12-31,1422,24274,25696
19,19355,2010-12-31,1392,24638,26030
19,19355,2011-12-31,1372,25000,26372
19,19355,2012-12-31,1354,25367,26721
19,19355,2013-12-31,1353,25736,27089
19,19355,2014-12-31,1376,26092,27468
19,19355,2015-12-31,1364,26437,27801
19,19355,2016-12-31,1347,26803,28150
19,19355,2017-12-31,1332,27177,28509
19,19355,2018-12-31,1308,27571,28879
19,19355,2019-12-31,1308,27862,29170
19,19355,2020-12-31,1306,28135,29441
19,19355,2021-12-31,1174,28507,29681
19,19355,2022-12-31,1042,28876,29918
19,19355,2023-12-31,917,29239,30156
19,19355,2024-12-31,872,29623,30495
19,19355,2025-12-31,863,29970,30833
19,19355,2026-12-31,859,30299,31158
19,19355,2027-12-31,855,30608,31463
19,19355,2028-12-31,857,30930,31787
19,19355,2029-12-31,859,31223,32082
19,19355,2030-12-31,862,31506,32368
19,19355,2031-12-31,867,31764,32631
19,19355,2032-12-31,867,32038,32905
19,19355,2033-12-31,864,32294,33158
19,19355,2034-12-31,872,32544,33416
19,19355,2035-12-31,870,32788,33658
19,19364,1985-12-31,647,4560,5207
19,19364,1986-12-31,651,5025,5676
19,19364,1987-12-31,691,5401,6092
19,19364,1988-12-31,713,5742,6455
19,19364,1989-12-31,771,6118,6889
19,19364,1990-12-31,789,6559,7348
19,19364,1991-12-31,819,6946,7765
19,19364,1992-12-31,880,7300,8180
19,19364,1993-12-31,906,7691,8597
19,19364,1994-12-31,942,8044,8986
19,19364,1995-12-31,976,8395,9371
19,19364,1996-12-31,1016,8750,9766
19,19364,1997-12-31,1062,9121,10183
19,19364,1998-12-31,1124,9396,10520
19,19364,1999-12-31,1134,9864,10998
19,19364,2000-12-31,1220,10149,11369
19,19364,2001-12-31,1274,10423,11697
19,19364,2002-12-31,1308,10777,12085
19,19364,2003-12-31,1370,11107,12477
19,19364,2004-12-31,1409,11456,12865
19,19364,2005-12-31,1450,11796,13246
19,19364,2006-12-31,1487,12139,13626
19,19364,2007-12-31,1435,12573,14008
19,19364,2008-12-31,1534,12815,14349
19,19364,2009-12-31,1531,13143,14674
19,19364,2010-12-31,1584,13458,15042
19,19364,2011-12-31,1640,13767,15407
19,19364,2012-12-31,1688,14084,15772
19,19364,2013-12-31,1732,14387,16119
19,19364,2014-12-31,1773,14697,16470
19,19364,2015-12-31,1817,15003,16820
19,19364,2016-12-31,1852,15302,17154
19,19364,2017-12-31,1885,15639,17524
19,19364,2018-12-31,1895,15946,17841
19,19364,2019-12-31,1917,16323,18240
19,19364,2020-12-31,1932,16636,18568
19,19364,2021-12-31,1861,16859,18720
19,19364,2022-12-31,1791,17078,18869
19,19364,2023-12-31,1727,17292,19019
19,19364,2024-12-31,1701,17486,19187
19,19364,2025-12-31,1702,17695,19397
19,19364,2026-12-31,1708,17895,19603
19,19364,2027-12-31,1709,18092,19801
19,19364,2028-12-31,1709,18264,19973
19,19364,2029-12-31,1719,18443,20162
19,19364,2030-12-31,1720,18604,20324
19,19364,2031-12-31,1721,18768,20489
19,19364,2032-12-31,1732,18916,20648
19,19364,2033-12-31,1734,19070,20804
19,19364,2034-12-31,1737,19223,20960
19,19364,2035-12-31,1740,19383,21123
19,19392,1985-12-31,1525,12404,13929
19,19392,1986-12-31,1566,12244,13810
19,19392,1987-12-31,1519,12070,13589
19,19392,1988-12-31,1521,11932,13453
19,19392,1989-12-31,1526,11770,13296
19,19392,1990-12-31,1523,11759,13282
19,19392,1991-12-31,1506,11654,13160
19,19392,1992-12-31,1522,11494,13016
19,19392,1993-12-31,1517,11434,12951
19,19392,1994-12-31,1547,11285,12832
19,19392,1995-12-31,1560,11158,12718
19,19392,1996-12-31,1565,11030,12595
19,19392,1997-12-31,1579,10934,12513
19,19392,1998-12-31,1617,10767,12384
19,19392,1999-12-31,1574,10785,12359
19,19392,2000-12-31,1622,10611,12233
19,19392,2001-12-31,1683,10440,12123
19,19392,2002-12-31,1678,10345,12023
19,19392,2003-12-31,1699,10261,11960
19,19392,2004-12-31,1706,10167,11873
19,19392,2005-12-31,1689,10063,11752
19,19392,2006-12-31,1721,9967,11688
19,19392,2007-12-31,1661,9960,11621
19,19392,2008-12-31,1705,9820,11525
19,19392,2009-12-31,1726,9707,11433
19,19392,2010-12-31,1724,9601,11325
19,19392,2011-12-31,1687,9512,11199
19,19392,2012-12-31,1702,9436,11138
19,19392,2013-12-31,1721,9330,11051
19,19392,2014-12-31,1743,9238,10981
19,19392,2015-12-31,1770,9166,10936
19,19392,2016-12-31,1797,9035,10832
19,19392,2017-12-31,1821,8986,10807
19,19392,2018-12-31,1822,8927,10749
19,19392,2019-12-31,1801,8873,10674
19,19392,2020-12-31,1777,8878,10655
19,19392,2021-12-31,1745,8995,10740
19,19392,2022-12-31,1713,9112,10825
19,19392,2023-12-31,1686,9226,10912
19,19392,2024-12-31,1663,9344,11007
19,19392,2025-12-31,1647,9453,11100
19,19392,2026-12-31,1633,9554,11187
19,19392,2027-12-31,1624,9653,11277
19,19392,2028-12-31,1625,9742,11367
19,19392,2029-12-31,1619,9827,11446
19,19392,2030-12-31,1625,9917,11542
19,19392,2031-12-31,1629,9999,11628
19,19392,2032-12-31,1633,10093,11726
19,19392,2033-12-31,1637,10175,11812
19,19392,2034-12-31,1636,10261,11897
19,19392,2035-12-31,1643,10324,11967
19,19397,1985-12-31,1860,18113,19973
19,19397,1986-12-31,1851,18221,20072
19,19397,1987-12-31,1845,18343,20188
19,19397,1988-12-31,1798,18474,20272
19,19397,1989-12-31,1706,18610,20316
19,19397,1990-12-31,1664,18940,20604
19,19397,1991-12-31,1584,19155,20739
19,19397,1992-12-31,1611,19262,20873
19,19397,1993-12-31,1562,19526,21088
19,19397,1994-12-31,1532,19633,21165
19,19397,1995-12-31,1533,19769,21302
19,19397,1996-12-31,1508,19923,21431
19,19397,1997-12-31,1491,20125,21616
19,19397,1998-12-31,1529,20165,21694
19,19397,1999-12-31,1412,20562,21974
19,19397,2000-12-31,1426,20587,22013
19,19397,2001-12-31,1431,20634,22065
19,19397,2002-12-31,1405,20810,22215
19,19397,2003-12-31,1368,21010,22378
19,19397,2004-12-31,1329,21178,22507
19,19397,2005-12-31,1351,21327,22678
19,19397,2006-12-31,1292,21513,22805
19,19397,2007-12-31,1259,21867,23126
19,19397,2008-12-31,1242,21897,23139
19,19397,2009-12-31,1194,22056,23250
19,19397,2010-12-31,1180,22216,23396
19,19397,2011-12-31,1169,22363,23532
19,19397,2012-12-31,1172,22507,23679
19,19397,2013-12-31,1138,22666,23804
19,19397,2014-12-31,1102,22814,23916
19,19397,2015-12-31,1149,22973,24122
19,19397,2016-12-31,1103,23115,24218
19,19397,2017-12-31,1075,23290,24365
19,19397,2018-12-31,1040,23461,24501
19,19397,2019-12-31,1041,23501,24542
19,19397,2020-12-31,1041,23601,24642
19,19397,2021-12-31,926,23913,24839
19,19397,2022-12-31,813,24223,25036
19,19397,2023-12-31,708,24527,25235
19,19397,2024-12-31,674,24810,25484
19,19397,2025-12-31,659,25121,25780
19,19397,2026-12-31,655,25405,26060
19,19397,2027-12-31,653,25667,26320
19,19397,2028-12-31,654,25928,26582
19,19397,2029-12-31,656,26171,26827
19,19397,2030-12-31,663,26411,27074
19,19397,2031-12-31,664,26635,27299
19,19397,2032-12-31,666,26839,27505
19,19397,2033-12-31,671,27061,27732
19,19397,2034-12-31,670,27266,27936
19,19397,2035-12-31,674,27465,28139
19,19418,1985-12-31,814,13700,14514
19,19418,1986-12-31,836,13745,14581
19,19418,1987-12-31,848,13798,14646
19,19418,1988-12-31,902,13864,14766
19,19418,1989-12-31,911,13945,14856
19,19418,1990-12-31,932,14170,15102
19,19418,1991-12-31,960,14303,15263
19,19418,1992-12-31,1001,14358,15359
19,19418,1993-12-31,1043,14522,15565
19,19418,1994-12-31,1070,14570,15640
19,19418,1995-12-31,1130,14639,15769
19,19418,1996-12-31,1135,14716,15851
19,19418,1997-12-31,1173,14820,15993
19,19418,1998-12-31,1212,14804,16016
19,19418,1999-12-31,1236,15060,16296
19,19418,2000-12-31,1295,15048,16343
19,19418,2001-12-31,1330,15044,16374
19,19418,2002-12-31,1371,15152,16523
19,19418,2003-12-31,1402,15278,16680
19,19418,2004-12-31,1440,15366,16806
19,19418,2005-12-31,1475,15465,16940
19,19418,2006-12-31,1502,15562,17064
19,19418,2007-12-31,1508,15800,17308
19,19418,2008-12-31,1589,15801,17390
19,19418,2009-12-31,1584,15882,17466
19,19418,2010-12-31,1608,15984,17592
19,19418,2011-12-31,1632,16074,17706
19,19418,2012-12-31,1658,16166,17824
19,19418,2013-12-31,1703,16231,17934
19,19418,2014-12-31,1732,16317,18049
19,19418,2015-12-31,1771,16401,18172
19,19418,2016-12-31,1800,16482,18282
19,19418,2017-12-31,1835,16596,18431
19,19418,2018-12-31,1875,16705,18580
19,19418,2019-12-31,1879,16882,18761
19,19418,2020-12-31,1881,17051,18932
19,19418,2021-12-31,1810,17276,19086
19,19418,2022-12-31,1739,17500,19239
19,19418,2023-12-31,1672,17720,19392
19,19418,2024-12-31,1643,17936,19579
19,19418,2025-12-31,1635,18159,19794
19,19418,2026-12-31,1639,18336,19975
19,19418,2027-12-31,1639,18539,20178
19,19418,2028-12-31,1641,18736,20377
19,19418,2029-12-31,1655,18917,20572
19,19418,2030-12-31,1664,19092,20756
19,19418,2031-12-31,1664,19263,20927
19,19418,2032-12-31,1671,19425,21096
19,19418,2033-12-31,1677,19588,21265
19,19418,2034-12-31,1673,19743,21416
19,19418,2035-12-31,1677,19894,21571
19,19450,1985-12-31,6052,26134,32186
19,19450,1986-12-31,5992,25404,31396
19,19450,1987-12-31,5991,24709,30700
19,19450,1988-12-31,5981,24032,30013
19,19450,1989-12-31,5980,23337,29317
19,19450,1990-12-31,5840,22957,28797
19,19450,1991-12-31,5803,22404,28207
19,19450,1992-12-31,5790,21772,27562
19,19450,1993-12-31,5783,11354,17137
19,19450,1994-12-31,5804,11560,17364
19,19450,1995-12-31,5825,11786,17611
19,19450,1996-12-31,5842,12001,17843
19,19450,1997-12-31,5850,12245,18095
19,19450,1998-12-31,5951,12388,18339
19,19450,1999-12-31,5855,12768,18623
19,19450,2000-12-31,5908,12909,18817
19,19450,2001-12-31,6013,13058,19071
19,19450,2002-12-31,6015,13290,19305
19,19450,2003-12-31,6021,13523,19544
19,19450,2004-12-31,6024,13740,19764
19,19450,2005-12-31,6032,13966,19998
19,19450,2006-12-31,6007,14176,20183
19,19450,2007-12-31,5942,14542,20484
19,19450,2008-12-31,5992,14666,20658
19,19450,2009-12-31,5971,14878,20849
19,19450,2010-12-31,5973,15088,21061
19,19450,2011-12-31,5995,15302,21297
19,19450,2012-12-31,5992,15507,21499
19,19450,2013-12-31,5989,15694,21683
19,19450,2014-12-31,5961,15902,21863
19,19450,2015-12-31,5903,16081,21984
19,19450,2016-12-31,5907,16318,22225
19,19450,2017-12-31,5956,16452,22408
19,19450,2018-12-31,5953,16735,22688
19,19450,2019-12-31,5965,16936,22901
19,19450,2020-12-31,5972,17125,23097
19,19450,2021-12-31,5931,17351,23282
19,19450,2022-12-31,5891,17576,23467
19,19450,2023-12-31,5856,17797,23653
19,19450,2024-12-31,5838,18025,23863
19,19450,2025-12-31,5863,18246,24109
19,19450,2026-12-31,5859,18459,24318
19,19450,2027-12-31,5872,18651,24523
19,19450,2028-12-31,5878,18829,24707
19,19450,2029-12-31,5897,19000,24897
19,19450,2030-12-31,5911,19174,25085
19,19450,2031-12-31,5933,19309,25242
19,19450,2032-12-31,5942,19473,25415
19,19450,2033-12-31,5963,19622,25585
19,19450,2034-12-31,5962,19779,25741
19,19450,2035-12-31,5991,19921,25912
19,19455,1985-12-31,11111,11260,22371
19,19455,1986-12-31,11296,11295,22591
19,19455,1987-12-31,11503,11327,22830
19,19455,1988-12-31,11698,11363,23061
19,19455,1989-12-31,11881,11413,23294
19,19455,1990-12-31,11889,11560,23449
19,19455,1991-12-31,11997,11650,23647
19,19455,1992-12-31,12205,11697,23902
19,19455,1993-12-31,12387,11811,24198
19,19455,1994-12-31,12687,11840,24527
19,19455,1995-12-31,12930,11905,24835
19,19455,1996-12-31,13178,11953,25131
19,19455,1997-12-31,13419,12048,25467
19,19455,1998-12-31,13805,12034,25839
19,19455,1999-12-31,13767,12235,26002
19,19455,2000-12-31,14184,12218,26402
19,19455,2001-12-31,14612,12213,26825
19,19455,2002-12-31,14839,12295,27134
19,19455,2003-12-31,15065,12369,27434
19,19455,2004-12-31,15272,12452,27724
19,19455,2005-12-31,15474,12518,27992
19,19455,2006-12-31,15686,12594,28280
19,19455,2007-12-31,15645,12777,28422
19,19455,2008-12-31,15982,12776,28758
19,19455,2009-12-31,16188,12837,29025
19,19455,2010-12-31,16389,12898,29287
19,19455,2011-12-31,16571,12967,29538
19,19455,2012-12-31,16769,13007,29776
19,19455,2013-12-31,16967,13062,30029
19,19455,2014-12-31,17115,13129,30244
19,19455,2015-12-31,17347,13167,30514
19,19455,2016-12-31,17579,13276,30855
19,19455,2017-12-31,17717,13278,30995
19,19455,2018-12-31,17930,13430,31360
19,19455,2019-12-31,18103,13630,31733
19,19455,2020-12-31,18264,13818,32082
19,19455,2021-12-31,18343,14001,32344
19,19455,2022-12-31,18420,14182,32602
19,19455,2023-12-31,18501,14360,32861
19,19455,2024-12-31,18571,14536,33107
19,19455,2025-12-31,18650,14702,33352
19,19455,2026-12-31,18730,14877,33607
19,19455,2027-12-31,18799,15015,33814
19,19455,2028-12-31,18875,15171,34046
19,19455,2029-12-31,18959,15315,34274
19,19455,2030-12-31,19033,15445,34478
19,19455,2031-12-31,19126,15590,34716
19,19455,2032-12-31,19179,15719,34898
19,19455,2033-12-31,19247,15849,35096
19,19455,2034-12-31,19303,15974,35277
19,19455,2035-12-31,19343,16092,35435
19,19473,1985-12-31,1393,12562,13955
19,19473,1986-12-31,1410,13335,14745
19,19473,1987-12-31,1450,14115,15565
19,19473,1988-12-31,1499,14890,16389
19,19473,1989-12-31,1533,15656,17189
19,19473,1990-12-31,1524,16604,18128
19,19473,1991-12-31,1557,17426,18983
19,19473,1992-12-31,1588,18167,19755
19,19473,1993-12-31,1602,19022,20624
19,19473,1994-12-31,1654,19722,21376
19,19473,1995-12-31,1695,20466,22161
19,19473,1996-12-31,1723,21195,22918
19,19473,1997-12-31,1782,21967,23749
19,19473,1998-12-31,1853,22565,24418
19,19473,1999-12-31,1814,23567,25381
19,19473,2000-12-31,1900,24134,26034
19,19473,2001-12-31,1958,24703,26661
19,19473,2002-12-31,1991,25450,27441
19,19473,2003-12-31,2030,26197,28227
19,19473,2004-12-31,2064,26885,28949
19,19473,2005-12-31,2091,27600,29691
19,19473,2006-12-31,2123,28324,30447
19,19473,2007-12-31,2114,29261,31375
19,19473,2008-12-31,2138,29788,31926
19,19473,2009-12-31,2182,30455,32637
19,19473,2010-12-31,2224,31126,33350
19,19473,2011-12-31,2231,31796,34027
19,19473,2012-12-31,2229,32448,34677
19,19473,2013-12-31,2279,33095,35374
19,19473,2014-12-31,2340,33734,36074
19,19473,2015-12-31,2376,34385,36761
19,19473,2016-12-31,2422,35048,37470
19,19473,2017-12-31,2464,35717,38181
19,19473,2018-12-31,2472,36366,38838
19,19473,2019-12-31,2473,37043,39516
19,19473,2020-12-31,2471,37613,40084
19,19473,2021-12-31,2294,38118,40412
19,19473,2022-12-31,2122,38611,40733
19,19473,2023-12-31,1961,39096,41057
19,19473,2024-12-31,1910,39542,41452
19,19473,2025-12-31,1896,39991,41887
19,19473,2026-12-31,1893,40435,42328
19,19473,2027-12-31,1893,40868,42761
19,19473,2028-12-31,1901,41276,43177
19,19473,2029-12-31,1909,41672,43581
19,19473,2030-12-31,1912,42050,43962
19,19473,2031-12-31,1920,42407,44327
19,19473,2032-12-31,1926,42763,44689
19,19473,2033-12-31,1928,43110,45038
19,19473,2034-12-31,1927,43431,45358
19,19473,2035-12-31,1934,43780,45714
19,19513,1985-12-31,3144,6534,9678
19,19513,1986-12-31,3168,6474,9642
19,19513,1987-12-31,3219,6420,9639
19,19513,1988-12-31,3252,6377,9629
19,19513,1989-12-31,3283,6301,9584
19,19513,1990-12-31,3270,6333,9603
19,19513,1991-12-31,3309,6298,9607
19,19513,1992-12-31,3344,6226,9570
19,19513,1993-12-31,3387,6221,9608
19,19513,1994-12-31,3461,6169,9630
19,19513,1995-12-31,3513,6133,9646
19,19513,1996-12-31,3572,6053,9625
19,19513,1997-12-31,3626,6058,9684
19,19513,1998-12-31,3688,5979,9667
19,19513,1999-12-31,3622,6021,9643
19,19513,2000-12-31,3765,5938,9703
19,19513,2001-12-31,3866,5889,9755
19,19513,2002-12-31,3917,5865,9782
19,19513,2003-12-31,3951,5842,9793
19,19513,2004-12-31,3982,5821,9803
19,19513,2005-12-31,4059,5777,9836
19,19513,2006-12-31,4089,5761,9850
19,19513,2007-12-31,3998,5786,9784
19,19513,2008-12-31,4119,5729,9848
19,19513,2009-12-31,4149,5676,9825
19,19513,2010-12-31,4193,5664,9857
19,19513,2011-12-31,4221,5629,9850
19,19513,2012-12-31,4258,5578,9836
19,19513,2013-12-31,4283,5547,9830
19,19513,2014-12-31,4290,5540,9830
19,19513,2015-12-31,4326,5512,9838
19,19513,2016-12-31,4371,5457,9828
19,19513,2017-12-31,4417,5460,9877
19,19513,2018-12-31,4478,5459,9937
19,19513,2019-12-31,4473,5480,9953
19,19513,2020-12-31,4467,5525,9992
19,19513,2021-12-31,4474,5598,10072
19,19513,2022-12-31,4481,5671,10152
19,19513,2023-12-31,4491,5742,10233
19,19513,2024-12-31,4492,5812,10304
19,19513,2025-12-31,4496,5875,10371
19,19513,2026-12-31,4507,5940,10447
19,19513,2027-12-31,4510,6004,10514
19,19513,2028-12-31,4530,6060,10590
19,19513,2029-12-31,4536,6127,10663
19,19513,2030-12-31,4546,6184,10730
19,19513,2031-12-31,4564,6241,10805
19,19513,2032-12-31,4572,6284,10856
19,19513,2033-12-31,4586,6334,10920
19,19513,2034-12-31,4607,6392,10999
19,19513,2035-12-31,4599,6431,11030
19,19517,1985-12-31,2399,7221,9620
19,19517,1986-12-31,2429,8445,10874
19,19517,1987-12-31,2432,9639,12071
19,19517,1988-12-31,2458,10838,13296
19,19517,1989-12-31,2461,12019,14480
19,19517,1990-12-31,2432,13328,15760
19,19517,1991-12-31,2414,14547,16961
19,19517,1992-12-31,2434,15694,18128
19,19517,1993-12-31,2454,16926,19380
19,19517,1994-12-31,2474,18011,20485
19,19517,1995-12-31,2517,19117,21634
19,19517,1996-12-31,2546,20236,22782
19,19517,1997-12-31,2551,21387,23938
19,19517,1998-12-31,2623,22339,24962
19,19517,1999-12-31,2582,23703,26285
19,19517,2000-12-31,2650,24624,27274
19,19517,2001-12-31,2708,25563,28271
19,19517,2002-12-31,2729,26642,29371
19,19517,2003-12-31,2757,27717,30474
19,19517,2004-12-31,2787,28768,31555
19,19517,2005-12-31,2794,29823,32617
19,19517,2006-12-31,2832,30883,33715
19,19517,2007-12-31,2763,32195,34958
19,19517,2008-12-31,2831,33040,35871
19,19517,2009-12-31,2837,34036,36873
19,19517,2010-12-31,2849,35036,37885
19,19517,2011-12-31,2866,36024,38890
19,19517,2012-12-31,2858,37003,39861
19,19517,2013-12-31,2869,37969,40838
19,19517,2014-12-31,2896,38922,41818
19,19517,2015-12-31,2914,39892,42806
19,19517,2016-12-31,2947,40848,43795
19,19517,2017-12-31,2967,41817,44784
19,19517,2018-12-31,2971,42805,45776
19,19517,2019-12-31,2871,43407,46278
19,19517,2020-12-31,2801,43941,46742
19,19517,2021-12-31,2602,44522,47124
19,19517,2022-12-31,2401,45098,47499
19,19517,2023-12-31,2212,45665,47877
19,19517,2024-12-31,2070,46233,48303
19,19517,2025-12-31,1998,46764,48762
19,19517,2026-12-31,1952,47283,49235
19,19517,2027-12-31,1933,47782,49715
19,19517,2028-12-31,1927,48267,50194
19,19517,2029-12-31,1921,48722,50643
19,19517,2030-12-31,1927,49165,51092
19,19517,2031-12-31,1937,49596,51533
19,19517,2032-12-31,1947,50009,51956
19,19517,2033-12-31,1946,50416,52362
19,19517,2034-12-31,1946,50814,52760
19,19517,2035-12-31,1948,51200,53148
19,19532,1985-12-31,9411,26751,36162
19,19532,1986-12-31,9538,26506,36044
19,19532,1987-12-31,9658,26269,35927
19,19532,1988-12-31,9771,26073,35844
19,19532,1989-12-31,9899,25877,35776
19,19532,1990-12-31,9860,25977,35837
19,19532,1991-12-31,9901,25905,35806
19,19532,1992-12-31,10030,25716,35746
19,19532,1993-12-31,10156,25703,35859
19,19532,1994-12-31,10339,25498,35837
19,19532,1995-12-31,10507,25338,35845
19,19532,1996-12-31,10678,25206,35884
19,19532,1997-12-31,10849,25112,35961
19,19532,1998-12-31,11147,24841,35988
19,19532,1999-12-31,11064,25010,36074
19,19532,2000-12-31,11350,24707,36057
19,19532,2001-12-31,11648,24464,36112
19,19532,2002-12-31,11780,24389,36169
19,19532,2003-12-31,11918,24291,36209
19,19532,2004-12-31,12070,24211,36281
19,19532,2005-12-31,12210,24110,36320
19,19532,2006-12-31,12326,24033,36359
19,19532,2007-12-31,12278,24153,36431
19,19532,2008-12-31,12515,23924,36439
19,19532,2009-12-31,12661,23824,36485
19,19532,2010-12-31,12745,23732,36477
19,19532,2011-12-31,12883,23642,36525
19,19532,2012-12-31,13022,23557,36579
19,19532,2013-12-31,13134,23447,36581
19,19532,2014-12-31,13288,23358,36646
19,19532,2015-12-31,13426,23268,36694
19,19532,2016-12-31,13468,23185,36653
19,19532,2017-12-31,13602,23114,36716
19,19532,2018-12-31,13781,23067,36848
19,19532,2019-12-31,13695,23488,37183
19,19532,2020-12-31,13619,23875,37494
19,19532,2021-12-31,13598,24195,37793
19,19532,2022-12-31,13585,24509,38094
19,19532,2023-12-31,13580,24817,38397
19,19532,2024-12-31,13604,25085,38689
19,19532,2025-12-31,13608,25390,38998
19,19532,2026-12-31,13616,25668,39284
19,19532,2027-12-31,13660,25938,39598
19,19532,2028-12-31,13676,26197,39873
19,19532,2029-12-31,13713,26463,40176
19,19532,2030-12-31,13758,26690,40448
19,19532,2031-12-31,13773,26906,40679
19,19532,2032-12-31,13825,27133,40958
19,19532,2033-12-31,13856,27366,41222
19,19532,2034-12-31,13891,27580,41471
19,19532,2035-12-31,13915,27774,41689
19,19533,1985-12-31,0,0,0
19,19533,1986-12-31,0,0,0
19,19533,1987-12-31,0,0,0
19,19533,1988-12-31,0,0,0
19,19533,1989-12-31,0,0,0
19,19533,1990-12-31,0,0,0
19,19533,1991-12-31,0,0,0
19,19533,1992-12-31,0,0,0
19,19533,1993-12-31,0,0,0
19,19533,1994-12-31,0,0,0
19,19533,1995-12-31,0,0,0
19,19533,1996-12-31,0,0,0
19,19533,1997-12-31,192,3557,3749
19,19533,1998-12-31,272,3684,3956
19,19533,1999-12-31,350,3895,4245
19,19533,2000-12-31,455,4071,4526
19,19533,2001-12-31,600,4158,4758
19,19533,2002-12-31,645,4317,4962
19,19533,2003-12-31,739,4490,5229
19,19533,2004-12-31,863,4612,5475
19,19533,2005-12-31,967,4802,5769
19,19533,2006-12-31,1040,4926,5966
19,19533,2007-12-31,1097,5142,6239
19,19533,2008-12-31,1237,5244,6481
19,19533,2009-12-31,1295,5413,6708
19,19533,2010-12-31,1382,5546,6928
19,19533,2011-12-31,1486,5692,7178
19,19533,2012-12-31,1573,5828,7401
19,19533,2013-12-31,1664,5965,7629
19,19533,2014-12-31,1740,6111,7851
19,19533,2015-12-31,1848,6256,8104
19,19533,2016-12-31,1925,6387,8312
19,19533,2017-12-31,2019,6500,8519
19,19533,2018-12-31,2109,6702,8811
19,19533,2019-12-31,2139,6865,9004
19,19533,2020-12-31,2183,7076,9259
19,19533,2021-12-31,2164,7171,9335
19,19533,2022-12-31,2145,7264,9409
19,19533,2023-12-31,2129,7355,9484
19,19533,2024-12-31,2133,7437,9570
19,19533,2025-12-31,2130,7524,9654
19,19533,2026-12-31,2127,7608,9735
19,19533,2027-12-31,2132,7688,9820
19,19533,2028-12-31,2145,7758,9903
19,19533,2029-12-31,2142,7845,9987
19,19533,2030-12-31,2145,7908,10053
19,19533,2031-12-31,2161,7984,10145
19,19533,2032-12-31,2166,8050,10216
19,19533,2033-12-31,2174,8107,10281
19,19533,2034-12-31,2172,8172,10344
19,19533,2035-12-31,2180,8237,10417
19,19548,1985-12-31,8778,16785,25563
19,19548,1986-12-31,8931,17054,25985
19,19548,1987-12-31,9106,17339,26445
19,19548,1988-12-31,9270,17618,26888
19,19548,1989-12-31,9431,17889,27320
19,19548,1990-12-31,9435,18362,27797
19,19548,1991-12-31,9495,18721,28216
19,19548,1992-12-31,9673,18994,28667
19,19548,1993-12-31,9833,19382,29215
19,19548,1994-12-31,10041,19655,29696
19,19548,1995-12-31,10255,19942,30197
19,19548,1996-12-31,10450,20225,30675
19,19548,1997-12-31,10653,20559,31212
19,19548,1998-12-31,10977,20723,31700
19,19548,1999-12-31,10944,21275,32219
19,19548,2000-12-31,11264,21430,32694
19,19548,2001-12-31,11591,21590,33181
19,19548,2002-12-31,11772,21914,33686
19,19548,2003-12-31,11952,22226,34178
19,19548,2004-12-31,12124,22540,34664
19,19548,2005-12-31,12290,22824,35114
19,19548,2006-12-31,12468,23123,35591
19,19548,2007-12-31,12440,23625,36065
19,19548,2008-12-31,12716,23789,36505
19,19548,2009-12-31,12863,24061,36924
19,19548,2010-12-31,13023,24337,37360
19,19548,2011-12-31,13173,24608,37781
19,19548,2012-12-31,13335,24888,38223
19,19548,2013-12-31,13479,25156,38635
19,19548,2014-12-31,13648,25422,39070
19,19548,2015-12-31,13823,25694,39517
19,19548,2016-12-31,13950,25977,39927
19,19548,2017-12-31,14107,26299,40406
19,19548,2018-12-31,14271,26547,40818
19,19548,2019-12-31,14308,27054,41362
19,19548,2020-12-31,14332,27505,41837
19,19548,2021-12-31,14305,27874,42179
19,19548,2022-12-31,14280,28235,42515
19,19548,2023-12-31,14263,28590,42853
19,19548,2024-12-31,14268,28908,43176
19,19548,2025-12-31,14280,29253,43533
19,19548,2026-12-31,14298,29571,43869
19,19548,2027-12-31,14314,29882,44196
19,19548,2028-12-31,14348,30186,44534
19,19548,2029-12-31,14389,30457,44846
19,19548,2030-12-31,14425,30728,45153
19,19548,2031-12-31,14478,30997,45475
19,19548,2032-12-31,14506,31252,45758
19,19548,2033-12-31,14537,31500,46037
19,19548,2034-12-31,14579,31748,46327
19,19548,2035-12-31,14610,31990,46600
19,19573,1985-12-31,32654,5324,37978
19,19573,1986-12-31,32673,5299,37972
19,19573,1987-12-31,32707,5285,37992
19,19573,1988-12-31,32770,5257,38027
19,19573,1989-12-31,32842,5249,38091
19,19573,1990-12-31,32351,5298,37649
19,19573,1991-12-31,32145,5295,37440
19,19573,1992-12-31,32289,5278,37567
19,19573,1993-12-31,32320,5316,37636
19,19573,1994-12-31,32618,5273,37891
19,19573,1995-12-31,32828,5269,38097
19,19573,1996-12-31,33053,5289,38342
19,19573,1997-12-31,33247,5300,38547
19,19573,1998-12-31,33848,5255,39103
19,19573,1999-12-31,33321,5320,38641
19,19573,2000-12-31,33924,5302,39226
19,19573,2001-12-31,34522,5239,39761
19,19573,2002-12-31,34688,5262,39950
19,19573,2003-12-31,34831,5271,40102
19,19573,2004-12-31,34964,5276,40240
19,19573,2005-12-31,35079,5275,40354
19,19573,2006-12-31,35188,5277,40465
19,19573,2007-12-31,34774,5323,40097
19,19573,2008-12-31,35186,5313,40499
19,19573,2009-12-31,35275,5320,40595
19,19573,2010-12-31,35405,5323,40728
19,19573,2011-12-31,35509,5322,40831
19,19573,2012-12-31,35585,5303,40888
19,19573,2013-12-31,35710,5347,41057
19,19573,2014-12-31,35774,5323,41097
19,19573,2015-12-31,35882,5258,41140
19,19573,2016-12-31,35950,5259,41209
19,19573,2017-12-31,36081,5276,41357
19,19573,2018-12-31,36266,5349,41615
19,19573,2019-12-31,35992,5656,41648
19,19573,2020-12-31,35821,5972,41793
19,19573,2021-12-31,36074,6052,42126
19,19573,2022-12-31,36331,6131,42462
19,19573,2023-12-31,36591,6208,42799
19,19573,2024-12-31,36639,6286,42925
19,19573,2025-12-31,36674,6350,43024
19,19573,2026-12-31,36716,6431,43147
19,19573,2027-12-31,36774,6493,43267
19,19573,2028-12-31,36866,6552,43418
19,19573,2029-12-31,36956,6621,43577
19,19573,2030-12-31,37061,6677,43738
19,19573,2031-12-31,37177,6732,43909
19,19573,2032-12-31,37272,6797,44069
19,19573,2033-12-31,37359,6841,44200
19,19573,2034-12-31,37432,6890,44322
19,19573,2035-12-31,37500,6939,44439
19,19585,1985-12-31,948,7328,8276
19,19585,1986-12-31,970,7579,8549
19,19585,1987-12-31,982,7836,8818
19,19585,1988-12-31,951,8101,9052
19,19585,1989-12-31,1012,8365,9377
19,19585,1990-12-31,1004,8710,9714
19,19585,1991-12-31,1015,9004,10019
19,19585,1992-12-31,1045,9249,10294
19,19585,1993-12-31,1070,9561,10631
19,19585,1994-12-31,1089,9800,10889
19,19585,1995-12-31,1125,10052,11177
19,19585,1996-12-31,1163,10298,11461
19,19585,1997-12-31,1190,10564,11754
19,19585,1998-12-31,1240,10746,11986
19,19585,1999-12-31,1226,11136,12362
19,19585,2000-12-31,1283,11308,12591
19,19585,2001-12-31,1319,11492,12811
19,19585,2002-12-31,1327,11757,13084
19,19585,2003-12-31,1367,12020,13387
19,19585,2004-12-31,1381,12259,13640
19,19585,2005-12-31,1403,12511,13914
19,19585,2006-12-31,1430,12766,14196
19,19585,2007-12-31,1429,13115,14544
19,19585,2008-12-31,1459,13287,14746
19,19585,2009-12-31,1503,13524,15027
19,19585,2010-12-31,1513,13743,15256
19,19585,2011-12-31,1532,13978,15510
19,19585,2012-12-31,1561,14210,15771
19,19585,2013-12-31,1566,14422,15988
19,19585,2014-12-31,1594,14636,16230
19,19585,2015-12-31,1620,14878,16498
19,19585,2016-12-31,1668,15088,16756
19,19585,2017-12-31,1705,15322,17027
19,19585,2018-12-31,1697,15575,17272
19,19585,2019-12-31,1700,15723,17423
19,19585,2020-12-31,1702,15867,17569
19,19585,2021-12-31,1632,16077,17709
19,19585,2022-12-31,1565,16285,17850
19,19585,2023-12-31,1503,16489,17992
19,19585,2024-12-31,1479,16713,18192
19,19585,2025-12-31,1479,16895,18374
19,19585,2026-12-31,1472,17091,18563
19,19585,2027-12-31,1475,17264,18739
19,19585,2028-12-31,1478,17447,18925
19,19585,2029-12-31,1484,17608,19092
19,19585,2030-12-31,1491,17765,19256
19,19585,2031-12-31,1496,17913,19409
19,19585,2032-12-31,1494,18075,19569
19,19585,2033-12-31,1490,18209,19699
19,19585,2034-12-31,1497,18354,19851
19,19585,2035-12-31,1502,18500,20002
19,19622,1985-12-31,1130,10160,11290
19,19622,1986-12-31,1155,10119,11274
19,19622,1987-12-31,1106,10104,11210
19,19622,1988-12-31,1140,10070,11210
19,19622,1989-12-31,1120,10063,11183
19,19622,1990-12-31,1085,10148,11233
19,19622,1991-12-31,1049,10167,11216
19,19622,1992-12-31,1046,10133,11179
19,19622,1993-12-31,1041,10185,11226
19,19622,1994-12-31,1055,10169,11224
19,19622,1995-12-31,1011,10158,11169
19,19622,1996-12-31,1056,10149,11205
19,19622,1997-12-31,1085,10158,11243
19,19622,1998-12-31,1055,10120,11175
19,19622,1999-12-31,1065,10238,11303
19,19622,2000-12-31,1065,10178,11243
19,19622,2001-12-31,1088,10133,11221
19,19622,2002-12-31,1097,10147,11244
19,19622,2003-12-31,1070,10173,11243
19,19622,2004-12-31,1060,10181,11241
19,19622,2005-12-31,1060,10196,11256
19,19622,2006-12-31,1057,10209,11266
19,19622,2007-12-31,1071,10316,11387
19,19622,2008-12-31,1079,10258,11337
19,19622,2009-12-31,1080,10278,11358
19,19622,2010-12-31,1052,10270,11322
19,19622,2011-12-31,1053,10293,11346
19,19622,2012-12-31,1112,10297,11409
19,19622,2013-12-31,1122,10330,11452
19,19622,2014-12-31,1103,10315,11418
19,19622,2015-12-31,1099,10315,11414
19,19622,2016-12-31,1096,10297,11393
19,19622,2017-12-31,1099,10310,11409
19,19622,2018-12-31,1087,10388,11475
19,19622,2019-12-31,1089,10406,11495
19,19622,2020-12-31,1089,10450,11539
19,19622,2021-12-31,1043,10588,11631
19,19622,2022-12-31,999,10725,11724
19,19622,2023-12-31,957,10860,11817
19,19622,2024-12-31,950,11007,11957
19,19622,2025-12-31,944,11113,12057
19,19622,2026-12-31,936,11238,12174
19,19622,2027-12-31,938,11359,12297
19,19622,2028-12-31,942,11476,12418
19,19622,2029-12-31,949,11582,12531
19,19622,2030-12-31,952,11681,12633
19,19622,2031-12-31,950,11774,12724
19,19622,2032-12-31,948,11866,12814
19,19622,2033-12-31,951,11965,12916
19,19622,2034-12-31,956,12056,13012
19,19622,2035-12-31,957,12160,13117
19,19693,1985-12-31,1092,8042,9134
19,19693,1986-12-31,1022,8074,9096
19,19693,1987-12-31,1014,8129,9143
19,19693,1988-12-31,992,8187,9179
19,19693,1989-12-31,987,8232,9219
19,19693,1990-12-31,964,8371,9335
19,19693,1991-12-31,931,8464,9395
19,19693,1992-12-31,931,8512,9443
19,19693,1993-12-31,926,8612,9538
19,19693,1994-12-31,878,8662,9540
19,19693,1995-12-31,857,8718,9575
19,19693,1996-12-31,872,8786,9658
19,19693,1997-12-31,865,8857,9722
19,19693,1998-12-31,838,8880,9718
19,19693,1999-12-31,852,9054,9906
19,19693,2000-12-31,848,9066,9914
19,19693,2001-12-31,802,9077,9879
19,19693,2002-12-31,819,9158,9977
19,19693,2003-12-31,819,9241,10060
19,19693,2004-12-31,801,9311,10112
19,19693,2005-12-31,800,9383,10183
19,19693,2006-12-31,777,9449,10226
19,19693,2007-12-31,769,9615,10384
19,19693,2008-12-31,763,9626,10389
19,19693,2009-12-31,761,9687,10448
19,19693,2010-12-31,767,9753,10520
19,19693,2011-12-31,763,9814,10577
19,19693,2012-12-31,749,9875,10624
19,19693,2013-12-31,731,9936,10667
19,19693,2014-12-31,717,9981,10698
19,19693,2015-12-31,708,10055,10763
19,19693,2016-12-31,698,10121,10819
19,19693,2017-12-31,691,10177,10868
19,19693,2018-12-31,668,10280,10948
19,19693,2019-12-31,668,10336,11004
19,19693,2020-12-31,668,10394,11062
19,19693,2021-12-31,619,10531,11150
19,19693,2022-12-31,571,10668,11239
19,19693,2023-12-31,526,10802,11328
19,19693,2024-12-31,504,10937,11441
19,19693,2025-12-31,505,11065,11570
19,19693,2026-12-31,507,11200,11707
19,19693,2027-12-31,501,11308,11809
19,19693,2028-12-31,495,11416,11911
19,19693,2029-12-31,498,11543,12041
19,19693,2030-12-31,499,11638,12137
19,19693,2031-12-31,501,11721,12222
19,19693,2032-12-31,509,11831,12340
19,19693,2033-12-31,510,11908,12418
19,19693,2034-12-31,506,12002,12508
19,19693,2035-12-31,506,12094,12600
19,19698,1985-12-31,27569,42269,69838
19,19698,1986-12-31,28308,43700,72008
19,19698,1987-12-31,29047,45150,74197
19,19698,1988-12-31,29793,46594,76387
19,19698,1989-12-31,30544,48049,78593
19,19698,1990-12-31,30747,49981,80728
19,19698,1991-12-31,31217,51635,82852
19,19698,1992-12-31,31991,53001,84992
19,19698,1993-12-31,32685,54740,87425
19,19698,1994-12-31,33609,56040,89649
19,19698,1995-12-31,34472,57421,91893
19,19698,1996-12-31,35329,58847,94176
19,19698,1997-12-31,36202,60358,96560
19,19698,1998-12-31,37484,61397,98881
19,19698,1999-12-31,37513,48912,86425
19,19698,2000-12-31,38806,49098,87904
19,19698,2001-12-31,40126,49329,89455
19,19698,2002-12-31,40924,49913,90837
19,19698,2003-12-31,41699,50470,92169
19,19698,2004-12-31,42479,51021,93500
19,19698,2005-12-31,43210,51532,94742
19,19698,2006-12-31,43977,52088,96065
19,19698,2007-12-31,44038,53077,97115
19,19698,2008-12-31,45130,53298,98428
19,19698,2009-12-31,45877,53773,99650
19,19698,2010-12-31,46602,54265,100867
19,19698,2011-12-31,47317,54747,102064
19,19698,2012-12-31,47988,55217,103205
19,19698,2013-12-31,48691,55684,104375
19,19698,2014-12-31,49374,56151,105525
19,19698,2015-12-31,50061,56651,106712
19,19698,2016-12-31,50771,57135,107906
19,19698,2017-12-31,51532,57683,109215
19,19698,2018-12-31,52246,58199,110445
19,19698,2019-12-31,52513,59276,111789
19,19698,2020-12-31,52684,60317,113001
19,19698,2021-12-31,52799,61126,113925
19,19698,2022-12-31,52914,61918,114832
19,19698,2023-12-31,53049,62696,115745
19,19698,2024-12-31,53220,63409,116629
19,19698,2025-12-31,53397,64145,117542
19,19698,2026-12-31,53598,64867,118465
19,19698,2027-12-31,53820,65536,119356
19,19698,2028-12-31,54022,66198,120220
19,19698,2029-12-31,54284,66827,121111
19,19698,2030-12-31,54551,67436,121987
19,19698,2031-12-31,54826,67992,122818
19,19698,2032-12-31,55079,68568,123647
19,19698,2033-12-31,55312,69129,124441
19,19698,2034-12-31,55523,69682,125205
19,19698,2035-12-31,55722,70187,125909
19,19701,1985-12-31,625,6077,6702
19,19701,1986-12-31,617,6478,7095
19,19701,1987-12-31,611,6878,7489
19,19701,1988-12-31,618,7270,7888
19,19701,1989-12-31,639,7673,8312
19,19701,1990-12-31,596,8160,8756
19,19701,1991-12-31,592,8584,9176
19,19701,1992-12-31,599,8957,9556
19,19701,1993-12-31,608,9398,10006
19,19701,1994-12-31,631,9762,10393
19,19701,1995-12-31,601,10135,10736
19,19701,1996-12-31,594,10508,11102
19,19701,1997-12-31,624,5912,6536
19,19701,1998-12-31,588,5806,6394
19,19701,1999-12-31,621,5802,6423
19,19701,2000-12-31,657,5702,6359
19,19701,2001-12-31,606,5614,6220
19,19701,2002-12-31,618,5548,6166
19,19701,2003-12-31,616,5500,6116
19,19701,2004-12-31,624,5448,6072
19,19701,2005-12-31,625,5379,6004
19,19701,2006-12-31,664,5314,5978
19,19701,2007-12-31,636,5304,5940
19,19701,2008-12-31,632,5218,5850
19,19701,2009-12-31,647,5155,5802
19,19701,2010-12-31,647,5088,5735
19,19701,2011-12-31,670,5039,5709
19,19701,2012-12-31,664,4968,5632
19,19701,2013-12-31,659,4911,5570
19,19701,2014-12-31,658,4852,5510
19,19701,2015-12-31,702,4788,5490
19,19701,2016-12-31,701,4730,5431
19,19701,2017-12-31,687,4703,5390
19,19701,2018-12-31,672,4667,5339
19,19701,2019-12-31,673,4681,5354
19,19701,2020-12-31,674,4709,5383
19,19701,2021-12-31,655,4771,5426
19,19701,2022-12-31,636,4833,5469
19,19701,2023-12-31,619,4894,5513
19,19701,2024-12-31,611,4946,5557
19,19701,2025-12-31,607,5006,5613
19,19701,2026-12-31,606,5061,5667
19,19701,2027-12-31,611,5115,5726
19,19701,2028-12-31,620,5167,5787
19,19701,2029-12-31,617,5224,5841
19,19701,2030-12-31,621,5257,5878
19,19701,2031-12-31,626,5308,5934
19,19701,2032-12-31,629,5348,5977
19,19701,2033-12-31,627,5396,6023
19,19701,2034-12-31,622,5439,6061
19,19701,2035-12-31,628,5477,6105
19,19743,1985-12-31,4316,9198,13514
19,19743,1986-12-31,4307,9989,14296
19,19743,1987-12-31,4290,10776,15066
19,19743,1988-12-31,4294,11539,15833
19,19743,1989-12-31,4297,12324,16621
19,19743,1990-12-31,4224,13224,17448
19,19743,1991-12-31,4190,14001,18191
19,19743,1992-12-31,4213,14765,18978
19,19743,1993-12-31,4206,15609,19815
19,19743,1994-12-31,4231,16343,20574
19,19743,1995-12-31,4273,17079,21352
19,19743,1996-12-31,4216,17799,22015
19,19743,1997-12-31,4270,18566,22836
19,19743,1998-12-31,4352,19175,23527
19,19743,1999-12-31,4274,20131,24405
19,19743,2000-12-31,4351,20714,25065
19,19743,2001-12-31,4382,21304,25686
19,19743,2002-12-31,4403,22040,26443
19,19743,2003-12-31,4423,22746,27169
19,19743,2004-12-31,4421,23466,27887
19,19743,2005-12-31,4454,24167,28621
19,19743,2006-12-31,4460,24866,29326
19,19743,2007-12-31,4421,25789,30210
19,19743,2008-12-31,4462,26317,30779
19,19743,2009-12-31,4447,26988,31435
19,19743,2010-12-31,4452,27652,32104
19,19743,2011-12-31,4466,28308,32774
19,19743,2012-12-31,4481,28951,33432
19,19743,2013-12-31,4457,29598,34055
19,19743,2014-12-31,4448,30250,34698
19,19743,2015-12-31,4402,30878,35280
19,19743,2016-12-31,4416,31532,35948
19,19743,2017-12-31,4465,32205,36670
19,19743,2018-12-31,4492,32845,37337
19,19743,2019-12-31,4423,33290,37713
19,19743,2020-12-31,4377,33686,38063
19,19743,2021-12-31,4243,34131,38374
19,19743,2022-12-31,4107,34573,38680
19,19743,2023-12-31,3980,35007,38987
19,19743,2024-12-31,3888,35436,39324
19,19743,2025-12-31,3823,35872,39695
19,19743,2026-12-31,3801,36274,40075
19,19743,2027-12-31,3780,36668,40448
19,19743,2028-12-31,3791,37040,40831
19,19743,2029-12-31,3783,37374,41157
19,19743,2030-12-31,3791,37716,41507
19,19743,2031-12-31,3792,38047,41839
19,19743,2032-12-31,3818,38364,42182
19,19743,2033-12-31,3827,38670,42497
19,19743,2034-12-31,3836,38970,42806
19,19743,2035-12-31,3839,39283,43122
19,19760,1985-12-31,398,8210,8608
19,19760,1986-12-31,431,8355,8786
19,19760,1987-12-31,393,8517,8910
19,19760,1988-12-31,388,8658,9046
19,19760,1989-12-31,417,8815,9232
19,19760,1990-12-31,389,9061,9450
19,19760,1991-12-31,390,9242,9632
19,19760,1992-12-31,409,9400,9809
19,19760,1993-12-31,406,9590,9996
19,19760,1994-12-31,407,9724,10131
19,19760,1995-12-31,411,9873,10284
19,19760,1996-12-31,428,10030,10458
19,19760,1997-12-31,428,10205,10633
19,19760,1998-12-31,438,10311,10749
19,19760,1999-12-31,446,10590,11036
19,19760,2000-12-31,482,10666,11148
19,19760,2001-12-31,460,10766,11226
19,19760,2002-12-31,480,10925,11405
19,19760,2003-12-31,462,11091,11553
19,19760,2004-12-31,501,11256,11757
19,19760,2005-12-31,501,11407,11908
19,19760,2006-12-31,518,11560,12078
19,19760,2007-12-31,486,11826,12312
19,19760,2008-12-31,486,11920,12406
19,19760,2009-12-31,485,12064,12549
19,19760,2010-12-31,494,12203,12697
19,19760,2011-12-31,496,12333,12829
19,19760,2012-12-31,519,12498,13017
19,19760,2013-12-31,528,12609,13137
19,19760,2014-12-31,535,12764,13299
19,19760,2015-12-31,541,12889,13430
19,19760,2016-12-31,545,13062,13607
19,19760,2017-12-31,550,13186,13736
19,19760,2018-12-31,571,13368,13939
19,19760,2019-12-31,569,13510,14079
19,19760,2020-12-31,566,13644,14210
19,19760,2021-12-31,502,13824,14326
19,19760,2022-12-31,437,14003,14440
19,19760,2023-12-31,376,14179,14555
19,19760,2024-12-31,358,14370,14728
19,19760,2025-12-31,351,14542,14893
19,19760,2026-12-31,348,14681,15029
19,19760,2027-12-31,346,14846,15192
19,19760,2028-12-31,345,14989,15334
19,19760,2029-12-31,345,15126,15471
19,19760,2030-12-31,344,15268,15612
19,19760,2031-12-31,343,15400,15743
19,19760,2032-12-31,343,15532,15875
19,19760,2033-12-31,347,15646,15993
19,19760,2034-12-31,352,15774,16126
19,19760,2035-12-31,354,15902,16256
19,19780,1985-12-31,0,0,0
19,19780,1986-12-31,0,0,0
19,19780,1987-12-31,0,0,0
19,19780,1988-12-31,0,0,0
19,19780,1989-12-31,0,0,0
19,19780,1990-12-31,6550,15305,21855
19,19780,1991-12-31,6478,15750,22228
19,19780,1992-12-31,6462,16102,22564
19,19780,1993-12-31,6446,16576,23022
19,19780,1994-12-31,6465,16911,23376
19,19780,1995-12-31,6480,17284,23764
19,19780,1996-12-31,6490,17649,24139
19,19780,1997-12-31,6486,18066,24552
19,19780,1998-12-31,6568,18320,24888
19,19780,1999-12-31,6440,18912,25352
19,19780,2000-12-31,6520,19168,25688
19,19780,2001-12-31,6597,19425,26022
19,19780,2002-12-31,6586,19815,26401
19,19780,2003-12-31,6589,20195,26784
19,19780,2004-12-31,6559,20572,27131
19,19780,2005-12-31,6572,20943,27515
19,19780,2006-12-31,6559,21315,27874
19,19780,2007-12-31,6458,21867,28325
19,19780,2008-12-31,6494,22103,28597
19,19780,2009-12-31,6484,22447,28931
19,19780,2010-12-31,6467,22800,29267
19,19780,2011-12-31,6457,23114,29571
19,19780,2012-12-31,6454,23445,29899
19,19780,2013-12-31,6434,23777,30211
19,19780,2014-12-31,6423,24158,30581
19,19780,2015-12-31,6375,24525,30900
19,19780,2016-12-31,6378,24831,31209
19,19780,2017-12-31,6374,25213,31587
19,19780,2018-12-31,6380,25524,31904
19,19780,2019-12-31,6314,25912,32226
19,19780,2020-12-31,6247,26279,32526
19,19780,2021-12-31,6160,26632,32792
19,19780,2022-12-31,6076,26977,33053
19,19780,2023-12-31,6000,27316,33316
19,19780,2024-12-31,5936,27647,33583
19,19780,2025-12-31,5878,27968,33846
19,19780,2026-12-31,5840,28286,34126
19,19780,2027-12-31,5806,28569,34375
19,19780,2028-12-31,5783,28858,34641
19,19780,2029-12-31,5767,29142,34909
19,19780,2030-12-31,5772,29404,35176
19,19780,2031-12-31,5757,29647,35404
19,19780,2032-12-31,5762,29900,35662
19,19780,2033-12-31,5763,30143,35906
19,19780,2034-12-31,5754,30374,36128
19,19780,2035-12-31,5774,30602,36376
19,19785,1985-12-31,0,0,0
19,19785,1986-12-31,0,0,0
19,19785,1987-12-31,0,0,0
19,19785,1988-12-31,0,0,0
19,19785,1989-12-31,0,0,0
19,19785,1990-12-31,0,0,0
19,19785,1991-12-31,0,0,0
19,19785,1992-12-31,0,0,0
19,19785,1993-12-31,0,0,0
19,19785,1994-12-31,0,0,0
19,19785,1995-12-31,0,0,0
19,19785,1996-12-31,0,0,0
19,19785,1997-12-31,0,0,0
19,19785,1998-12-31,0,0,0
19,19785,1999-12-31,0,0,0
19,19785,2000-12-31,1370,8717,10087
19,19785,2001-12-31,1404,8658,10062
19,19785,2002-12-31,1437,8561,9998
19,19785,2003-12-31,1439,8532,9971
19,19785,2004-12-31,1447,8479,9926
19,19785,2005-12-31,1425,8433,9858
19,19785,2006-12-31,1432,8385,9817
19,19785,2007-12-31,1426,8422,9848
19,19785,2008-12-31,1466,8314,9780
19,19785,2009-12-31,1497,8264,9761
19,19785,2010-12-31,1510,8215,9725
19,19785,2011-12-31,1519,8146,9665
19,19785,2012-12-31,1536,8109,9645
19,19785,2013-12-31,1559,8052,9611
19,19785,2014-12-31,1584,8010,9594
19,19785,2015-12-31,1597,7973,9570
19,19785,2016-12-31,1610,7886,9496
19,19785,2017-12-31,1625,7862,9487
19,19785,2018-12-31,1633,7856,9489
19,19785,2019-12-31,1639,7943,9582
19,19785,2020-12-31,1644,8025,9669
19,19785,2021-12-31,1617,8131,9748
19,19785,2022-12-31,1590,8236,9826
19,19785,2023-12-31,1564,8340,9904
19,19785,2024-12-31,1560,8445,10005
19,19785,2025-12-31,1555,8542,10097
19,19785,2026-12-31,1557,8640,10197
19,19785,2027-12-31,1561,8733,10294
19,19785,2028-12-31,1565,8822,10387
19,19785,2029-12-31,1558,8894,10452
19,19785,2030-12-31,1572,8971,10543
19,19785,2031-12-31,1575,9067,10642
19,19785,2032-12-31,1577,9120,10697
19,19785,2033-12-31,1586,9202,10788
19,19785,2034-12-31,1589,9269,10858
19,19785,2035-12-31,1583,9338,10921
19,19807,1985-12-31,9453,19674,29127
19,19807,1986-12-31,9604,19621,29225
19,19807,1987-12-31,9734,19600,29334
19,19807,1988-12-31,9871,19585,29456
19,19807,1989-12-31,10019,19581,29600
19,19807,1990-12-31,10014,19766,29780
19,19807,1991-12-31,10058,19820,29878
19,19807,1992-12-31,10218,19811,30029
19,19807,1993-12-31,10365,19931,30296
19,19807,1994-12-31,10583,19909,30492
19,19807,1995-12-31,10788,19958,30746
19,19807,1996-12-31,10970,19964,30934
19,19807,1997-12-31,11161,20023,31184
19,19807,1998-12-31,11466,19949,31415
19,19807,1999-12-31,11412,20217,31629
19,19807,2000-12-31,11731,20112,31843
19,19807,2001-12-31,12055,20031,32086
19,19807,2002-12-31,12235,20097,32332
19,19807,2003-12-31,12390,20164,32554
19,19807,2004-12-31,12560,20214,32774
19,19807,2005-12-31,12705,20241,32946
19,19807,2006-12-31,12858,20313,33171
19,19807,2007-12-31,12830,20540,33370
19,19807,2008-12-31,13095,20463,33558
19,19807,2009-12-31,13247,20500,33747
19,19807,2010-12-31,13412,20530,33942
19,19807,2011-12-31,13534,20574,34108
19,19807,2012-12-31,13697,20638,34335
19,19807,2013-12-31,13787,20643,34430
19,19807,2014-12-31,13993,20711,34704
19,19807,2015-12-31,14123,20745,34868
19,19807,2016-12-31,14230,20774,35004
19,19807,2017-12-31,14344,20820,35164
19,19807,2018-12-31,14562,20917,35479
19,19807,2019-12-31,14591,21304,35895
19,19807,2020-12-31,14607,21680,36287
19,19807,2021-12-31,14613,21971,36584
19,19807,2022-12-31,14619,22256,36875
19,19807,2023-12-31,14633,22535,37168
19,19807,2024-12-31,14654,22783,37437
19,19807,2025-12-31,14682,23031,37713
19,19807,2026-12-31,14717,23288,38005
19,19807,2027-12-31,14760,23549,38309
19,19807,2028-12-31,14805,23786,38591
19,19807,2029-12-31,14864,23991,38855
19,19807,2030-12-31,14907,24209,39116
19,19807,2031-12-31,14971,24411,39382
19,19807,2032-12-31,15000,24612,39612
19,19807,2033-12-31,15048,24804,39852
19,19807,2034-12-31,15089,24997,40086
19,19807,2035-12-31,15127,25199,40326
19,19809,1985-12-31,2378,13818,16196
19,19809,1986-12-31,2515,13957,16472
19,19809,1987-12-31,2631,14116,16747
19,19809,1988-12-31,2751,14281,17032
19,19809,1989-12-31,2878,14454,17332
19,19809,1990-12-31,2958,14794,17752
19,19809,1991-12-31,3046,15028,18074
19,19809,1992-12-31,3185,15180,18365
19,19809,1993-12-31,3254,15440,18694
19,19809,1994-12-31,3401,15582,18983
19,19809,1995-12-31,3539,15741,19280
19,19809,1996-12-31,3656,15922,19578
19,19809,1997-12-31,3791,16127,19918
19,19809,1998-12-31,3971,16204,20175
19,19809,1999-12-31,4007,16600,20607
19,19809,2000-12-31,4199,16676,20875
19,19809,2001-12-31,4365,16762,21127
19,19809,2002-12-31,4501,16960,21461
19,19809,2003-12-31,4643,17136,21779
19,19809,2004-12-31,4736,17333,22069
19,19809,2005-12-31,4864,17515,22379
19,19809,2006-12-31,4983,17709,22692
19,19809,2007-12-31,4981,18038,23019
19,19809,2008-12-31,5194,18117,23311
19,19809,2009-12-31,5285,18320,23605
19,19809,2010-12-31,5374,18495,23869
19,19809,2011-12-31,5487,18660,24147
19,19809,2012-12-31,5586,18819,24405
19,19809,2013-12-31,5712,18973,24685
19,19809,2014-12-31,5825,19137,24962
19,19809,2015-12-31,5902,19293,25195
19,19809,2016-12-31,6010,19481,25491
19,19809,2017-12-31,6144,19653,25797
19,19809,2018-12-31,6266,19834,26100
19,19809,2019-12-31,6279,20084,26363
19,19809,2020-12-31,6287,20320,26607
19,19809,2021-12-31,6235,20589,26824
19,19809,2022-12-31,6183,20855,27038
19,19809,2023-12-31,6136,21117,27253
19,19809,2024-12-31,6125,21404,27529
19,19809,2025-12-31,6124,21644,27768
19,19809,2026-12-31,6134,21869,28003
19,19809,2027-12-31,6144,22125,28269
19,19809,2028-12-31,6150,22359,28509
19,19809,2029-12-31,6170,22569,28739
19,19809,2030-12-31,6199,22760,28959
19,19809,2031-12-31,6211,22969,29180
19,19809,2032-12-31,6225,23143,29368
19,19809,2033-12-31,6242,23346,29588
19,19809,2034-12-31,6254,23517,29771
19,19809,2035-12-31,6260,23686,29946
19,19821,1985-12-31,1011,925,1936
19,19821,1986-12-31,1029,2044,3073
19,19821,1987-12-31,1091,3143,4234
19,19821,1988-12-31,1135,4219,5354
19,19821,1989-12-31,1177,5294,6471
19,19821,1990-12-31,1192,6414,7606
19,19821,1991-12-31,1223,7498,8721
19,19821,1992-12-31,1269,8527,9796
19,19821,1993-12-31,1309,9610,10919
19,19821,1994-12-31,1355,10603,11958
19,19821,1995-12-31,1405,11612,13017
19,19821,1996-12-31,1465,12631,14096
19,19821,1997-12-31,1514,13628,15142
19,19821,1998-12-31,1600,14521,16121
19,19821,1999-12-31,1602,15672,17274
19,19821,2000-12-31,1661,16546,18207
19,19821,2001-12-31,1716,17404,19120
19,19821,2002-12-31,1779,18368,20147
19,19821,2003-12-31,1824,19321,21145
19,19821,2004-12-31,1864,20271,22135
19,19821,2005-12-31,1896,21197,23093
19,19821,2006-12-31,1959,22137,24096
19,19821,2007-12-31,1942,23270,25212
19,19821,2008-12-31,2047,24066,26113
19,19821,2009-12-31,2101,24950,27051
19,19821,2010-12-31,2160,25857,28017
19,19821,2011-12-31,2202,26725,28927
19,19821,2012-12-31,2173,27598,29771
19,19821,2013-12-31,2211,28442,30653
19,19821,2014-12-31,2255,29310,31565
19,19821,2015-12-31,2316,30162,32478
19,19821,2016-12-31,2368,31018,33386
19,19821,2017-12-31,2427,31895,34322
19,19821,2018-12-31,2441,32777,35218
19,19821,2019-12-31,2446,33570,36016
19,19821,2020-12-31,2449,34245,36694
19,19821,2021-12-31,2290,34704,36994
19,19821,2022-12-31,2135,35154,37289
19,19821,2023-12-31,1989,35596,37585
19,19821,2024-12-31,1947,35999,37946
19,19821,2025-12-31,1927,36440,38367
19,19821,2026-12-31,1928,36843,38771
19,19821,2027-12-31,1927,37209,39136
19,19821,2028-12-31,1939,37569,39508
19,19821,2029-12-31,1939,37928,39867
19,19821,2030-12-31,1946,38274,40220
19,19821,2031-12-31,1949,38624,40573
19,19821,2032-12-31,1957,38961,40918
19,19821,2033-12-31,1957,39272,41229
19,19821,2034-12-31,1969,39579,41548
19,19821,2035-12-31,1966,39894,41860
19,19824,1985-12-31,982,6454,7436
19,19824,1986-12-31,943,7007,7950
19,19824,1987-12-31,975,7572,8547
19,19824,1988-12-31,984,8114,9098
19,19824,1989-12-31,1007,8659,9666
19,19824,1990-12-31,1021,9306,10327
19,19824,1991-12-31,982,9888,10870
19,19824,1992-12-31,977,10413,11390
19,19824,1993-12-31,986,11003,11989
19,19824,1994-12-31,983,11522,12505
19,19824,1995-12-31,1012,12045,13057
19,19824,1996-12-31,1049,12570,13619
19,19824,1997-12-31,1041,13101,14142
19,19824,1998-12-31,1079,13539,14618
19,19824,1999-12-31,1105,14220,15325
19,19824,2000-12-31,1123,14626,15749
19,19824,2001-12-31,1124,15056,16180
19,19824,2002-12-31,1138,15576,16714
19,19824,2003-12-31,1160,16072,17232
19,19824,2004-12-31,1177,16586,17763
19,19824,2005-12-31,1172,17077,18249
19,19824,2006-12-31,1181,17572,18753
19,19824,2007-12-31,1170,18226,19396
19,19824,2008-12-31,1194,18608,19802
19,19824,2009-12-31,1204,19081,20285
19,19824,2010-12-31,1217,19554,20771
19,19824,2011-12-31,1210,20020,21230
19,19824,2012-12-31,1236,20484,21720
19,19824,2013-12-31,1299,20934,22233
19,19824,2014-12-31,1305,21372,22677
19,19824,2015-12-31,1315,21844,23159
19,19824,2016-12-31,1322,22302,23624
19,19824,2017-12-31,1326,22768,24094
19,19824,2018-12-31,1319,23239,24558
19,19824,2019-12-31,1332,23805,25137
19,19824,2020-12-31,1344,24268,25612
19,19824,2021-12-31,1227,24594,25821
19,19824,2022-12-31,1115,24912,26027
19,19824,2023-12-31,1009,25225,26234
19,19824,2024-12-31,975,25513,26488
19,19824,2025-12-31,966,25808,26774
19,19824,2026-12-31,961,26097,27058
19,19824,2027-12-31,961,26386,27347
19,19824,2028-12-31,971,26659,27630
19,19824,2029-12-31,976,26915,27891
19,19824,2030-12-31,978,27154,28132
19,19824,2031-12-31,983,27365,28348
19,19824,2032-12-31,991,27597,28588
19,19824,2033-12-31,988,27814,28802
19,19824,2034-12-31,985,28033,29018
19,19824,2035-12-31,985,28251,29236
19,19845,1985-12-31,0,0,0
19,19845,1986-12-31,0,0,0
19,19845,1987-12-31,0,0,0
19,19845,1988-12-31,0,0,0
19,19845,1989-12-31,0,0,0
19,19845,1990-12-31,0,0,0
19,19845,1991-12-31,0,0,0
19,19845,1992-12-31,0,0,0
19,19845,1993-12-31,0,0,0
19,19845,1994-12-31,0,0,0
19,19845,1995-12-31,0,0,0
19,19845,1996-12-31,0,0,0
19,19845,1997-12-31,0,0,0
19,19845,1998-12-31,0,0,0
19,19845,1999-12-31,9224,5836,15060
19,19845,2000-12-31,9645,5839,15484
19,19845,2001-12-31,10039,5830,15869
19,19845,2002-12-31,10304,5854,16158
19,19845,2003-12-31,10584,5895,16479
19,19845,2004-12-31,10853,5956,16809
19,19845,2005-12-31,11104,5976,17080
19,19845,2006-12-31,11349,6018,17367
19,19845,2007-12-31,11437,6089,17526
19,19845,2008-12-31,11824,6104,17928
19,19845,2009-12-31,12058,6128,18186
19,19845,2010-12-31,12290,6166,18456
19,19845,2011-12-31,12556,6208,18764
19,19845,2012-12-31,12813,6198,19011
19,19845,2013-12-31,13018,6227,19245
19,19845,2014-12-31,13277,6279,19556
19,19845,2015-12-31,13536,6301,19837
19,19845,2016-12-31,13824,6315,20139
19,19845,2017-12-31,13975,6381,20356
19,19845,2018-12-31,14267,6426,20693
19,19845,2019-12-31,14370,6630,21000
19,19845,2020-12-31,14488,6840,21328
19,19845,2021-12-31,14570,6932,21502
19,19845,2022-12-31,14652,7022,21674
19,19845,2023-12-31,14736,7110,21846
19,19845,2024-12-31,14815,7192,22007
19,19845,2025-12-31,14898,7276,22174
19,19845,2026-12-31,14974,7357,22331
19,19845,2027-12-31,15035,7439,22474
19,19845,2028-12-31,15109,7502,22611
19,19845,2029-12-31,15170,7576,22746
19,19845,2030-12-31,15233,7645,22878
19,19845,2031-12-31,15290,7713,23003
19,19845,2032-12-31,15360,7780,23140
19,19845,2033-12-31,15402,7839,23241
19,19845,2034-12-31,15448,7891,23339
19,19845,2035-12-31,15485,7966,23451
20,20001,1985-12-31,155016,42493,197509
20,20001,1986-12-31,162255,46353,208608
20,20001,1987-12-31,169534,50346,219880
20,20001,1988-12-31,176612,54362,230974
20,20001,1989-12-31,183603,58387,241990
20,20001,1990-12-31,190453,62455,252908
20,20001,1991-12-31,197328,66569,263897
20,20001,1992-12-31,204118,70682,274800
20,20001,1993-12-31,210839,74774,285613
20,20001,1994-12-31,217269,78859,296128
20,20001,1995-12-31,223640,82829,306469
20,20001,1996-12-31,230043,86668,316711
20,20001,1997-12-31,236568,90351,326919
20,20001,1998-12-31,241449,76571,318020
20,20001,1999-12-31,252274,74468,326742
20,20001,2000-12-31,260228,73872,334100
20,20001,2001-12-31,269253,72641,341894
20,20001,2002-12-31,279531,70704,350235
20,20001,2003-12-31,291036,68106,359142
20,20001,2004-12-31,303218,65119,368337
20,20001,2005-12-31,315074,62186,377260
20,20001,2006-12-31,326252,59762,386014
20,20001,2007-12-31,336453,57976,394429
20,20001,2008-12-31,345690,56849,402539
20,20001,2009-12-31,354090,56173,410263
20,20001,2010-12-31,362072,55842,417914
20,20001,2011-12-31,369541,55711,425252
20,20001,2012-12-31,376783,55726,432509
20,20001,2013-12-31,384040,55832,439872
20,20001,2014-12-31,391227,55991,447218
20,20001,2015-12-31,398712,56194,454906
20,20001,2016-12-31,407358,56565,463923
20,20001,2017-12-31,417446,57150,474596
20,20001,2018-12-31,431794,58281,490075
20,20001,2019-12-31,451803,61882,513685
20,20001,2020-12-31,468165,64791,532956
20,20001,2021-12-31,477763,66371,544134
20,20001,2022-12-31,484453,67595,552048
20,20001,2023-12-31,490733,68729,559462
20,20001,2024-12-31,496408,69829,566237
20,20001,2025-12-31,502111,70902,573013
20,20001,2026-12-31,507637,71953,579590
20,20001,2027-12-31,513008,72999,586007
20,20001,2028-12-31,518258,74018,592276
20,20001,2029-12-31,523371,75029,598400
20,20001,2030-12-31,528374,76033,604407
20,20001,2031-12-31,533277,77043,610320
20,20001,2032-12-31,537988,78053,616041
20,20001,2033-12-31,542476,79016,621492
20,20001,2034-12-31,546775,79983,626758
20,20001,2035-12-31,550874,80929,631803
20,20011,1985-12-31,40977,10479,51456
20,20011,1986-12-31,42326,10720,53046
20,20011,1987-12-31,43678,11002,54680
20,20011,1988-12-31,45011,11234,56245
20,20011,1989-12-31,46342,11453,57795
20,20011,1990-12-31,47562,11676,59238
20,20011,1991-12-31,48866,11893,60759
20,20011,1992-12-31,50149,12090,62239
20,20011,1993-12-31,51413,12299,63712
20,20011,1994-12-31,52629,12480,65109
20,20011,1995-12-31,53825,12635,66460
20,20011,1996-12-31,55034,12776,67810
20,20011,1997-12-31,56276,12891,69167
20,20011,1998-12-31,57136,13078,70214
20,20011,1999-12-31,59393,12928,72321
20,20011,2000-12-31,60979,13044,74023
20,20011,2001-12-31,62817,13014,75831
20,20011,2002-12-31,64936,12880,77816
20,20011,2003-12-31,67347,12595,79942
20,20011,2004-12-31,69892,12237,82129
20,20011,2005-12-31,72407,11872,84279
20,20011,2006-12-31,74691,11611,86302
20,20011,2007-12-31,76754,11451,88205
20,20011,2008-12-31,78594,11396,89990
20,20011,2009-12-31,80260,11452,91712
20,20011,2010-12-31,81871,11559,93430
20,20011,2011-12-31,83340,11723,95063
20,20011,2012-12-31,84768,11919,96687
20,20011,2013-12-31,86196,12137,98333
20,20011,2014-12-31,87578,12372,99950
20,20011,2015-12-31,89062,12626,101688
20,20011,2016-12-31,90789,12925,103714
20,20011,2017-12-31,92841,13278,106119
20,20011,2018-12-31,95851,13770,109621
20,20011,2019-12-31,99897,14672,114569
20,20011,2020-12-31,103209,15443,118652
20,20011,2021-12-31,105320,15820,121140
20,20011,2022-12-31,106790,16112,122902
20,20011,2023-12-31,108171,16382,124553
20,20011,2024-12-31,109507,16652,126159
20,20011,2025-12-31,110735,16902,127637
20,20011,2026-12-31,111920,17155,129075
20,20011,2027-12-31,113079,17387,130466
20,20011,2028-12-31,114209,17630,131839
20,20011,2029-12-31,115323,17864,133187
20,20011,2030-12-31,116424,18119,134543
20,20011,2031-12-31,117489,18355,135844
20,20011,2032-12-31,118517,18572,137089
20,20011,2033-12-31,119511,18827,138338
20,20011,2034-12-31,120432,19047,139479
20,20011,2035-12-31,121348,19270,140618
20,20013,1985-12-31,30568,10787,41355
20,20013,1986-12-31,30840,10984,41824
20,20013,1987-12-31,31134,11177,42311
20,20013,1988-12-31,31402,11402,42804
20,20013,1989-12-31,31711,11584,43295
20,20013,1990-12-31,31951,11772,43723
20,20013,1991-12-31,32264,11946,44210
20,20013,1992-12-31,32566,12116,44682
20,20013,1993-12-31,32856,12282,45138
20,20013,1994-12-31,33133,12392,45525
20,20013,1995-12-31,33404,12505,45909
20,20013,1996-12-31,33686,12599,46285
20,20013,1997-12-31,33991,12662,46653
20,20013,1998-12-31,34082,12805,46887
20,20013,1999-12-31,35015,12604,47619
20,20013,2000-12-31,35520,12648,48168
20,20013,2001-12-31,36199,12583,48782
20,20013,2002-12-31,37030,12407,49437
20,20013,2003-12-31,38010,12096,50106
20,20013,2004-12-31,39070,11724,50794
20,20013,2005-12-31,40078,11351,51429
20,20013,2006-12-31,40965,11041,52006
20,20013,2007-12-31,41731,10848,52579
20,20013,2008-12-31,42376,10778,53154
20,20013,2009-12-31,42899,10786,53685
20,20013,2010-12-31,43408,10856,54264
20,20013,2011-12-31,43877,10965,54842
20,20013,2012-12-31,44311,11118,55429
20,20013,2013-12-31,44733,11285,56018
20,20013,2014-12-31,45136,11475,56611
20,20013,2015-12-31,45597,11676,57273
20,20013,2016-12-31,46183,11903,58086
20,20013,2017-12-31,46926,12208,59134
20,20013,2018-12-31,48157,12611,60768
20,20013,2019-12-31,49479,13385,62864
20,20013,2020-12-31,50642,14034,64676
20,20013,2021-12-31,51642,14377,66019
20,20013,2022-12-31,52337,14642,66979
20,20013,2023-12-31,52992,14887,67879
20,20013,2024-12-31,53616,15118,68734
20,20013,2025-12-31,54206,15353,69559
20,20013,2026-12-31,54781,15581,70362
20,20013,2027-12-31,55343,15807,71150
20,20013,2028-12-31,55908,16029,71937
20,20013,2029-12-31,56443,16254,72697
20,20013,2030-12-31,56981,16466,73447
20,20013,2031-12-31,57514,16672,74186
20,20013,2032-12-31,58006,16896,74902
20,20013,2033-12-31,58471,17104,75575
20,20013,2034-12-31,58941,17308,76249
20,20013,2035-12-31,59386,17517,76903
20,20032,1985-12-31,6876,9617,16493
20,20032,1986-12-31,6899,9736,16635
20,20032,1987-12-31,6957,9856,16813
20,20032,1988-12-31,6992,9996,16988
20,20032,1989-12-31,7056,10124,17180
20,20032,1990-12-31,7138,10245,17383
20,20032,1991-12-31,7188,10332,17520
20,20032,1992-12-31,7255,10430,17685
20,20032,1993-12-31,7315,10506,17821
20,20032,1994-12-31,7349,10571,17920
20,20032,1995-12-31,7395,10615,18010
20,20032,1996-12-31,7458,10641,18099
20,20032,1997-12-31,7518,10652,18170
20,20032,1998-12-31,7531,10716,18247
20,20032,1999-12-31,7735,10502,18237
20,20032,2000-12-31,7830,10494,18324
20,20032,2001-12-31,7973,10409,18382
20,20032,2002-12-31,8154,10207,18361
20,20032,2003-12-31,8351,9908,18259
20,20032,2004-12-31,8588,9538,18126
20,20032,2005-12-31,8804,9181,17985
20,20032,2006-12-31,9011,8904,17915
20,20032,2007-12-31,9180,8717,17897
20,20032,2008-12-31,9297,8621,17918
20,20032,2009-12-31,9445,8590,18035
20,20032,2010-12-31,9521,8610,18131
20,20032,2011-12-31,9583,8667,18250
20,20032,2012-12-31,9676,8746,18422
20,20032,2013-12-31,9757,8838,18595
20,20032,2014-12-31,9838,8938,18776
20,20032,2015-12-31,9929,9054,18983
20,20032,2016-12-31,10039,9193,19232
20,20032,2017-12-31,10204,9376,19580
20,20032,2018-12-31,10468,9652,20120
20,20032,2019-12-31,10896,9721,20617
20,20032,2020-12-31,11243,9819,21062
20,20032,2021-12-31,11442,10057,21499
20,20032,2022-12-31,11570,10242,21812
20,20032,2023-12-31,11691,10414,22105
20,20032,2024-12-31,11818,10582,22400
20,20032,2025-12-31,11917,10737,22654
20,20032,2026-12-31,12032,10897,22929
20,20032,2027-12-31,12141,11068,23209
20,20032,2028-12-31,12256,11217,23473
20,20032,2029-12-31,12371,11377,23748
20,20032,2030-12-31,12479,11511,23990
20,20032,2031-12-31,12585,11681,24266
20,20032,2032-12-31,12707,11839,24546
20,20032,2033-12-31,12788,11985,24773
20,20032,2034-12-31,12884,12129,25013
20,20032,2035-12-31,12986,12273,25259
20,20045,1985-12-31,5927,6054,11981
20,20045,1986-12-31,6195,6114,12309
20,20045,1987-12-31,6471,6174,12645
20,20045,1988-12-31,6710,6219,12929
20,20045,1989-12-31,6971,6283,13254
20,20045,1990-12-31,7222,6333,13555
20,20045,1991-12-31,7472,6369,13841
20,20045,1992-12-31,7722,6414,14136
20,20045,1993-12-31,7968,6446,14414
20,20045,1994-12-31,8201,6462,14663
20,20045,1995-12-31,8439,6472,14911
20,20045,1996-12-31,8669,6472,15141
20,20045,1997-12-31,8917,6457,15374
20,20045,1998-12-31,9086,6467,15553
20,20045,1999-12-31,9489,6329,15818
20,20045,2000-12-31,9787,6308,16095
20,20045,2001-12-31,10111,6228,16339
20,20045,2002-12-31,10502,6098,16600
20,20045,2003-12-31,10912,5898,16810
20,20045,2004-12-31,11375,5698,17073
20,20045,2005-12-31,11805,5456,17261
20,20045,2006-12-31,12232,5277,17509
20,20045,2007-12-31,12611,5147,17758
20,20045,2008-12-31,12958,5058,18016
20,20045,2009-12-31,13277,5026,18303
20,20045,2010-12-31,13555,5027,18582
20,20045,2011-12-31,13811,5035,18846
20,20045,2012-12-31,14086,5072,19158
20,20045,2013-12-31,14359,5102,19461
20,20045,2014-12-31,14614,5147,19761
20,20045,2015-12-31,14895,5195,20090
20,20045,2016-12-31,15212,5261,20473
20,20045,2017-12-31,15592,5333,20925
20,20045,2018-12-31,16123,5488,21611
20,20045,2019-12-31,16816,5726,22542
20,20045,2020-12-31,17382,5926,23308
20,20045,2021-12-31,17724,6069,23793
20,20045,2022-12-31,17957,6181,24138
20,20045,2023-12-31,18177,6285,24462
20,20045,2024-12-31,18392,6383,24775
20,20045,2025-12-31,18606,6490,25096
20,20045,2026-12-31,18810,6588,25398
20,20045,2027-12-31,19013,6690,25703
20,20045,2028-12-31,19222,6795,26017
20,20045,2029-12-31,19409,6905,26314
20,20045,2030-12-31,19619,7003,26622
20,20045,2031-12-31,19803,7097,26900
20,20045,2032-12-31,19992,7206,27198
20,20045,2033-12-31,20161,7304,27465
20,20045,2034-12-31,20334,7418,27752
20,20045,2035-12-31,20511,7516,28027
20,20060,1985-12-31,16229,5585,21814
20,20060,1986-12-31,16755,5579,22334
20,20060,1987-12-31,17276,5538,22814
20,20060,1988-12-31,17811,5456,23267
20,20060,1989-12-31,18328,5483,23811
20,20060,1990-12-31,18769,5442,24211
20,20060,1991-12-31,19300,5384,24684
20,20060,1992-12-31,19799,5346,25145
20,20060,1993-12-31,20280,5289,25569
20,20060,1994-12-31,20754,5182,25936
20,20060,1995-12-31,21219,5118,26337
20,20060,1996-12-31,21692,5010,26702
20,20060,1997-12-31,22176,4901,27077
20,20060,1998-12-31,22513,4813,27326
20,20060,1999-12-31,23399,4595,27994
20,20060,2000-12-31,24018,4506,28524
20,20060,2001-12-31,24736,4365,29101
20,20060,2002-12-31,25571,4143,29714
20,20060,2003-12-31,26505,3941,30446
20,20060,2004-12-31,27515,3725,31240
20,20060,2005-12-31,28486,3483,31969
20,20060,2006-12-31,29388,3263,32651
20,20060,2007-12-31,30198,3122,33320
20,20060,2008-12-31,30929,2981,33910
20,20060,2009-12-31,31573,2885,34458
20,20060,2010-12-31,32184,2814,34998
20,20060,2011-12-31,32780,2740,35520
20,20060,2012-12-31,33312,2684,35996
20,20060,2013-12-31,33879,2621,36500
20,20060,2014-12-31,34437,2550,36987
20,20060,2015-12-31,35008,2493,37501
20,20060,2016-12-31,35675,2446,38121
20,20060,2017-12-31,36486,2369,38855
20,20060,2018-12-31,37676,2346,40022
20,20060,2019-12-31,39262,2563,41825
20,20060,2020-12-31,40562,2764,43326
20,20060,2021-12-31,41404,2831,44235
20,20060,2022-12-31,41994,2884,44878
20,20060,2023-12-31,42549,2932,45481
20,20060,2024-12-31,43069,2970,46039
20,20060,2025-12-31,43548,3018,46566
20,20060,2026-12-31,44013,3062,47075
20,20060,2027-12-31,44469,3107,47576
20,20060,2028-12-31,44911,3152,48063
20,20060,2029-12-31,45363,3195,48558
20,20060,2030-12-31,45788,3235,49023
20,20060,2031-12-31,46211,3285,49496
20,20060,2032-12-31,46599,3324,49923
20,20060,2033-12-31,47002,3378,50380
20,20060,2034-12-31,47379,3407,50786
20,20060,2035-12-31,47711,3455,51166
20,20175,1985-12-31,8009,14553,22562
20,20175,1986-12-31,8131,14941,23072
20,20175,1987-12-31,8251,15393,23644
20,20175,1988-12-31,8317,15728,24045
20,20175,1989-12-31,8418,16065,24483
20,20175,1990-12-31,8551,16427,24978
20,20175,1991-12-31,8644,16785,25429
20,20175,1992-12-31,8744,17109,25853
20,20175,1993-12-31,8865,17424,26289
20,20175,1994-12-31,8958,17737,26695
20,20175,1995-12-31,9067,17999,27066
20,20175,1996-12-31,9174,18237,27411
20,20175,1997-12-31,9283,18437,27720
20,20175,1998-12-31,9313,18754,28067
20,20175,1999-12-31,9600,18564,28164
20,20175,2000-12-31,9759,18753,28512
20,20175,2001-12-31,9972,18758,28730
20,20175,2002-12-31,10257,18599,28856
20,20175,2003-12-31,10533,18256,28789
20,20175,2004-12-31,10850,17743,28593
20,20175,2005-12-31,11159,17255,28414
20,20175,2006-12-31,11443,16889,28332
20,20175,2007-12-31,11683,16686,28369
20,20175,2008-12-31,11891,16642,28533
20,20175,2009-12-31,12085,16747,28832
20,20175,2010-12-31,12245,16948,29193
20,20175,2011-12-31,12346,17225,29571
20,20175,2012-12-31,12497,17535,30032
20,20175,2013-12-31,12617,17891,30508
20,20175,2014-12-31,12797,18273,31070
20,20175,2015-12-31,12918,18681,31599
20,20175,2016-12-31,13123,19157,32280
20,20175,2017-12-31,13341,19684,33025
20,20175,2018-12-31,13721,20448,34169
20,20175,2019-12-31,14154,21115,35269
20,20175,2020-12-31,14530,21699,36229
20,20175,2021-12-31,14758,22224,36982
20,20175,2022-12-31,14885,22634,37519
20,20175,2023-12-31,15010,23013,38023
20,20175,2024-12-31,15134,23367,38501
20,20175,2025-12-31,15269,23725,38994
20,20175,2026-12-31,15398,24076,39474
20,20175,2027-12-31,15536,24421,39957
20,20175,2028-12-31,15660,24759,40419
20,20175,2029-12-31,15788,25091,40879
20,20175,2030-12-31,15938,25433,41371
20,20175,2031-12-31,16053,25767,41820
20,20175,2032-12-31,16186,26091,42277
20,20175,2033-12-31,16309,26398,42707
20,20175,2034-12-31,16433,26735,43168
20,20175,2035-12-31,16544,27049,43593
20,20178,1985-12-31,8996,7455,16451
20,20178,1986-12-31,9152,7692,16844
20,20178,1987-12-31,9309,7891,17200
20,20178,1988-12-31,9477,8131,17608
20,20178,1989-12-31,9596,8317,17913
20,20178,1990-12-31,9747,8512,18259
20,20178,1991-12-31,9896,8720,18616
20,20178,1992-12-31,10064,8912,18976
20,20178,1993-12-31,10220,9097,19317
20,20178,1994-12-31,10384,9266,19650
20,20178,1995-12-31,10524,9432,19956
20,20178,1996-12-31,10658,9582,20240
20,20178,1997-12-31,10812,9703,20515
20,20178,1998-12-31,10902,9883,20785
20,20178,1999-12-31,11247,9809,21056
20,20178,2000-12-31,11472,9914,21386
20,20178,2001-12-31,11741,9946,21687
20,20178,2002-12-31,12060,9889,21949
20,20178,2003-12-31,12446,9679,22125
20,20178,2004-12-31,12844,9452,22296
20,20178,2005-12-31,13210,9208,22418
20,20178,2006-12-31,13576,9029,22605
20,20178,2007-12-31,13872,8915,22787
20,20178,2008-12-31,14169,8932,23101
20,20178,2009-12-31,14416,8992,23408
20,20178,2010-12-31,14603,9116,23719
20,20178,2011-12-31,14818,9279,24097
20,20178,2012-12-31,14974,9464,24438
20,20178,2013-12-31,15180,9664,24844
20,20178,2014-12-31,15353,9889,25242
20,20178,2015-12-31,15561,10123,25684
20,20178,2016-12-31,15804,10386,26190
20,20178,2017-12-31,16106,10681,26787
20,20178,2018-12-31,16576,11118,27694
20,20178,2019-12-31,17145,11598,28743
20,20178,2020-12-31,17628,12004,29632
20,20178,2021-12-31,17953,12295,30248
20,20178,2022-12-31,18166,12521,30687
20,20178,2023-12-31,18369,12731,31100
20,20178,2024-12-31,18579,12932,31511
20,20178,2025-12-31,18754,13133,31887
20,20178,2026-12-31,18954,13320,32274
20,20178,2027-12-31,19138,13518,32656
20,20178,2028-12-31,19328,13703,33031
20,20178,2029-12-31,19507,13887,33394
20,20178,2030-12-31,19693,14086,33779
20,20178,2031-12-31,19867,14272,34139
20,20178,2032-12-31,20038,14460,34498
20,20178,2033-12-31,20205,14643,34848
20,20178,2034-12-31,20369,14816,35185
20,20178,2035-12-31,20521,15002,35523
20,20228,1985-12-31,14479,10754,25233
20,20228,1986-12-31,14721,10906,25627
20,20228,1987-12-31,14969,11122,26091
20,20228,1988-12-31,15224,11255,26479
20,20228,1989-12-31,15451,11362,26813
20,20228,1990-12-31,15648,11480,27128
20,20228,1991-12-31,15898,11595,27493
20,20228,1992-12-31,16154,11700,27854
20,20228,1993-12-31,16405,11810,28215
20,20228,1994-12-31,16627,11888,28515
20,20228,1995-12-31,16849,11953,28802
20,20228,1996-12-31,17085,11984,29069
20,20228,1997-12-31,17326,11993,29319
20,20228,1998-12-31,17454,12080,29534
20,20228,1999-12-31,18017,11843,29860
20,20228,2000-12-31,18358,11857,30215
20,20228,2001-12-31,18785,11725,30510
20,20228,2002-12-31,19282,11530,30812
20,20228,2003-12-31,19890,11190,31080
20,20228,2004-12-31,20510,10769,31279
20,20228,2005-12-31,21109,10387,31496
20,20228,2006-12-31,21658,10079,31737
20,20228,2007-12-31,22151,9864,32015
20,20228,2008-12-31,22592,9749,32341
20,20228,2009-12-31,22963,9715,32678
20,20228,2010-12-31,23245,9746,32991
20,20228,2011-12-31,23572,9811,33383
20,20228,2012-12-31,23904,9905,33809
20,20228,2013-12-31,24193,10019,34212
20,20228,2014-12-31,24499,10144,34643
20,20228,2015-12-31,24813,10273,35086
20,20228,2016-12-31,25192,10462,35654
20,20228,2017-12-31,25668,10649,36317
20,20228,2018-12-31,26422,10977,37399
20,20228,2019-12-31,27258,11359,38617
20,20228,2020-12-31,27954,11713,39667
20,20228,2021-12-31,28494,11997,40491
20,20228,2022-12-31,28862,12218,41080
20,20228,2023-12-31,29210,12422,41632
20,20228,2024-12-31,29581,12613,42194
20,20228,2025-12-31,29893,12790,42683
20,20228,2026-12-31,30226,12984,43210
20,20228,2027-12-31,30535,13151,43686
20,20228,2028-12-31,30843,13347,44190
20,20228,2029-12-31,31153,13532,44685
20,20228,2030-12-31,31448,13712,45160
20,20228,2031-12-31,31730,13914,45644
20,20228,2032-12-31,31996,14089,46085
20,20228,2033-12-31,32265,14272,46537
20,20228,2034-12-31,32518,14437,46955
20,20228,2035-12-31,32766,14623,47389
20,20238,1985-12-31,13233,11184,24417
20,20238,1986-12-31,13403,11221,24624
20,20238,1987-12-31,13580,11255,24835
20,20238,1988-12-31,13770,11337,25107
20,20238,1989-12-31,13929,11349,25278
20,20238,1990-12-31,14076,11355,25431
20,20238,1991-12-31,14255,11339,25594
20,20238,1992-12-31,14429,11338,25767
20,20238,1993-12-31,14611,11316,25927
20,20238,1994-12-31,14762,11258,26020
20,20238,1995-12-31,14944,11200,26144
20,20238,1996-12-31,15110,11105,26215
20,20238,1997-12-31,15261,10994,26255
20,20238,1998-12-31,15344,10940,26284
20,20238,1999-12-31,15797,10593,26390
20,20238,2000-12-31,16063,10490,26553
20,20238,2001-12-31,16407,10285,26692
20,20238,2002-12-31,16839,9967,26806
20,20238,2003-12-31,17297,9556,26853
20,20238,2004-12-31,17814,9114,26928
20,20238,2005-12-31,18299,8675,26974
20,20238,2006-12-31,18758,8303,27061
20,20238,2007-12-31,19134,8026,27160
20,20238,2008-12-31,19494,7836,27330
20,20238,2009-12-31,19784,7716,27500
20,20238,2010-12-31,20021,7640,27661
20,20238,2011-12-31,20260,7597,27857
20,20238,2012-12-31,20474,7556,28030
20,20238,2013-12-31,20723,7540,28263
20,20238,2014-12-31,20920,7525,28445
20,20238,2015-12-31,21181,7525,28706
20,20238,2016-12-31,21486,7540,29026
20,20238,2017-12-31,21857,7572,29429
20,20238,2018-12-31,22469,7690,30159
20,20238,2019-12-31,23164,7793,30957
20,20238,2020-12-31,23767,7883,31650
20,20238,2021-12-31,24233,8074,32307
20,20238,2022-12-31,24554,8223,32777
20,20238,2023-12-31,24857,8360,33217
20,20238,2024-12-31,25151,8512,33663
20,20238,2025-12-31,25431,8656,34087
20,20238,2026-12-31,25700,8770,34470
20,20238,2027-12-31,25979,8907,34886
20,20238,2028-12-31,26234,9036,35270
20,20238,2029-12-31,26488,9141,35629
20,20238,2030-12-31,26727,9279,36006
20,20238,2031-12-31,26981,9378,36359
20,20238,2032-12-31,27224,9505,36729
20,20238,2033-12-31,27438,9609,37047
20,20238,2034-12-31,27661,9732,37393
20,20238,2035-12-31,27864,9845,37709
20,20250,1985-12-31,3390,10803,14193
20,20250,1986-12-31,3441,11520,14961
20,20250,1987-12-31,3521,12325,15846
20,20250,1988-12-31,3598,13094,16692
20,20250,1989-12-31,3695,13853,17548
20,20250,1990-12-31,3812,14623,18435
20,20250,1991-12-31,3871,15398,19269
20,20250,1992-12-31,3941,16175,20116
20,20250,1993-12-31,4027,16944,20971
20,20250,1994-12-31,4088,17679,21767
20,20250,1995-12-31,4150,18415,22565
20,20250,1996-12-31,4238,19108,23346
20,20250,1997-12-31,4324,19775,24099
20,20250,1998-12-31,4359,20558,24917
20,20250,1999-12-31,4507,20804,25311
20,20250,2000-12-31,4617,21440,26057
20,20250,2001-12-31,4746,21878,26624
20,20250,2002-12-31,4875,22106,26981
20,20250,2003-12-31,5051,22088,27139
20,20250,2004-12-31,5216,21870,27086
20,20250,2005-12-31,5388,21641,27029
20,20250,2006-12-31,5560,21511,27071
20,20250,2007-12-31,5691,21605,27296
20,20250,2008-12-31,5804,21899,27703
20,20250,2009-12-31,5920,22360,28280
20,20250,2010-12-31,6034,22949,28983
20,20250,2011-12-31,6140,23642,29782
20,20250,2012-12-31,6214,24405,30619
20,20250,2013-12-31,6290,25220,31510
20,20250,2014-12-31,6379,26072,32451
20,20250,2015-12-31,6486,26983,33469
20,20250,2016-12-31,6576,27994,34570
20,20250,2017-12-31,6702,29129,35831
20,20250,2018-12-31,6922,30609,37531
20,20250,2019-12-31,7200,32165,39365
20,20250,2020-12-31,7422,33436,40858
20,20250,2021-12-31,7463,34252,41715
20,20250,2022-12-31,7438,34884,42322
20,20250,2023-12-31,7422,35468,42890
20,20250,2024-12-31,7465,36041,43506
20,20250,2025-12-31,7540,36595,44135
20,20250,2026-12-31,7601,37136,44737
20,20250,2027-12-31,7680,37678,45358
20,20250,2028-12-31,7760,38212,45972
20,20250,2029-12-31,7837,38749,46586
20,20250,2030-12-31,7908,39285,47193
20,20250,2031-12-31,7983,39819,47802
20,20250,2032-12-31,8049,40340,48389
20,20250,2033-12-31,8121,40870,48991
20,20250,2034-12-31,8184,41366,49550
20,20250,2035-12-31,8252,41866,50118
20,20295,1985-12-31,5837,4298,10135
20,20295,1986-12-31,5927,4398,10325
20,20295,1987-12-31,5974,4468,10442
20,20295,1988-12-31,6036,4515,10551
20,20295,1989-12-31,6102,4614,10716
20,20295,1990-12-31,6205,4679,10884
20,20295,1991-12-31,6267,4763,11030
20,20295,1992-12-31,6341,4828,11169
20,20295,1993-12-31,6418,4901,11319
20,20295,1994-12-31,6494,4945,11439
20,20295,1995-12-31,6559,5025,11584
20,20295,1996-12-31,6629,5075,11704
20,20295,1997-12-31,6711,5098,11809
20,20295,1998-12-31,6738,5159,11897
20,20295,1999-12-31,6942,5073,12015
20,20295,2000-12-31,7058,5106,12164
20,20295,2001-12-31,7202,5069,12271
20,20295,2002-12-31,7375,5002,12377
20,20295,2003-12-31,7592,4896,12488
20,20295,2004-12-31,7832,4759,12591
20,20295,2005-12-31,8049,4600,12649
20,20295,2006-12-31,8220,4481,12701
20,20295,2007-12-31,8418,4414,12832
20,20295,2008-12-31,8553,4375,12928
20,20295,2009-12-31,8722,4378,13100
20,20295,2010-12-31,8776,4410,13186
20,20295,2011-12-31,8883,4483,13366
20,20295,2012-12-31,8948,4496,13444
20,20295,2013-12-31,9067,4604,13671
20,20295,2014-12-31,9167,4672,13839
20,20295,2015-12-31,9246,4748,13994
20,20295,2016-12-31,9381,4859,14240
20,20295,2017-12-31,9548,5008,14556
20,20295,2018-12-31,9828,5145,14973
20,20295,2019-12-31,10129,5329,15458
20,20295,2020-12-31,10389,5475,15864
20,20295,2021-12-31,10586,5608,16194
20,20295,2022-12-31,10718,5711,16429
20,20295,2023-12-31,10843,5807,16650
20,20295,2024-12-31,10967,5901,16868
20,20295,2025-12-31,11070,5987,17057
20,20295,2026-12-31,11188,6071,17259
20,20295,2027-12-31,11303,6167,17470
20,20295,2028-12-31,11400,6243,17643
20,20295,2029-12-31,11510,6322,17832
20,20295,2030-12-31,11619,6411,18030
20,20295,2031-12-31,11732,6489,18221
20,20295,2032-12-31,11824,6583,18407
20,20295,2033-12-31,11931,6661,18592
20,20295,2034-12-31,12016,6741,18757
20,20295,2035-12-31,12106,6820,18926
20,20310,1985-12-31,2954,5641,8595
20,20310,1986-12-31,2894,5671,8565
20,20310,1987-12-31,2813,5641,8454
20,20310,1988-12-31,2723,5603,8326
20,20310,1989-12-31,2679,5576,8255
20,20310,1990-12-31,2627,5571,8198
20,20310,1991-12-31,2591,5550,8141
20,20310,1992-12-31,2491,5520,8011
20,20310,1993-12-31,2421,5484,7905
20,20310,1994-12-31,2377,5405,7782
20,20310,1995-12-31,2320,5350,7670
20,20310,1996-12-31,2245,5261,7506
20,20310,1997-12-31,2162,5185,7347
20,20310,1998-12-31,2112,5124,7236
20,20310,1999-12-31,2107,4938,7045
20,20310,2000-12-31,2071,4826,6897
20,20310,2001-12-31,2030,4708,6738
20,20310,2002-12-31,1992,4505,6497
20,20310,2003-12-31,1984,4333,6317
20,20310,2004-12-31,1969,4109,6078
20,20310,2005-12-31,1972,3872,5844
20,20310,2006-12-31,1923,3673,5596
20,20310,2007-12-31,1872,3498,5370
20,20310,2008-12-31,1824,3375,5199
20,20310,2009-12-31,1785,3323,5108
20,20310,2010-12-31,1752,3245,4997
20,20310,2011-12-31,1710,3190,4900
20,20310,2012-12-31,1662,3162,4824
20,20310,2013-12-31,1635,3107,4742
20,20310,2014-12-31,1584,3039,4623
20,20310,2015-12-31,1533,3028,4561
20,20310,2016-12-31,1497,3002,4499
20,20310,2017-12-31,1464,2957,4421
20,20310,2018-12-31,1414,2965,4379
20,20310,2019-12-31,1391,3078,4469
20,20310,2020-12-31,1388,3180,4568
20,20310,2021-12-31,1406,3257,4663
20,20310,2022-12-31,1414,3317,4731
20,20310,2023-12-31,1421,3373,4794
20,20310,2024-12-31,1426,3419,4845
20,20310,2025-12-31,1445,3464,4909
20,20310,2026-12-31,1456,3523,4979
20,20310,2027-12-31,1473,3564,5037
20,20310,2028-12-31,1486,3620,5106
20,20310,2029-12-31,1503,3670,5173
20,20310,2030-12-31,1516,3709,5225
20,20310,2031-12-31,1528,3758,5286
20,20310,2032-12-31,1544,3798,5342
20,20310,2033-12-31,1555,3831,5386
20,20310,2034-12-31,1572,3894,5466
20,20310,2035-12-31,1575,3937,5512
20,20383,1985-12-31,3238,5954,9192
20,20383,1986-12-31,3285,6218,9503
20,20383,1987-12-31,3330,6434,9764
20,20383,1988-12-31,3366,6651,10017
20,20383,1989-12-31,3459,6894,10353
20,20383,1990-12-31,3549,7149,10698
20,20383,1991-12-31,3584,7386,10970
20,20383,1992-12-31,3650,7630,11280
20,20383,1993-12-31,3726,7849,11575
20,20383,1994-12-31,3754,8071,11825
20,20383,1995-12-31,3803,8255,12058
20,20383,1996-12-31,3874,8448,12322
20,20383,1997-12-31,3922,8628,12550
20,20383,1998-12-31,3955,8865,12820
20,20383,1999-12-31,4084,8848,12932
20,20383,2000-12-31,4183,9011,13194
20,20383,2001-12-31,4268,9105,13373
20,20383,2002-12-31,4381,9093,13474
20,20383,2003-12-31,4520,8982,13502
20,20383,2004-12-31,4668,8801,13469
20,20383,2005-12-31,4800,8623,13423
20,20383,2006-12-31,4958,8509,13467
20,20383,2007-12-31,5057,8481,13538
20,20383,2008-12-31,5151,8514,13665
20,20383,2009-12-31,5240,8624,13864
20,20383,2010-12-31,5333,8783,14116
20,20383,2011-12-31,5418,8980,14398
20,20383,2012-12-31,5490,9206,14696
20,20383,2013-12-31,5527,9437,14964
20,20383,2014-12-31,5613,9695,15308
20,20383,2015-12-31,5626,9978,15604
20,20383,2016-12-31,5736,10274,16010
20,20383,2017-12-31,5858,10651,16509
20,20383,2018-12-31,6034,11116,17150
20,20383,2019-12-31,6292,11566,17858
20,20383,2020-12-31,6502,11946,18448
20,20383,2021-12-31,6596,12235,18831
20,20383,2022-12-31,6644,12461,19105
20,20383,2023-12-31,6692,12670,19362
20,20383,2024-12-31,6757,12871,19628
20,20383,2025-12-31,6829,13068,19897
20,20383,2026-12-31,6904,13260,20164
20,20383,2027-12-31,6972,13451,20423
20,20383,2028-12-31,7047,13626,20673
20,20383,2029-12-31,7119,13815,20934
20,20383,2030-12-31,7179,14016,21195
20,20383,2031-12-31,7238,14201,21439
20,20383,2032-12-31,7306,14380,21686
20,20383,2033-12-31,7377,14575,21952
20,20383,2034-12-31,7424,14740,22164
20,20383,2035-12-31,7487,14911,22398
20,20400,1985-12-31,5036,9906,14942
20,20400,1986-12-31,5928,10058,15986
20,20400,1987-12-31,6811,10244,17055
20,20400,1988-12-31,7715,10445,18160
20,20400,1989-12-31,8569,10627,19196
20,20400,1990-12-31,9406,10743,20149
20,20400,1991-12-31,10266,10891,21157
20,20400,1992-12-31,11072,11034,22106
20,20400,1993-12-31,11880,11144,23024
20,20400,1994-12-31,12685,11241,23926
20,20400,1995-12-31,13451,11331,24782
20,20400,1996-12-31,14238,11413,25651
20,20400,1997-12-31,15015,11465,26480
20,20400,1998-12-31,15677,11589,27266
20,20400,1999-12-31,16731,11407,28138
20,20400,2000-12-31,17605,11442,29047
20,20400,2001-12-31,18544,11376,29920
20,20400,2002-12-31,19573,11211,30784
20,20400,2003-12-31,20690,10927,31617
20,20400,2004-12-31,21872,10542,32414
20,20400,2005-12-31,23022,10193,33215
20,20400,2006-12-31,24132,9920,34052
20,20400,2007-12-31,25187,9731,34918
20,20400,2008-12-31,26181,9667,35848
20,20400,2009-12-31,27090,9666,36756
20,20400,2010-12-31,27946,9716,37662
20,20400,2011-12-31,28799,9814,38613
20,20400,2012-12-31,29645,9947,39592
20,20400,2013-12-31,30459,10082,40541
20,20400,2014-12-31,31287,10234,41521
20,20400,2015-12-31,32119,10415,42534
20,20400,2016-12-31,33053,10608,43661
20,20400,2017-12-31,34109,10852,44961
20,20400,2018-12-31,35513,11209,46722
20,20400,2019-12-31,37573,11479,49052
20,20400,2020-12-31,39219,11727,50946
20,20400,2021-12-31,40004,12011,52015
20,20400,2022-12-31,40539,12232,52771
20,20400,2023-12-31,41043,12437,53480
20,20400,2024-12-31,41557,12632,54189
20,20400,2025-12-31,42023,12834,54857
20,20400,2026-12-31,42475,13020,55495
20,20400,2027-12-31,42918,13210,56128
20,20400,2028-12-31,43352,13397,56749
20,20400,2029-12-31,43777,13584,57361
20,20400,2030-12-31,44204,13751,57955
20,20400,2031-12-31,44610,13935,58545
20,20400,2032-12-31,45005,14132,59137
20,20400,2033-12-31,45378,14311,59689
20,20400,2034-12-31,45732,14476,60208
20,20400,2035-12-31,46087,14650,60737
20,20443,1985-12-31,3814,1163,4977
20,20443,1986-12-31,3922,1211,5133
20,20443,1987-12-31,4024,1214,5238
20,20443,1988-12-31,4138,1240,5378
20,20443,1989-12-31,4247,1277,5524
20,20443,1990-12-31,4390,1307,5697
20,20443,1991-12-31,4465,1359,5824
20,20443,1992-12-31,4586,1349,5935
20,20443,1993-12-31,4676,1377,6053
20,20443,1994-12-31,4776,1447,6223
20,20443,1995-12-31,4856,1455,6311
20,20443,1996-12-31,4953,1464,6417
20,20443,1997-12-31,5056,1481,6537
20,20443,1998-12-31,5114,1497,6611
20,20443,1999-12-31,5315,1480,6795
20,20443,2000-12-31,5447,1489,6936
20,20443,2001-12-31,5597,1528,7125
20,20443,2002-12-31,5794,1490,7284
20,20443,2003-12-31,5981,1473,7454
20,20443,2004-12-31,6219,1462,7681
20,20443,2005-12-31,6439,1405,7844
20,20443,2006-12-31,6624,1396,8020
20,20443,2007-12-31,6812,1334,8146
20,20443,2008-12-31,6962,1333,8295
20,20443,2009-12-31,7097,1362,8459
20,20443,2010-12-31,7237,1374,8611
20,20443,2011-12-31,7341,1413,8754
20,20443,2012-12-31,7444,1439,8883
20,20443,2013-12-31,7563,1472,9035
20,20443,2014-12-31,7690,1490,9180
20,20443,2015-12-31,7800,1517,9317
20,20443,2016-12-31,7967,1539,9506
20,20443,2017-12-31,8117,1599,9716
20,20443,2018-12-31,8389,1658,10047
20,20443,2019-12-31,8723,1756,10479
20,20443,2020-12-31,8991,1844,10835
20,20443,2021-12-31,9171,1889,11060
20,20443,2022-12-31,9297,1924,11221
20,20443,2023-12-31,9416,1956,11372
20,20443,2024-12-31,9528,1978,11506
20,20443,2025-12-31,9635,2013,11648
20,20443,2026-12-31,9739,2041,11780
20,20443,2027-12-31,9847,2065,11912
20,20443,2028-12-31,9944,2103,12047
20,20443,2029-12-31,10046,2128,12174
20,20443,2030-12-31,10127,2169,12296
20,20443,2031-12-31,10217,2188,12405
20,20443,2032-12-31,10310,2212,12522
20,20443,2033-12-31,10399,2237,12636
20,20443,2034-12-31,10482,2274,12756
20,20443,2035-12-31,10559,2289,12848
20,20517,1985-12-31,7681,4906,12587
20,20517,1986-12-31,7791,4965,12756
20,20517,1987-12-31,7929,5020,12949
20,20517,1988-12-31,8045,5045,13090
20,20517,1989-12-31,8142,5131,13273
20,20517,1990-12-31,8271,5173,13444
20,20517,1991-12-31,8399,5207,13606
20,20517,1992-12-31,8520,5248,13768
20,20517,1993-12-31,8631,5286,13917
20,20517,1994-12-31,8755,5307,14062
20,20517,1995-12-31,8874,5318,14192
20,20517,1996-12-31,8965,5339,14304
20,20517,1997-12-31,9107,5331,14438
20,20517,1998-12-31,9190,5361,14551
20,20517,1999-12-31,9489,5254,14743
20,20517,2000-12-31,9669,5243,14912
20,20517,2001-12-31,9878,5190,15068
20,20517,2002-12-31,10147,5063,15210
20,20517,2003-12-31,10444,4938,15382
20,20517,2004-12-31,10774,4790,15564
20,20517,2005-12-31,11105,4574,15679
20,20517,2006-12-31,11392,4417,15809
20,20517,2007-12-31,11677,4338,16015
20,20517,2008-12-31,11881,4284,16165
20,20517,2009-12-31,12067,4260,16327
20,20517,2010-12-31,12277,4283,16560
20,20517,2011-12-31,12373,4286,16659
20,20517,2012-12-31,12574,4313,16887
20,20517,2013-12-31,12682,4355,17037
20,20517,2014-12-31,12852,4411,17263
20,20517,2015-12-31,12998,4441,17439
20,20517,2016-12-31,13210,4519,17729
20,20517,2017-12-31,13449,4601,18050
20,20517,2018-12-31,13838,4728,18566
20,20517,2019-12-31,14324,4859,19183
20,20517,2020-12-31,14734,4971,19705
20,20517,2021-12-31,15023,5091,20114
20,20517,2022-12-31,15222,5185,20407
20,20517,2023-12-31,15409,5272,20681
20,20517,2024-12-31,15589,5356,20945
20,20517,2025-12-31,15756,5430,21186
20,20517,2026-12-31,15907,5506,21413
20,20517,2027-12-31,16077,5599,21676
20,20517,2028-12-31,16244,5679,21923
20,20517,2029-12-31,16388,5751,22139
20,20517,2030-12-31,16543,5835,22378
20,20517,2031-12-31,16700,5909,22609
20,20517,2032-12-31,16838,5975,22813
20,20517,2033-12-31,16979,6051,23030
20,20517,2034-12-31,17118,6127,23245
20,20517,2035-12-31,17249,6212,23461
20,20550,1985-12-31,6227,4273,10500
20,20550,1986-12-31,6434,4413,10847
20,20550,1987-12-31,6623,4515,11138
20,20550,1988-12-31,6826,4615,11441
20,20550,1989-12-31,7007,4740,11747
20,20550,1990-12-31,7212,4852,12064
20,20550,1991-12-31,7397,4971,12368
20,20550,1992-12-31,7594,5080,12674
20,20550,1993-12-31,7779,5186,12965
20,20550,1994-12-31,7951,5286,13237
20,20550,1995-12-31,8134,5376,13510
20,20550,1996-12-31,8306,5465,13771
20,20550,1997-12-31,8468,5539,14007
20,20550,1998-12-31,8598,5615,14213
20,20550,1999-12-31,8947,5592,14539
20,20550,2000-12-31,9168,5659,14827
20,20550,2001-12-31,9446,5686,15132
20,20550,2002-12-31,9753,5660,15413
20,20550,2003-12-31,10141,5529,15670
20,20550,2004-12-31,10518,5399,15917
20,20550,2005-12-31,10895,5263,16158
20,20550,2006-12-31,11237,5149,16386
20,20550,2007-12-31,11553,5102,16655
20,20550,2008-12-31,11830,5074,16904
20,20550,2009-12-31,12077,5119,17196
20,20550,2010-12-31,12304,5186,17490
20,20550,2011-12-31,12521,5282,17803
20,20550,2012-12-31,12712,5373,18085
20,20550,2013-12-31,12919,5512,18431
20,20550,2014-12-31,13141,5609,18750
20,20550,2015-12-31,13341,5745,19086
20,20550,2016-12-31,13613,5923,19536
20,20550,2017-12-31,13920,6087,20007
20,20550,2018-12-31,14363,6320,20683
20,20550,2019-12-31,14959,6605,21564
20,20550,2020-12-31,15450,6841,22291
20,20550,2021-12-31,15745,7009,22754
20,20550,2022-12-31,15946,7139,23085
20,20550,2023-12-31,16137,7258,23395
20,20550,2024-12-31,16330,7382,23712
20,20550,2025-12-31,16525,7477,24002
20,20550,2026-12-31,16692,7611,24303
20,20550,2027-12-31,16855,7705,24560
20,20550,2028-12-31,17033,7804,24837
20,20550,2029-12-31,17196,7914,25110
20,20550,2030-12-31,17350,8035,25385
20,20550,2031-12-31,17514,8136,25650
20,20550,2032-12-31,17656,8234,25890
20,20550,2033-12-31,17805,8341,26146
20,20550,2034-12-31,17943,8450,26393
20,20550,2035-12-31,18073,8544,26617
20,20570,1985-12-31,0,0,0
20,20570,1986-12-31,0,0,0
20,20570,1987-12-31,0,0,0
20,20570,1988-12-31,0,0,0
20,20570,1989-12-31,0,0,0
20,20570,1990-12-31,0,0,0
20,20570,1991-12-31,0,0,0
20,20570,1992-12-31,0,0,0
20,20570,1993-12-31,0,0,0
20,20570,1994-12-31,0,0,0
20,20570,1995-12-31,0,0,0
20,20570,1996-12-31,0,0,0
20,20570,1997-12-31,0,0,0
20,20570,1998-12-31,4069,15431,19500
20,20570,1999-12-31,4315,15383,19698
20,20570,2000-12-31,4499,15613,20112
20,20570,2001-12-31,4720,15725,20445
20,20570,2002-12-31,4943,15663,20606
20,20570,2003-12-31,5219,15438,20657
20,20570,2004-12-31,5488,15082,20570
20,20570,2005-12-31,5767,14737,20504
20,20570,2006-12-31,6010,14485,20495
20,20570,2007-12-31,6258,14390,20648
20,20570,2008-12-31,6467,14418,20885
20,20570,2009-12-31,6675,14577,21252
20,20570,2010-12-31,6876,14817,21693
20,20570,2011-12-31,7058,15114,22172
20,20570,2012-12-31,7221,15460,22681
20,20570,2013-12-31,7417,15835,23252
20,20570,2014-12-31,7601,16236,23837
20,20570,2015-12-31,7783,16666,24449
20,20570,2016-12-31,7995,17146,25141
20,20570,2017-12-31,8236,17704,25940
20,20570,2018-12-31,8556,18451,27007
20,20570,2019-12-31,8999,19299,28298
20,20570,2020-12-31,9414,20023,29437
20,20570,2021-12-31,9542,20512,30054
20,20570,2022-12-31,9601,20890,30491
20,20570,2023-12-31,9661,21240,30901
20,20570,2024-12-31,9771,21586,31357
20,20570,2025-12-31,9882,21928,31810
20,20570,2026-12-31,9988,22250,32238
20,20570,2027-12-31,10097,22567,32664
20,20570,2028-12-31,10190,22906,33096
20,20570,2029-12-31,10282,23226,33508
20,20570,2030-12-31,10386,23523,33909
20,20570,2031-12-31,10485,23862,34347
20,20570,2032-12-31,10583,24169,34752
20,20570,2033-12-31,10663,24494,35157
20,20570,2034-12-31,10756,24789,35545
20,20570,2035-12-31,10828,25098,35926
20,20614,1985-12-31,4269,6817,11086
20,20614,1986-12-31,4351,7012,11363
20,20614,1987-12-31,4388,7152,11540
20,20614,1988-12-31,4459,7321,11780
20,20614,1989-12-31,4543,7470,12013
20,20614,1990-12-31,4660,7610,12270
20,20614,1991-12-31,4714,7743,12457
20,20614,1992-12-31,4779,7875,12654
20,20614,1993-12-31,4861,8024,12885
20,20614,1994-12-31,4921,8132,13053
20,20614,1995-12-31,4996,8232,13228
20,20614,1996-12-31,5045,8330,13375
20,20614,1997-12-31,5123,8400,13523
20,20614,1998-12-31,5176,8530,13706
20,20614,1999-12-31,5337,8420,13757
20,20614,2000-12-31,5450,8489,13939
20,20614,2001-12-31,5574,8478,14052
20,20614,2002-12-31,5734,8392,14126
20,20614,2003-12-31,5896,8195,14091
20,20614,2004-12-31,6092,7997,14089
20,20614,2005-12-31,6264,7760,14024
20,20614,2006-12-31,6462,7578,14040
20,20614,2007-12-31,6605,7499,14104
20,20614,2008-12-31,6714,7419,14133
20,20614,2009-12-31,6825,7458,14283
20,20614,2010-12-31,6939,7542,14481
20,20614,2011-12-31,7062,7656,14718
20,20614,2012-12-31,7130,7775,14905
20,20614,2013-12-31,7193,7919,15112
20,20614,2014-12-31,7287,8070,15357
20,20614,2015-12-31,7391,8242,15633
20,20614,2016-12-31,7490,8434,15924
20,20614,2017-12-31,7625,8678,16303
20,20614,2018-12-31,7859,8978,16837
20,20614,2019-12-31,8111,9235,17346
20,20614,2020-12-31,8322,9471,17793
20,20614,2021-12-31,8463,9700,18163
20,20614,2022-12-31,8548,9879,18427
20,20614,2023-12-31,8629,10045,18674
20,20614,2024-12-31,8714,10218,18932
20,20614,2025-12-31,8801,10370,19171
20,20614,2026-12-31,8887,10525,19412
20,20614,2027-12-31,8978,10672,19650
20,20614,2028-12-31,9058,10814,19872
20,20614,2029-12-31,9146,10976,20122
20,20614,2030-12-31,9228,11112,20340
20,20614,2031-12-31,9312,11265,20577
20,20614,2032-12-31,9394,11419,20813
20,20614,2033-12-31,9472,11549,21021
20,20614,2034-12-31,9531,11707,21238
20,20614,2035-12-31,9603,11823,21426
20,20621,1985-12-31,9045,7996,17041
20,20621,1986-12-31,9301,8135,17436
20,20621,1987-12-31,9519,8225,17744
20,20621,1988-12-31,9785,8340,18125
20,20621,1989-12-31,10013,8436,18449
20,20621,1990-12-31,10249,8543,18792
20,20621,1991-12-31,10492,8625,19117
20,20621,1992-12-31,10739,8708,19447
20,20621,1993-12-31,10976,8776,19752
20,20621,1994-12-31,11198,8828,20026
20,20621,1995-12-31,11432,8877,20309
20,20621,1996-12-31,11658,8905,20563
20,20621,1997-12-31,11886,8915,20801
20,20621,1998-12-31,12034,8966,21000
20,20621,1999-12-31,12500,8784,21284
20,20621,2000-12-31,12800,8788,21588
20,20621,2001-12-31,13149,8714,21863
20,20621,2002-12-31,13574,8555,22129
20,20621,2003-12-31,14052,8296,22348
20,20621,2004-12-31,14553,8013,22566
20,20621,2005-12-31,15041,7733,22774
20,20621,2006-12-31,15504,7478,22982
20,20621,2007-12-31,15907,7318,23225
20,20621,2008-12-31,16301,7244,23545
20,20621,2009-12-31,16629,7215,23844
20,20621,2010-12-31,16895,7238,24133
20,20621,2011-12-31,17179,7284,24463
20,20621,2012-12-31,17441,7353,24794
20,20621,2013-12-31,17735,7436,25171
20,20621,2014-12-31,18005,7521,25526
20,20621,2015-12-31,18281,7623,25904
20,20621,2016-12-31,18619,7745,26364
20,20621,2017-12-31,19016,7901,26917
20,20621,2018-12-31,19622,8137,27759
20,20621,2019-12-31,20345,8413,28758
20,20621,2020-12-31,20900,8703,29603
20,20621,2021-12-31,21304,8914,30218
20,20621,2022-12-31,21579,9078,30657
20,20621,2023-12-31,21839,9230,31069
20,20621,2024-12-31,22087,9374,31461
20,20621,2025-12-31,22332,9523,31855
20,20621,2026-12-31,22583,9667,32250
20,20621,2027-12-31,22804,9802,32606
20,20621,2028-12-31,23033,9936,32969
20,20621,2029-12-31,23256,10067,33323
20,20621,2030-12-31,23466,10221,33687
20,20621,2031-12-31,23691,10339,34030
20,20621,2032-12-31,23895,10463,34358
20,20621,2033-12-31,24099,10612,34711
20,20621,2034-12-31,24292,10729,35021
20,20621,2035-12-31,24461,10870,35331
20,20710,1985-12-31,6839,6590,13429
20,20710,1986-12-31,7224,6645,13869
20,20710,1987-12-31,7571,6693,14264
20,20710,1988-12-31,7967,6736,14703
20,20710,1989-12-31,8299,6776,15075
20,20710,1990-12-31,8654,6820,15474
20,20710,1991-12-31,9026,6847,15873
20,20710,1992-12-31,9389,6865,16254
20,20710,1993-12-31,9734,6876,16610
20,20710,1994-12-31,10056,6872,16928
20,20710,1995-12-31,10392,6860,17252
20,20710,1996-12-31,10729,6847,17576
20,20710,1997-12-31,11046,6819,17865
20,20710,1998-12-31,11312,6805,18117
20,20710,1999-12-31,11843,6649,18492
20,20710,2000-12-31,12250,6617,18867
20,20710,2001-12-31,12698,6496,19194
20,20710,2002-12-31,13218,6345,19563
20,20710,2003-12-31,13787,6133,19920
20,20710,2004-12-31,14387,5840,20227
20,20710,2005-12-31,14940,5634,20574
20,20710,2006-12-31,15555,5395,20950
20,20710,2007-12-31,16028,5251,21279
20,20710,2008-12-31,16538,5161,21699
20,20710,2009-12-31,16972,5105,22077
20,20710,2010-12-31,17309,5096,22405
20,20710,2011-12-31,17715,5086,22801
20,20710,2012-12-31,18105,5096,23201
20,20710,2013-12-31,18453,5116,23569
20,20710,2014-12-31,18816,5135,23951
20,20710,2015-12-31,19197,5168,24365
20,20710,2016-12-31,19653,5210,24863
20,20710,2017-12-31,20128,5282,25410
20,20710,2018-12-31,20857,5390,26247
20,20710,2019-12-31,21890,5559,27449
20,20710,2020-12-31,22725,5728,28453
20,20710,2021-12-31,23183,5867,29050
20,20710,2022-12-31,23497,5975,29472
20,20710,2023-12-31,23793,6075,29868
20,20710,2024-12-31,24082,6165,30247
20,20710,2025-12-31,24345,6253,30598
20,20710,2026-12-31,24611,6357,30968
20,20710,2027-12-31,24863,6449,31312
20,20710,2028-12-31,25120,6540,31660
20,20710,2029-12-31,25368,6630,31998
20,20710,2030-12-31,25609,6702,32311
20,20710,2031-12-31,25834,6800,32634
20,20710,2032-12-31,26053,6891,32944
20,20710,2033-12-31,26277,6977,33254
20,20710,2034-12-31,26496,7065,33561
20,20710,2035-12-31,26692,7156,33848
20,20750,1985-12-31,5532,8354,13886
20,20750,1986-12-31,5633,8485,14118
20,20750,1987-12-31,5738,8587,14325
20,20750,1988-12-31,5844,8710,14554
20,20750,1989-12-31,5940,8813,14753
20,20750,1990-12-31,6067,8911,14978
20,20750,1991-12-31,6167,9005,15172
20,20750,1992-12-31,6266,9080,15346
20,20750,1993-12-31,6358,9167,15525
20,20750,1994-12-31,6468,9226,15694
20,20750,1995-12-31,6567,9268,15835
20,20750,1996-12-31,6665,9300,15965
20,20750,1997-12-31,6771,9311,16082
20,20750,1998-12-31,6828,9365,16193
20,20750,1999-12-31,7059,9179,16238
20,20750,2000-12-31,7199,9180,16379
20,20750,2001-12-31,7370,9107,16477
20,20750,2002-12-31,7594,8931,16525
20,20750,2003-12-31,7826,8669,16495
20,20750,2004-12-31,8096,8368,16464
20,20750,2005-12-31,8324,8075,16399
20,20750,2006-12-31,8548,7822,16370
20,20750,2007-12-31,8789,7648,16437
20,20750,2008-12-31,8931,7575,16506
20,20750,2009-12-31,9102,7539,16641
20,20750,2010-12-31,9250,7567,16817
20,20750,2011-12-31,9352,7617,16969
20,20750,2012-12-31,9464,7685,17149
20,20750,2013-12-31,9602,7774,17376
20,20750,2014-12-31,9724,7880,17604
20,20750,2015-12-31,9850,7962,17812
20,20750,2016-12-31,9998,8081,18079
20,20750,2017-12-31,10240,8249,18489
20,20750,2018-12-31,10517,8505,19022
20,20750,2019-12-31,10873,8945,19818
20,20750,2020-12-31,11166,9304,20470
20,20750,2021-12-31,11364,9531,20895
20,20750,2022-12-31,11492,9707,21199
20,20750,2023-12-31,11614,9870,21484
20,20750,2024-12-31,11748,10018,21766
20,20750,2025-12-31,11860,10183,22043
20,20750,2026-12-31,11986,10318,22304
20,20750,2027-12-31,12110,10473,22583
20,20750,2028-12-31,12222,10621,22843
20,20750,2029-12-31,12334,10767,23101
20,20750,2030-12-31,12463,10904,23367
20,20750,2031-12-31,12566,11051,23617
20,20750,2032-12-31,12687,11199,23886
20,20750,2033-12-31,12784,11348,24132
20,20750,2034-12-31,12878,11478,24356
20,20750,2035-12-31,12978,11612,24590
20,20770,1985-12-31,3597,8405,12002
20,20770,1986-12-31,3887,8642,12529
20,20770,1987-12-31,4175,8865,13040
20,20770,1988-12-31,4480,9121,13601
20,20770,1989-12-31,4777,9340,14117
20,20770,1990-12-31,5103,9558,14661
20,20770,1991-12-31,5371,9764,15135
20,20770,1992-12-31,5647,10006,15653
20,20770,1993-12-31,5922,10203,16125
20,20770,1994-12-31,6186,10374,16560
20,20770,1995-12-31,6453,10524,16977
20,20770,1996-12-31,6711,10720,17431
20,20770,1997-12-31,6981,10855,17836
20,20770,1998-12-31,7197,11048,18245
20,20770,1999-12-31,7582,10962,18544
20,20770,2000-12-31,7898,11077,18975
20,20770,2001-12-31,8234,11120,19354
20,20770,2002-12-31,8610,10990,19600
20,20770,2003-12-31,9038,10781,19819
20,20770,2004-12-31,9498,10536,20034
20,20770,2005-12-31,9916,10254,20170
20,20770,2006-12-31,10317,10042,20359
20,20770,2007-12-31,10728,9934,20662
20,20770,2008-12-31,11054,9929,20983
20,20770,2009-12-31,11385,9997,21382
20,20770,2010-12-31,11716,10133,21849
20,20770,2011-12-31,11970,10292,22262
20,20770,2012-12-31,12279,10516,22795
20,20770,2013-12-31,12564,10715,23279
20,20770,2014-12-31,12836,10962,23798
20,20770,2015-12-31,13147,11208,24355
20,20770,2016-12-31,13469,11496,24965
20,20770,2017-12-31,13851,11836,25687
20,20770,2018-12-31,14370,12304,26674
20,20770,2019-12-31,15125,12698,27823
20,20770,2020-12-31,15730,13039,28769
20,20770,2021-12-31,16012,13355,29367
20,20770,2022-12-31,16193,13601,29794
20,20770,2023-12-31,16365,13829,30194
20,20770,2024-12-31,16555,14055,30610
20,20770,2025-12-31,16740,14278,31018
20,20770,2026-12-31,16919,14490,31409
20,20770,2027-12-31,17096,14698,31794
20,20770,2028-12-31,17270,14894,32164
20,20770,2029-12-31,17438,15103,32541
20,20770,2030-12-31,17607,15303,32910
20,20770,2031-12-31,17774,15519,33293
20,20770,2032-12-31,17921,15726,33647
20,20770,2033-12-31,18075,15907,33982
20,20770,2034-12-31,18216,16111,34327
20,20770,2035-12-31,18349,16292,34641
20,20787,1985-12-31,3422,7184,10606
20,20787,1986-12-31,3473,7374,10847
20,20787,1987-12-31,3500,7533,11033
20,20787,1988-12-31,3554,7709,11263
20,20787,1989-12-31,3629,7838,11467
20,20787,1990-12-31,3716,7988,11704
20,20787,1991-12-31,3763,8126,11889
20,20787,1992-12-31,3814,8259,12073
20,20787,1993-12-31,3857,8383,12240
20,20787,1994-12-31,3912,8500,12412
20,20787,1995-12-31,3956,8605,12561
20,20787,1996-12-31,3990,8696,12686
20,20787,1997-12-31,4031,8789,12820
20,20787,1998-12-31,4074,8904,12978
20,20787,1999-12-31,4183,8794,12977
20,20787,2000-12-31,4287,8854,13141
20,20787,2001-12-31,4394,8852,13246
20,20787,2002-12-31,4501,8736,13237
20,20787,2003-12-31,4651,8534,13185
20,20787,2004-12-31,4743,8301,13044
20,20787,2005-12-31,4920,8056,12976
20,20787,2006-12-31,5043,7863,12906
20,20787,2007-12-31,5147,7732,12879
20,20787,2008-12-31,5246,7720,12966
20,20787,2009-12-31,5333,7731,13064
20,20787,2010-12-31,5409,7814,13223
20,20787,2011-12-31,5498,7915,13413
20,20787,2012-12-31,5542,8051,13593
20,20787,2013-12-31,5560,8177,13737
20,20787,2014-12-31,5645,8363,14008
20,20787,2015-12-31,5723,8508,14231
20,20787,2016-12-31,5803,8710,14513
20,20787,2017-12-31,5915,8936,14851
20,20787,2018-12-31,6072,9267,15339
20,20787,2019-12-31,6321,9469,15790
20,20787,2020-12-31,6524,9665,16189
20,20787,2021-12-31,6626,9899,16525
20,20787,2022-12-31,6685,10081,16766
20,20787,2023-12-31,6741,10250,16991
20,20787,2024-12-31,6805,10410,17215
20,20787,2025-12-31,6862,10558,17420
20,20787,2026-12-31,6922,10724,17646
20,20787,2027-12-31,6985,10876,17861
20,20787,2028-12-31,7048,11035,18083
20,20787,2029-12-31,7121,11181,18302
20,20787,2030-12-31,7185,11342,18527
20,20787,2031-12-31,7244,11479,18723
20,20787,2032-12-31,7308,11615,18923
20,20787,2033-12-31,7371,11757,19128
20,20787,2034-12-31,7424,11911,19335
20,20787,2035-12-31,7482,12063,19545
23,23001,1985-12-31,200176,83646,283822
23,23001,1986-12-31,205317,83591,288908
23,23001,1987-12-31,210750,83477,294227
23,23001,1988-12-31,216637,83286,299923
23,23001,1989-12-31,223094,82980,306074
23,23001,1990-12-31,230096,82524,312620
23,23001,1991-12-31,237767,81968,319735
23,23001,1992-12-31,246008,81297,327305
23,23001,1993-12-31,254657,80510,335167
23,23001,1994-12-31,263512,79775,343287
23,23001,1995-12-31,272343,79089,351432
23,23001,1996-12-31,280844,78500,359344
23,23001,1997-12-31,282532,78901,361433
23,23001,1998-12-31,290044,79602,369646
23,23001,1999-12-31,297041,80454,377495
23,23001,2000-12-31,303655,81410,385065
23,23001,2001-12-31,309812,82447,392259
23,23001,2002-12-31,315723,83569,399292
23,23001,2003-12-31,321332,84723,406055
23,23001,2004-12-31,326801,85950,412751
23,23001,2005-12-31,332052,87167,419219
23,23001,2006-12-31,337299,88435,425734
23,23001,2007-12-31,342459,89727,432186
23,23001,2008-12-31,343497,91492,434989
23,23001,2009-12-31,348194,92607,440801
23,23001,2010-12-31,352818,93701,446519
23,23001,2011-12-31,357345,94813,452158
23,23001,2012-12-31,361713,95858,457571
23,23001,2013-12-31,366030,96916,462946
23,23001,2014-12-31,370256,97915,468171
23,23001,2015-12-31,374477,98936,473413
23,23001,2016-12-31,378800,100006,478806
23,23001,2017-12-31,383246,101154,484400
23,23001,2018-12-31,388499,102436,490935
23,23001,2019-12-31,392262,106596,498858
23,23001,2020-12-31,395184,110150,505334
23,23001,2021-12-31,397922,111636,509558
23,23001,2022-12-31,400073,112921,512994
23,23001,2023-12-31,402069,114148,516217
23,23001,2024-12-31,403460,115348,518808
23,23001,2025-12-31,404682,116542,521224
23,23001,2026-12-31,405922,117705,523627
23,23001,2027-12-31,407288,118879,526167
23,23001,2028-12-31,408731,120030,528761
23,23001,2029-12-31,410311,121176,531487
23,23001,2030-12-31,412038,122319,534357
23,23001,2031-12-31,413757,123453,537210
23,23001,2032-12-31,415326,124557,539883
23,23001,2033-12-31,416718,125666,542384
23,23001,2034-12-31,417996,126740,544736
23,23001,2035-12-31,419097,127805,546902
23,23068,1985-12-31,16726,27750,44476
23,23068,1986-12-31,16990,28871,45861
23,23068,1987-12-31,17292,29945,47237
23,23068,1988-12-31,17631,30962,48593
23,23068,1989-12-31,18006,31898,49904
23,23068,1990-12-31,18436,32772,51208
23,23068,1991-12-31,18910,33551,52461
23,23068,1992-12-31,19424,34264,53688
23,23068,1993-12-31,19982,34872,54854
23,23068,1994-12-31,20553,35479,56032
23,23068,1995-12-31,21113,36068,57181
23,23068,1996-12-31,21654,36672,58326
23,23068,1997-12-31,21660,25558,47218
23,23068,1998-12-31,22124,25178,47302
23,23068,1999-12-31,22557,24836,47393
23,23068,2000-12-31,22955,24514,47469
23,23068,2001-12-31,23304,24242,47546
23,23068,2002-12-31,23647,23995,47642
23,23068,2003-12-31,23978,23716,47694
23,23068,2004-12-31,24296,23465,47761
23,23068,2005-12-31,24584,23225,47809
23,23068,2006-12-31,24880,22989,47869
23,23068,2007-12-31,25152,22730,47882
23,23068,2008-12-31,25140,22597,47737
23,23068,2009-12-31,25426,22292,47718
23,23068,2010-12-31,25664,21978,47642
23,23068,2011-12-31,25914,21656,47570
23,23068,2012-12-31,26140,21334,47474
23,23068,2013-12-31,26385,20990,47375
23,23068,2014-12-31,26628,20657,47285
23,23068,2015-12-31,26843,20322,47165
23,23068,2016-12-31,27078,19967,47045
23,23068,2017-12-31,27387,19649,47036
23,23068,2018-12-31,27626,19342,46968
23,23068,2019-12-31,27709,19348,47057
23,23068,2020-12-31,27729,19518,47247
23,23068,2021-12-31,27856,19777,47633
23,23068,2022-12-31,27949,20005,47954
23,23068,2023-12-31,28033,20222,48255
23,23068,2024-12-31,28090,20452,48542
23,23068,2025-12-31,28151,20662,48813
23,23068,2026-12-31,28243,20880,49123
23,23068,2027-12-31,28325,21076,49401
23,23068,2028-12-31,28423,21280,49703
23,23068,2029-12-31,28527,21475,50002
23,23068,2030-12-31,28647,21692,50339
23,23068,2031-12-31,28770,21877,50647
23,23068,2032-12-31,28879,22081,50960
23,23068,2033-12-31,28964,22269,51233
23,23068,2034-12-31,29058,22472,51530
23,23068,2035-12-31,29133,22661,51794
23,23079,1985-12-31,3882,11892,15774
23,23079,1986-12-31,4003,11835,15838
23,23079,1987-12-31,4113,11780,15893
23,23079,1988-12-31,4231,11705,15936
23,23079,1989-12-31,4372,11635,16007
23,23079,1990-12-31,4501,11530,16031
23,23079,1991-12-31,4658,11417,16075
23,23079,1992-12-31,4833,11278,16111
23,23079,1993-12-31,4997,11152,16149
23,23079,1994-12-31,5185,11015,16200
23,23079,1995-12-31,5359,10893,16252
23,23079,1996-12-31,5529,10784,16313
23,23079,1997-12-31,5571,10793,16364
23,23079,1998-12-31,5724,10859,16583
23,23079,1999-12-31,5879,10948,16827
23,23079,2000-12-31,6005,11053,17058
23,23079,2001-12-31,6138,11161,17299
23,23079,2002-12-31,6261,11275,17536
23,23079,2003-12-31,6379,11394,17773
23,23079,2004-12-31,6494,11556,18050
23,23079,2005-12-31,6588,11687,18275
23,23079,2006-12-31,6703,11837,18540
23,23079,2007-12-31,6808,11944,18752
23,23079,2008-12-31,6836,12177,19013
23,23079,2009-12-31,6927,12278,19205
23,23079,2010-12-31,7024,12407,19431
23,23079,2011-12-31,7119,12519,19638
23,23079,2012-12-31,7200,12647,19847
23,23079,2013-12-31,7291,12738,20029
23,23079,2014-12-31,7359,12868,20227
23,23079,2015-12-31,7475,12947,20422
23,23079,2016-12-31,7559,13058,20617
23,23079,2017-12-31,7646,13211,20857
23,23079,2018-12-31,7755,13323,21078
23,23079,2019-12-31,7830,13444,21274
23,23079,2020-12-31,7888,13563,21451
23,23079,2021-12-31,7883,13743,21626
23,23079,2022-12-31,7870,13902,21772
23,23079,2023-12-31,7857,14052,21909
23,23079,2024-12-31,7870,14205,22075
23,23079,2025-12-31,7877,14355,22232
23,23079,2026-12-31,7899,14501,22400
23,23079,2027-12-31,7930,14649,22579
23,23079,2028-12-31,7956,14789,22745
23,23079,2029-12-31,7988,14921,22909
23,23079,2030-12-31,8022,15068,23090
23,23079,2031-12-31,8054,15208,23262
23,23079,2032-12-31,8087,15343,23430
23,23079,2033-12-31,8111,15479,23590
23,23079,2034-12-31,8131,15608,23739
23,23079,2035-12-31,8159,15730,23889
23,23090,1985-12-31,3534,10436,13970
23,23090,1986-12-31,3500,10383,13883
23,23090,1987-12-31,3503,10330,13833
23,23090,1988-12-31,3501,10270,13771
23,23090,1989-12-31,3521,10177,13698
23,23090,1990-12-31,3543,10095,13638
23,23090,1991-12-31,3579,9986,13565
23,23090,1992-12-31,3611,9864,13475
23,23090,1993-12-31,3659,9746,13405
23,23090,1994-12-31,3722,9626,13348
23,23090,1995-12-31,3756,9513,13269
23,23090,1996-12-31,3813,9390,13203
23,23090,1997-12-31,3751,9420,13171
23,23090,1998-12-31,3787,9477,13264
23,23090,1999-12-31,3803,9535,13338
23,23090,2000-12-31,3832,9620,13452
23,23090,2001-12-31,3864,9711,13575
23,23090,2002-12-31,3876,9821,13697
23,23090,2003-12-31,3884,9939,13823
23,23090,2004-12-31,3883,10047,13930
23,23090,2005-12-31,3861,10167,14028
23,23090,2006-12-31,3897,10281,14178
23,23090,2007-12-31,3891,10407,14298
23,23090,2008-12-31,3829,10594,14423
23,23090,2009-12-31,3840,10655,14495
23,23090,2010-12-31,3851,10777,14628
23,23090,2011-12-31,3840,10865,14705
23,23090,2012-12-31,3818,10938,14756
23,23090,2013-12-31,3829,11050,14879
23,23090,2014-12-31,3812,11114,14926
23,23090,2015-12-31,3790,11184,14974
23,23090,2016-12-31,3790,11281,15071
23,23090,2017-12-31,3825,11400,15225
23,23090,2018-12-31,3840,11513,15353
23,23090,2019-12-31,3884,11501,15385
23,23090,2020-12-31,3919,11518,15437
23,23090,2021-12-31,3892,11671,15563
23,23090,2022-12-31,3862,11806,15668
23,23090,2023-12-31,3832,11934,15766
23,23090,2024-12-31,3831,12085,15916
23,23090,2025-12-31,3832,12218,16050
23,23090,2026-12-31,3843,12326,16169
23,23090,2027-12-31,3851,12459,16310
23,23090,2028-12-31,3868,12588,16456
23,23090,2029-12-31,3878,12699,16577
23,23090,2030-12-31,3893,12808,16701
23,23090,2031-12-31,3906,12929,16835
23,23090,2032-12-31,3924,13054,16978
23,23090,2033-12-31,3929,13162,17091
23,23090,2034-12-31,3945,13280,17225
23,23090,2035-12-31,3964,13402,17366
23,23162,1985-12-31,32976,35224,68200
23,23162,1986-12-31,33660,35325,68985
23,23162,1987-12-31,34400,35400,69800
23,23162,1988-12-31,35214,35417,70631
23,23162,1989-12-31,36125,35403,71528
23,23162,1990-12-31,37120,35313,72433
23,23162,1991-12-31,38224,35186,73410
23,23162,1992-12-31,39406,34997,74403
23,23162,1993-12-31,40679,34749,75428
23,23162,1994-12-31,41968,34511,76479
23,23162,1995-12-31,43238,34320,77558
23,23162,1996-12-31,44467,34143,78610
23,23162,1997-12-31,44618,34398,79016
23,23162,1998-12-31,45689,34790,80479
23,23162,1999-12-31,46679,35246,81925
23,23162,2000-12-31,47616,35757,83373
23,23162,2001-12-31,48480,36287,84767
23,23162,2002-12-31,49296,36868,86164
23,23162,2003-12-31,50084,37463,87547
23,23162,2004-12-31,50834,38085,88919
23,23162,2005-12-31,51558,38694,90252
23,23162,2006-12-31,52284,39338,91622
23,23162,2007-12-31,52989,39991,92980
23,23162,2008-12-31,53064,40865,93929
23,23162,2009-12-31,53705,41440,95145
23,23162,2010-12-31,54340,42009,96349
23,23162,2011-12-31,54961,42588,97549
23,23162,2012-12-31,55556,43141,98697
23,23162,2013-12-31,56138,43683,99821
23,23162,2014-12-31,56718,44236,100954
23,23162,2015-12-31,57303,44802,102105
23,23162,2016-12-31,57897,45344,103241
23,23162,2017-12-31,58519,45871,104390
23,23162,2018-12-31,59224,46591,105815
23,23162,2019-12-31,59783,47451,107234
23,23162,2020-12-31,60220,48189,108409
23,23162,2021-12-31,60468,48831,109299
23,23162,2022-12-31,60639,49393,110032
23,23162,2023-12-31,60795,49928,110723
23,23162,2024-12-31,60958,50402,111360
23,23162,2025-12-31,61135,50915,112050
23,23162,2026-12-31,61325,51428,112753
23,23162,2027-12-31,61539,51944,113483
23,23162,2028-12-31,61778,52440,114218
23,23162,2029-12-31,62011,52949,114960
23,23162,2030-12-31,62311,53444,115755
23,23162,2031-12-31,62570,53947,116517
23,23162,2032-12-31,62834,54430,117264
23,23162,2033-12-31,63053,54903,117956
23,23162,2034-12-31,63250,55384,118634
23,23162,2035-12-31,63407,55843,119250
23,23168,1985-12-31,2457,9830,12287
23,23168,1986-12-31,2467,9877,12344
23,23168,1987-12-31,2528,9917,12445
23,23168,1988-12-31,2561,9962,12523
23,23168,1989-12-31,2609,9967,12576
23,23168,1990-12-31,2668,9974,12642
23,23168,1991-12-31,2731,9950,12681
23,23168,1992-12-31,2806,9909,12715
23,23168,1993-12-31,2853,9863,12716
23,23168,1994-12-31,2941,9819,12760
23,23168,1995-12-31,3021,9779,12800
23,23168,1996-12-31,3094,9734,12828
23,23168,1997-12-31,3070,9845,12915
23,23168,1998-12-31,3094,9967,13061
23,23168,1999-12-31,3156,10112,13268
23,23168,2000-12-31,3191,10273,13464
23,23168,2001-12-31,3287,10441,13728
23,23168,2002-12-31,3320,10649,13969
23,23168,2003-12-31,3343,10814,14157
23,23168,2004-12-31,3396,11016,14412
23,23168,2005-12-31,3437,11213,14650
23,23168,2006-12-31,3482,11405,14887
23,23168,2007-12-31,3484,11607,15091
23,23168,2008-12-31,3500,11864,15364
23,23168,2009-12-31,3550,12077,15627
23,23168,2010-12-31,3591,12247,15838
23,23168,2011-12-31,3636,12392,16028
23,23168,2012-12-31,3688,12606,16294
23,23168,2013-12-31,3698,12791,16489
23,23168,2014-12-31,3738,12920,16658
23,23168,2015-12-31,3716,13090,16806
23,23168,2016-12-31,3772,13269,17041
23,23168,2017-12-31,3813,13540,17353
23,23168,2018-12-31,3817,13712,17529
23,23168,2019-12-31,3798,13940,17738
23,23168,2020-12-31,3776,14129,17905
23,23168,2021-12-31,3734,14317,18051
23,23168,2022-12-31,3691,14482,18173
23,23168,2023-12-31,3648,14639,18287
23,23168,2024-12-31,3615,14788,18403
23,23168,2025-12-31,3577,14924,18501
23,23168,2026-12-31,3549,15081,18630
23,23168,2027-12-31,3523,15223,18746
23,23168,2028-12-31,3510,15377,18887
23,23168,2029-12-31,3489,15534,19023
23,23168,2030-12-31,3481,15677,19158
23,23168,2031-12-31,3482,15813,19295
23,23168,2032-12-31,3480,15981,19461
23,23168,2033-12-31,3479,16123,19602
23,23168,2034-12-31,3469,16243,19712
23,23168,2035-12-31,3473,16374,19847
23,23182,1985-12-31,16943,20003,36946
23,23182,1986-12-31,16945,20100,37045
23,23182,1987-12-31,16993,20194,37187
23,23182,1988-12-31,17062,20262,37324
23,23182,1989-12-31,17197,20284,37481
23,23182,1990-12-31,17358,20279,37637
23,23182,1991-12-31,17565,20239,37804
23,23182,1992-12-31,17823,20168,37991
23,23182,1993-12-31,18112,20053,38165
23,23182,1994-12-31,18409,19956,38365
23,23182,1995-12-31,18703,19870,38573
23,23182,1996-12-31,18954,19807,38761
23,23182,1997-12-31,18762,19995,38757
23,23182,1998-12-31,18965,20258,39223
23,23182,1999-12-31,19119,20562,39681
23,23182,2000-12-31,19250,20879,40129
23,23182,2001-12-31,19365,21236,40601
23,23182,2002-12-31,19453,21596,41049
23,23182,2003-12-31,19543,21969,41512
23,23182,2004-12-31,19619,22378,41997
23,23182,2005-12-31,19670,22768,42438
23,23182,2006-12-31,19748,23180,42928
23,23182,2007-12-31,19812,23590,43402
23,23182,2008-12-31,19639,24125,43764
23,23182,2009-12-31,19683,24487,44170
23,23182,2010-12-31,19725,24874,44599
23,23182,2011-12-31,19768,25232,45000
23,23182,2012-12-31,19812,25619,45431
23,23182,2013-12-31,19845,25937,45782
23,23182,2014-12-31,19865,26293,46158
23,23182,2015-12-31,19897,26617,46514
23,23182,2016-12-31,19911,27037,46948
23,23182,2017-12-31,20046,27408,47454
23,23182,2018-12-31,20083,27834,47917
23,23182,2019-12-31,20022,28301,48323
23,23182,2020-12-31,20010,28684,48694
23,23182,2021-12-31,20027,29065,49092
23,23182,2022-12-31,20022,29400,49422
23,23182,2023-12-31,20014,29719,49733
23,23182,2024-12-31,20027,30038,50065
23,23182,2025-12-31,20065,30346,50411
23,23182,2026-12-31,20106,30648,50754
23,23182,2027-12-31,20162,30953,51115
23,23182,2028-12-31,20220,31251,51471
23,23182,2029-12-31,20295,31544,51839
23,23182,2030-12-31,20380,31831,52211
23,23182,2031-12-31,20468,32123,52591
23,23182,2032-12-31,20543,32405,52948
23,23182,2033-12-31,20614,32685,53299
23,23182,2034-12-31,20669,32985,53654
23,23182,2035-12-31,20724,33257,53981
23,23189,1985-12-31,18307,30030,48337
23,23189,1986-12-31,18362,29998,48360
23,23189,1987-12-31,18402,29950,48352
23,23189,1988-12-31,18516,29877,48393
23,23189,1989-12-31,18686,29757,48443
23,23189,1990-12-31,18883,29602,48485
23,23189,1991-12-31,19145,29393,48538
23,23189,1992-12-31,19449,29153,48602
23,23189,1993-12-31,19787,28870,48657
23,23189,1994-12-31,20124,28597,48721
23,23189,1995-12-31,20470,28347,48817
23,23189,1996-12-31,20780,28144,48924
23,23189,1997-12-31,20577,28272,48849
23,23189,1998-12-31,20825,28526,49351
23,23189,1999-12-31,21016,28820,49836
23,23189,2000-12-31,21189,29138,50327
23,23189,2001-12-31,21344,29522,50866
23,23189,2002-12-31,21458,29918,51376
23,23189,2003-12-31,21583,30336,51919
23,23189,2004-12-31,21673,30765,52438
23,23189,2005-12-31,21775,31201,52976
23,23189,2006-12-31,21872,31657,53529
23,23189,2007-12-31,21955,32070,54025
23,23189,2008-12-31,21794,32746,54540
23,23189,2009-12-31,21871,33126,54997
23,23189,2010-12-31,21928,33534,55462
23,23189,2011-12-31,21996,33862,55858
23,23189,2012-12-31,22050,34276,56326
23,23189,2013-12-31,22111,34665,56776
23,23189,2014-12-31,22173,35025,57198
23,23189,2015-12-31,22250,35377,57627
23,23189,2016-12-31,22278,35769,58047
23,23189,2017-12-31,22362,36128,58490
23,23189,2018-12-31,22469,36617,59086
23,23189,2019-12-31,22391,37480,59871
23,23189,2020-12-31,22365,38156,60521
23,23189,2021-12-31,22346,38670,61016
23,23189,2022-12-31,22310,39116,61426
23,23189,2023-12-31,22271,39541,61812
23,23189,2024-12-31,22256,39917,62173
23,23189,2025-12-31,22276,40328,62604
23,23189,2026-12-31,22309,40731,63040
23,23189,2027-12-31,22349,41142,63491
23,23189,2028-12-31,22417,41539,63956
23,23189,2029-12-31,22495,41915,64410
23,23189,2030-12-31,22571,42324,64895
23,23189,2031-12-31,22647,42706,65353
23,23189,2032-12-31,22739,43104,65843
23,23189,2033-12-31,22806,43474,66280
23,23189,2034-12-31,22878,43850,66728
23,23189,2035-12-31,22928,44215,67143
23,23300,1985-12-31,0,0,0
23,23300,1986-12-31,0,0,0
23,23300,1987-12-31,0,0,0
23,23300,1988-12-31,0,0,0
23,23300,1989-12-31,0,0,0
23,23300,1990-12-31,0,0,0
23,23300,1991-12-31,0,0,0
23,23300,1992-12-31,0,0,0
23,23300,1993-12-31,0,0,0
23,23300,1994-12-31,0,0,0
23,23300,1995-12-31,0,0,0
23,23300,1996-12-31,0,0,0
23,23300,1997-12-31,4138,15215,19353
23,23300,1998-12-31,4255,15053,19308
23,23300,1999-12-31,4401,14925,19326
23,23300,2000-12-31,4489,14815,19304
23,23300,2001-12-31,4589,14719,19308
23,23300,2002-12-31,4684,14627,19311
23,23300,2003-12-31,4773,14547,19320
23,23300,2004-12-31,4879,14485,19364
23,23300,2005-12-31,4962,14401,19363
23,23300,2006-12-31,5045,14313,19358
23,23300,2007-12-31,5142,14250,19392
23,23300,2008-12-31,5165,14248,19413
23,23300,2009-12-31,5228,14129,19357
23,23300,2010-12-31,5323,14044,19367
23,23300,2011-12-31,5374,13924,19298
23,23300,2012-12-31,5445,13787,19232
23,23300,2013-12-31,5549,13698,19247
23,23300,2014-12-31,5654,13587,19241
23,23300,2015-12-31,5749,13433,19182
23,23300,2016-12-31,5762,13308,19070
23,23300,2017-12-31,5856,13236,19092
23,23300,2018-12-31,5939,13102,19041
23,23300,2019-12-31,6043,13272,19315
23,23300,2020-12-31,6154,13395,19549
23,23300,2021-12-31,6139,13573,19712
23,23300,2022-12-31,6116,13729,19845
23,23300,2023-12-31,6092,13878,19970
23,23300,2024-12-31,6104,14022,20126
23,23300,2025-12-31,6119,14170,20289
23,23300,2026-12-31,6138,14305,20443
23,23300,2027-12-31,6156,14446,20602
23,23300,2028-12-31,6175,14580,20755
23,23300,2029-12-31,6196,14723,20919
23,23300,2030-12-31,6222,14866,21088
23,23300,2031-12-31,6253,15017,21270
23,23300,2032-12-31,6273,15143,21416
23,23300,2033-12-31,6299,15271,21570
23,23300,2034-12-31,6320,15399,21719
23,23300,2035-12-31,6326,15541,21867
23,23350,1985-12-31,0,0,0
23,23350,1986-12-31,0,0,0
23,23350,1987-12-31,0,0,0
23,23350,1988-12-31,0,0,0
23,23350,1989-12-31,0,0,0
23,23350,1990-12-31,0,0,0
23,23350,1991-12-31,0,0,0
23,23350,1992-12-31,0,0,0
23,23350,1993-12-31,0,0,0
23,23350,1994-12-31,0,0,0
23,23350,1995-12-31,0,0,0
23,23350,1996-12-31,0,0,0
23,23350,1997-12-31,11463,5274,16737
23,23350,1998-12-31,11537,5182,16719
23,23350,1999-12-31,11597,5077,16674
23,23350,2000-12-31,11638,4994,16632
23,23350,2001-12-31,11658,4899,16557
23,23350,2002-12-31,11675,4840,16515
23,23350,2003-12-31,11690,4752,16442
23,23350,2004-12-31,11664,4679,16343
23,23350,2005-12-31,11673,4603,16276
23,23350,2006-12-31,11656,4531,16187
23,23350,2007-12-31,11654,4474,16128
23,23350,2008-12-31,11466,4417,15883
23,23350,2009-12-31,11488,4309,15797
23,23350,2010-12-31,11464,4218,15682
23,23350,2011-12-31,11475,4132,15607
23,23350,2012-12-31,11454,4051,15505
23,23350,2013-12-31,11428,3982,15410
23,23350,2014-12-31,11381,3891,15272
23,23350,2015-12-31,11375,3792,15167
23,23350,2016-12-31,11395,3698,15093
23,23350,2017-12-31,11325,3596,14921
23,23350,2018-12-31,11380,3486,14866
23,23350,2019-12-31,11481,3577,15058
23,23350,2020-12-31,11560,3658,15218
23,23350,2021-12-31,11635,3707,15342
23,23350,2022-12-31,11696,3750,15446
23,23350,2023-12-31,11752,3791,15543
23,23350,2024-12-31,11781,3827,15608
23,23350,2025-12-31,11826,3868,15694
23,23350,2026-12-31,11857,3908,15765
23,23350,2027-12-31,11886,3952,15838
23,23350,2028-12-31,11930,3992,15922
23,23350,2029-12-31,11986,4025,16011
23,23350,2030-12-31,12025,4063,16088
23,23350,2031-12-31,12085,4097,16182
23,23350,2032-12-31,12112,4130,16242
23,23350,2033-12-31,12163,4178,16341
23,23350,2034-12-31,12192,4210,16402
23,23350,2035-12-31,12232,4243,16475
23,23417,1985-12-31,30938,64529,95467
23,23417,1986-12-31,31522,67766,99288
23,23417,1987-12-31,32124,70869,102993
23,23417,1988-12-31,32818,73817,106635
23,23417,1989-12-31,33609,76585,110194
23,23417,1990-12-31,34471,79158,113629
23,23417,1991-12-31,35430,81502,116932
23,23417,1992-12-31,36462,83602,120064
23,23417,1993-12-31,37577,85502,123079
23,23417,1994-12-31,38716,87378,126094
23,23417,1995-12-31,39835,89199,129034
23,23417,1996-12-31,40916,91049,131965
23,23417,1997-12-31,40989,81022,122011
23,23417,1998-12-31,41931,79766,121697
23,23417,1999-12-31,42784,78653,121437
23,23417,2000-12-31,43590,77644,121234
23,23417,2001-12-31,44339,76723,121062
23,23417,2002-12-31,45046,75843,120889
23,23417,2003-12-31,45704,74997,120701
23,23417,2004-12-31,46345,74186,120531
23,23417,2005-12-31,46972,73285,120257
23,23417,2006-12-31,47580,72480,120060
23,23417,2007-12-31,48182,71640,119822
23,23417,2008-12-31,48217,71172,119389
23,23417,2009-12-31,48754,70167,118921
23,23417,2010-12-31,49296,69134,118430
23,23417,2011-12-31,49815,68107,117922
23,23417,2012-12-31,50307,67019,117326
23,23417,2013-12-31,50808,65922,116730
23,23417,2014-12-31,51289,64812,116101
23,23417,2015-12-31,51788,63673,115461
23,23417,2016-12-31,52301,62566,114867
23,23417,2017-12-31,52814,61478,114292
23,23417,2018-12-31,53420,60489,113909
23,23417,2019-12-31,53983,60683,114666
23,23417,2020-12-31,54430,61031,115461
23,23417,2021-12-31,54563,61841,116404
23,23417,2022-12-31,54633,62555,117188
23,23417,2023-12-31,54691,63233,117924
23,23417,2024-12-31,54786,63931,118717
23,23417,2025-12-31,54920,64589,119509
23,23417,2026-12-31,55057,65247,120304
23,23417,2027-12-31,55258,65877,121135
23,23417,2028-12-31,55440,66527,121967
23,23417,2029-12-31,55645,67163,122808
23,23417,2030-12-31,55885,67787,123672
23,23417,2031-12-31,56115,68416,124531
23,23417,2032-12-31,56321,69026,125347
23,23417,2033-12-31,56508,69637,126145
23,23417,2034-12-31,56683,70232,126915
23,23417,2035-12-31,56847,70810,127657
23,23419,1985-12-31,1532,10145,11677
23,23419,1986-12-31,1600,10223,11823
23,23419,1987-12-31,1673,10282,11955
23,23419,1988-12-31,1731,10309,12040
23,23419,1989-12-31,1798,10368,12166
23,23419,1990-12-31,1888,10396,12284
23,23419,1991-12-31,1978,10398,12376
23,23419,1992-12-31,2091,10377,12468
23,23419,1993-12-31,2166,10351,12517
23,23419,1994-12-31,2254,10351,12605
23,23419,1995-12-31,2358,10310,12668
23,23419,1996-12-31,2448,10304,12752
23,23419,1997-12-31,2476,10421,12897
23,23419,1998-12-31,2570,10573,13143
23,23419,1999-12-31,2646,10753,13399
23,23419,2000-12-31,2730,10930,13660
23,23419,2001-12-31,2803,11134,13937
23,23419,2002-12-31,2870,11337,14207
23,23419,2003-12-31,2948,11595,14543
23,23419,2004-12-31,3011,11811,14822
23,23419,2005-12-31,3061,12032,15093
23,23419,2006-12-31,3113,12273,15386
23,23419,2007-12-31,3177,12517,15694
23,23419,2008-12-31,3197,12829,16026
23,23419,2009-12-31,3258,13037,16295
23,23419,2010-12-31,3318,13240,16558
23,23419,2011-12-31,3382,13442,16824
23,23419,2012-12-31,3429,13664,17093
23,23419,2013-12-31,3474,13873,17347
23,23419,2014-12-31,3544,14090,17634
23,23419,2015-12-31,3576,14312,17888
23,23419,2016-12-31,3614,14471,18085
23,23419,2017-12-31,3720,14774,18494
23,23419,2018-12-31,3768,14949,18717
23,23419,2019-12-31,3823,15215,19038
23,23419,2020-12-31,3869,15445,19314
23,23419,2021-12-31,3826,15650,19476
23,23419,2022-12-31,3776,15831,19607
23,23419,2023-12-31,3728,16002,19730
23,23419,2024-12-31,3720,16173,19893
23,23419,2025-12-31,3731,16339,20070
23,23419,2026-12-31,3742,16510,20252
23,23419,2027-12-31,3754,16669,20423
23,23419,2028-12-31,3765,16827,20592
23,23419,2029-12-31,3780,16987,20767
23,23419,2030-12-31,3785,17148,20933
23,23419,2031-12-31,3807,17311,21118
23,23419,2032-12-31,3818,17464,21282
23,23419,2033-12-31,3836,17612,21448
23,23419,2034-12-31,3852,17745,21597
23,23419,2035-12-31,3856,17904,21760
23,23464,1985-12-31,7734,4932,12666
23,23464,1986-12-31,7822,4994,12816
23,23464,1987-12-31,7928,5060,12988
23,23464,1988-12-31,8062,5084,13146
23,23464,1989-12-31,8148,5117,13265
23,23464,1990-12-31,8330,5136,13466
23,23464,1991-12-31,8527,5122,13649
23,23464,1992-12-31,8742,5167,13909
23,23464,1993-12-31,8970,5218,14188
23,23464,1994-12-31,9174,5166,14340
23,23464,1995-12-31,9423,5165,14588
23,23464,1996-12-31,9669,5177,14846
23,23464,1997-12-31,9618,5245,14863
23,23464,1998-12-31,9821,5339,15160
23,23464,1999-12-31,9980,5423,15403
23,23464,2000-12-31,10116,5535,15651
23,23464,2001-12-31,10262,5639,15901
23,23464,2002-12-31,10389,5771,16160
23,23464,2003-12-31,10503,5902,16405
23,23464,2004-12-31,10597,6012,16609
23,23464,2005-12-31,10719,6143,16862
23,23464,2006-12-31,10820,6253,17073
23,23464,2007-12-31,10909,6388,17297
23,23464,2008-12-31,10910,6568,17478
23,23464,2009-12-31,10986,6681,17667
23,23464,2010-12-31,11090,6847,17937
23,23464,2011-12-31,11202,6930,18132
23,23464,2012-12-31,11301,7029,18330
23,23464,2013-12-31,11397,7156,18553
23,23464,2014-12-31,11455,7248,18703
23,23464,2015-12-31,11552,7352,18904
23,23464,2016-12-31,11646,7534,19180
23,23464,2017-12-31,11660,7658,19318
23,23464,2018-12-31,11825,7765,19590
23,23464,2019-12-31,11849,8027,19876
23,23464,2020-12-31,11840,8277,20117
23,23464,2021-12-31,11896,8389,20285
23,23464,2022-12-31,11937,8485,20422
23,23464,2023-12-31,11973,8577,20550
23,23464,2024-12-31,12002,8670,20672
23,23464,2025-12-31,12021,8751,20772
23,23464,2026-12-31,12056,8837,20893
23,23464,2027-12-31,12093,8930,21023
23,23464,2028-12-31,12142,9009,21151
23,23464,2029-12-31,12181,9110,21291
23,23464,2030-12-31,12231,9190,21421
23,23464,2031-12-31,12291,9277,21568
23,23464,2032-12-31,12331,9353,21684
23,23464,2033-12-31,12379,9435,21814
23,23464,2034-12-31,12412,9522,21934
23,23464,2035-12-31,12450,9591,22041
23,23466,1985-12-31,25014,17936,42950
23,23466,1986-12-31,26095,18756,44851
23,23466,1987-12-31,27217,19544,46761
23,23466,1988-12-31,28383,20308,48691
23,23466,1989-12-31,29604,21012,50616
23,23466,1990-12-31,30899,21677,52576
23,23466,1991-12-31,32304,22255,54559
23,23466,1992-12-31,33783,22798,56581
23,23466,1993-12-31,35325,23277,58602
23,23466,1994-12-31,36900,23753,60653
23,23466,1995-12-31,38485,24203,62688
23,23466,1996-12-31,40010,24682,64692
23,23466,1997-12-31,40575,23971,64546
23,23466,1998-12-31,41954,23704,65658
23,23466,1999-12-31,43276,23465,66741
23,23466,2000-12-31,44545,23267,67812
23,23466,2001-12-31,45721,23081,68802
23,23466,2002-12-31,46874,22931,69805
23,23466,2003-12-31,47980,22767,70747
23,23466,2004-12-31,49065,22623,71688
23,23466,2005-12-31,50097,22490,72587
23,23466,2006-12-31,51145,22356,73501
23,23466,2007-12-31,52167,22220,74387
23,23466,2008-12-31,52562,14907,67469
23,23466,2009-12-31,53499,15428,68927
23,23466,2010-12-31,54431,15934,70365
23,23466,2011-12-31,55343,16460,71803
23,23466,2012-12-31,56225,16950,73175
23,23466,2013-12-31,57097,17456,74553
23,23466,2014-12-31,57962,17971,75933
23,23466,2015-12-31,58823,18473,77296
23,23466,2016-12-31,59702,18980,78682
23,23466,2017-12-31,60601,19512,80113
23,23466,2018-12-31,61589,20052,81641
23,23466,2019-12-31,62792,21116,83908
23,23466,2020-12-31,63689,22196,85885
23,23466,2021-12-31,64108,22495,86603
23,23466,2022-12-31,64432,22755,87187
23,23466,2023-12-31,64733,23002,87735
23,23466,2024-12-31,64969,23238,88207
23,23466,2025-12-31,65201,23463,88664
23,23466,2026-12-31,65443,23708,89151
23,23466,2027-12-31,65688,23947,89635
23,23466,2028-12-31,65935,24164,90099
23,23466,2029-12-31,66217,24396,90613
23,23466,2030-12-31,66500,24627,91127
23,23466,2031-12-31,66786,24866,91652
23,23466,2032-12-31,67058,25088,92146
23,23466,2033-12-31,67286,25324,92610
23,23466,2034-12-31,67487,25527,93014
23,23466,2035-12-31,67660,25761,93421
23,23500,1985-12-31,3087,14634,17721
23,23500,1986-12-31,3189,14790,17979
23,23500,1987-12-31,3277,14956,18233
23,23500,1988-12-31,3394,15106,18500
23,23500,1989-12-31,3490,15221,18711
23,23500,1990-12-31,3614,15315,18929
23,23500,1991-12-31,3729,15369,19098
23,23500,1992-12-31,3876,15397,19273
23,23500,1993-12-31,4020,15420,19440
23,23500,1994-12-31,4163,15421,19584
23,23500,1995-12-31,4302,15420,19722
23,23500,1996-12-31,4455,15463,19918
23,23500,1997-12-31,4499,15687,20186
23,23500,1998-12-31,4616,15969,20585
23,23500,1999-12-31,4750,16260,21010
23,23500,2000-12-31,4852,16596,21448
23,23500,2001-12-31,4958,16951,21909
23,23500,2002-12-31,5060,17313,22373
23,23500,2003-12-31,5146,17676,22822
23,23500,2004-12-31,5251,18069,23320
23,23500,2005-12-31,5342,18471,23813
23,23500,2006-12-31,5434,18863,24297
23,23500,2007-12-31,5520,19291,24811
23,23500,2008-12-31,5539,19781,25320
23,23500,2009-12-31,5617,20176,25793
23,23500,2010-12-31,5716,20509,26225
23,23500,2011-12-31,5776,20917,26693
23,23500,2012-12-31,5858,21301,27159
23,23500,2013-12-31,5932,21642,27574
23,23500,2014-12-31,6023,22011,28034
23,23500,2015-12-31,6087,22390,28477
23,23500,2016-12-31,6131,22706,28837
23,23500,2017-12-31,6225,23033,29258
23,23500,2018-12-31,6325,23508,29833
23,23500,2019-12-31,6396,23846,30242
23,23500,2020-12-31,6454,24126,30580
23,23500,2021-12-31,6391,24446,30837
23,23500,2022-12-31,6319,24728,31047
23,23500,2023-12-31,6246,24997,31243
23,23500,2024-12-31,6240,25286,31526
23,23500,2025-12-31,6238,25544,31782
23,23500,2026-12-31,6266,25813,32079
23,23500,2027-12-31,6268,26065,32333
23,23500,2028-12-31,6294,26324,32618
23,23500,2029-12-31,6311,26572,32883
23,23500,2030-12-31,6346,26829,33175
23,23500,2031-12-31,6367,27085,33452
23,23500,2032-12-31,6380,27328,33708
23,23500,2033-12-31,6409,27562,33971
23,23500,2034-12-31,6430,27802,34232
23,23500,2035-12-31,6452,28035,34487
23,23555,1985-12-31,30977,25132,56109
23,23555,1986-12-31,31124,24851,55975
23,23555,1987-12-31,31363,24568,55931
23,23555,1988-12-31,31657,24261,55918
23,23555,1989-12-31,32021,23934,55955
23,23555,1990-12-31,32483,23558,56041
23,23555,1991-12-31,33021,23174,56195
23,23555,1992-12-31,33647,22753,56400
23,23555,1993-12-31,34327,22332,56659
23,23555,1994-12-31,35021,21912,56933
23,23555,1995-12-31,35711,21521,57232
23,23555,1996-12-31,36348,21169,57517
23,23555,1997-12-31,36105,21072,57177
23,23555,1998-12-31,36613,21074,57687
23,23555,1999-12-31,37074,21093,58167
23,23555,2000-12-31,37477,21162,58639
23,23555,2001-12-31,37819,21242,59061
23,23555,2002-12-31,38141,21334,59475
23,23555,2003-12-31,38431,21460,59891
23,23555,2004-12-31,38713,21569,60282
23,23555,2005-12-31,38955,21699,60654
23,23555,2006-12-31,39210,21830,61040
23,23555,2007-12-31,39459,21929,61388
23,23555,2008-12-31,39237,22192,61429
23,23555,2009-12-31,39444,22307,61751
23,23555,2010-12-31,39646,22363,62009
23,23555,2011-12-31,39833,22455,62288
23,23555,2012-12-31,40021,22535,62556
23,23555,2013-12-31,40195,22583,62778
23,23555,2014-12-31,40364,22639,63003
23,23555,2015-12-31,40551,22710,63261
23,23555,2016-12-31,40753,22785,63538
23,23555,2017-12-31,40968,22834,63802
23,23555,2018-12-31,41228,22977,64205
23,23555,2019-12-31,41219,23246,64465
23,23555,2020-12-31,41267,23509,64776
23,23555,2021-12-31,41484,23821,65305
23,23555,2022-12-31,41649,24096,65745
23,23555,2023-12-31,41801,24357,66158
23,23555,2024-12-31,41882,24639,66521
23,23555,2025-12-31,41985,24894,66879
23,23555,2026-12-31,42101,25154,67255
23,23555,2027-12-31,42238,25403,67641
23,23555,2028-12-31,42383,25642,68025
23,23555,2029-12-31,42543,25875,68418
23,23555,2030-12-31,42728,26121,68849
23,23555,2031-12-31,42894,26345,69239
23,23555,2032-12-31,43066,26590,69656
23,23555,2033-12-31,43211,26830,70041
23,23555,2034-12-31,43337,27059,70396
23,23555,2035-12-31,43438,27291,70729
23,23570,1985-12-31,6489,15362,21851
23,23570,1986-12-31,6581,15559,22140
23,23570,1987-12-31,6685,15753,22438
23,23570,1988-12-31,6790,15927,22717
23,23570,1989-12-31,6907,16078,22985
23,23570,1990-12-31,7063,16196,23259
23,23570,1991-12-31,7230,16272,23502
23,23570,1992-12-31,7409,16333,23742
23,23570,1993-12-31,7616,16365,23981
23,23570,1994-12-31,7819,16394,24213
23,23570,1995-12-31,7995,16428,24423
23,23570,1996-12-31,8199,16476,24675
23,23570,1997-12-31,8182,16730,24912
23,23570,1998-12-31,8351,17052,25403
23,23570,1999-12-31,8487,17387,25874
23,23570,2000-12-31,8619,17763,26382
23,23570,2001-12-31,8749,18142,26891
23,23570,2002-12-31,8865,18555,27420
23,23570,2003-12-31,8972,18979,27951
23,23570,2004-12-31,9078,19407,28485
23,23570,2005-12-31,9169,19823,28992
23,23570,2006-12-31,9282,20332,29614
23,23570,2007-12-31,9363,20765,30128
23,23570,2008-12-31,9355,21330,30685
23,23570,2009-12-31,9429,21748,31177
23,23570,2010-12-31,9503,22165,31668
23,23570,2011-12-31,9591,22564,32155
23,23570,2012-12-31,9672,22992,32664
23,23570,2013-12-31,9746,23374,33120
23,23570,2014-12-31,9830,23787,33617
23,23570,2015-12-31,9906,24184,34090
23,23570,2016-12-31,10012,24596,34608
23,23570,2017-12-31,10021,25020,35041
23,23570,2018-12-31,10167,25488,35655
23,23570,2019-12-31,10265,25847,36112
23,23570,2020-12-31,10341,26145,36486
23,23570,2021-12-31,10292,26492,36784
23,23570,2022-12-31,10234,26798,37032
23,23570,2023-12-31,10176,27088,37264
23,23570,2024-12-31,10170,27372,37542
23,23570,2025-12-31,10180,27666,37846
23,23570,2026-12-31,10197,27929,38126
23,23570,2027-12-31,10238,28195,38433
23,23570,2028-12-31,10270,28474,38744
23,23570,2029-12-31,10296,28762,39058
23,23570,2030-12-31,10354,29030,39384
23,23570,2031-12-31,10389,29293,39682
23,23570,2032-12-31,10430,29559,39989
23,23570,2033-12-31,10470,29821,40291
23,23570,2034-12-31,10506,30076,40582
23,23570,2035-12-31,10533,30315,40848
23,23574,1985-12-31,1998,12468,14466
23,23574,1986-12-31,2035,12588,14623
23,23574,1987-12-31,2109,12696,14805
23,23574,1988-12-31,2183,12808,14991
23,23574,1989-12-31,2252,12888,15140
23,23574,1990-12-31,2340,12945,15285
23,23574,1991-12-31,2423,12996,15419
23,23574,1992-12-31,2533,12983,15516
23,23574,1993-12-31,2599,12984,15583
23,23574,1994-12-31,2736,12988,15724
23,23574,1995-12-31,2821,12978,15799
23,23574,1996-12-31,2919,12985,15904
23,23574,1997-12-31,2937,13149,16086
23,23574,1998-12-31,3013,13381,16394
23,23574,1999-12-31,3090,13621,16711
23,23574,2000-12-31,3177,13899,17076
23,23574,2001-12-31,3261,14176,17437
23,23574,2002-12-31,3328,14469,17797
23,23574,2003-12-31,3390,14763,18153
23,23574,2004-12-31,3462,15071,18533
23,23574,2005-12-31,3525,15402,18927
23,23574,2006-12-31,3581,15725,19306
23,23574,2007-12-31,3659,16065,19724
23,23574,2008-12-31,3665,16464,20129
23,23574,2009-12-31,3717,16756,20473
23,23574,2010-12-31,3783,17063,20846
23,23574,2011-12-31,3822,17370,21192
23,23574,2012-12-31,3884,17633,21517
23,23574,2013-12-31,3935,17934,21869
23,23574,2014-12-31,4007,18225,22232
23,23574,2015-12-31,4024,18521,22545
23,23574,2016-12-31,4057,18817,22874
23,23574,2017-12-31,4177,19093,23270
23,23574,2018-12-31,4209,19440,23649
23,23574,2019-12-31,4250,19786,24036
23,23574,2020-12-31,4281,20083,24364
23,23574,2021-12-31,4218,20350,24568
23,23574,2022-12-31,4149,20584,24733
23,23574,2023-12-31,4081,20808,24889
23,23574,2024-12-31,4059,21027,25086
23,23574,2025-12-31,4062,21238,25300
23,23574,2026-12-31,4073,21455,25528
23,23574,2027-12-31,4086,21668,25754
23,23574,2028-12-31,4086,21883,25969
23,23574,2029-12-31,4117,22076,26193
23,23574,2030-12-31,4126,22278,26404
23,23574,2031-12-31,4150,22482,26632
23,23574,2032-12-31,4157,22691,26848
23,23574,2033-12-31,4173,22886,27059
23,23574,2034-12-31,4190,23090,27280
23,23574,2035-12-31,4201,23280,27481
23,23580,1985-12-31,4873,13412,18285
23,23580,1986-12-31,5133,13802,18935
23,23580,1987-12-31,5381,14166,19547
23,23580,1988-12-31,5648,14529,20177
23,23580,1989-12-31,5943,14847,20790
23,23580,1990-12-31,6229,15136,21365
23,23580,1991-12-31,6538,15388,21926
23,23580,1992-12-31,6867,15616,22483
23,23580,1993-12-31,7221,15822,23043
23,23580,1994-12-31,7559,15992,23551
23,23580,1995-12-31,7915,16179,24094
23,23580,1996-12-31,8257,16381,24638
23,23580,1997-12-31,8394,16771,25165
23,23580,1998-12-31,8723,17213,25936
23,23580,1999-12-31,9019,17708,26727
23,23580,2000-12-31,9302,18209,27511
23,23580,2001-12-31,9568,18753,28321
23,23580,2002-12-31,9826,19271,29097
23,23580,2003-12-31,10089,19844,29933
23,23580,2004-12-31,10329,20427,30756
23,23580,2005-12-31,10569,21034,31603
23,23580,2006-12-31,10810,21629,32439
23,23580,2007-12-31,11045,22233,33278
23,23580,2008-12-31,11141,22943,34084
23,23580,2009-12-31,11347,23538,34885
23,23580,2010-12-31,11577,24103,35680
23,23580,2011-12-31,11785,24665,36450
23,23580,2012-12-31,11993,25220,37213
23,23580,2013-12-31,12189,25788,37977
23,23580,2014-12-31,12378,26336,38714
23,23580,2015-12-31,12593,26886,39479
23,23580,2016-12-31,12809,27476,40285
23,23580,2017-12-31,12981,27998,40979
23,23580,2018-12-31,13220,28653,41873
23,23580,2019-12-31,13398,29437,42835
23,23580,2020-12-31,13550,30023,43573
23,23580,2021-12-31,13509,30428,43937
23,23580,2022-12-31,13454,30779,44233
23,23580,2023-12-31,13399,31113,44512
23,23580,2024-12-31,13414,31421,44835
23,23580,2025-12-31,13441,31746,45187
23,23580,2026-12-31,13470,32055,45525
23,23580,2027-12-31,13515,32376,45891
23,23580,2028-12-31,13571,32686,46257
23,23580,2029-12-31,13616,33016,46632
23,23580,2030-12-31,13672,33324,46996
23,23580,2031-12-31,13739,33635,47374
23,23580,2032-12-31,13782,33932,47714
23,23580,2033-12-31,13825,34231,48056
23,23580,2034-12-31,13871,34530,48401
23,23580,2035-12-31,13912,34819,48731
23,23586,1985-12-31,5701,6101,11802
23,23586,1986-12-31,5698,6171,11869
23,23586,1987-12-31,5728,6232,11960
23,23586,1988-12-31,5770,6312,12082
23,23586,1989-12-31,5837,6362,12199
23,23586,1990-12-31,5928,6403,12331
23,23586,1991-12-31,6010,6445,12455
23,23586,1992-12-31,6102,6452,12554
23,23586,1993-12-31,6204,6493,12697
23,23586,1994-12-31,6324,6490,12814
23,23586,1995-12-31,6438,6496,12934
23,23586,1996-12-31,6549,6519,13068
23,23586,1997-12-31,6485,6607,13092
23,23586,1998-12-31,6573,6711,13284
23,23586,1999-12-31,6646,6854,13500
23,23586,2000-12-31,6702,6988,13690
23,23586,2001-12-31,6761,7161,13922
23,23586,2002-12-31,6814,7301,14115
23,23586,2003-12-31,6836,7476,14312
23,23586,2004-12-31,6867,7631,14498
23,23586,2005-12-31,6923,7820,14743
23,23586,2006-12-31,6956,7987,14943
23,23586,2007-12-31,6978,8171,15149
23,23586,2008-12-31,6948,8383,15331
23,23586,2009-12-31,6963,8557,15520
23,23586,2010-12-31,6977,8705,15682
23,23586,2011-12-31,7040,8859,15899
23,23586,2012-12-31,7093,9051,16144
23,23586,2013-12-31,7102,9199,16301
23,23586,2014-12-31,7094,9337,16431
23,23586,2015-12-31,7127,9466,16593
23,23586,2016-12-31,7106,9691,16797
23,23586,2017-12-31,7147,9849,16996
23,23586,2018-12-31,7217,9989,17206
23,23586,2019-12-31,7184,10227,17411
23,23586,2020-12-31,7172,10415,17587
23,23586,2021-12-31,7176,10555,17731
23,23586,2022-12-31,7173,10677,17850
23,23586,2023-12-31,7169,10793,17962
23,23586,2024-12-31,7177,10898,18075
23,23586,2025-12-31,7182,11018,18200
23,23586,2026-12-31,7202,11127,18329
23,23586,2027-12-31,7217,11230,18447
23,23586,2028-12-31,7249,11335,18584
23,23586,2029-12-31,7273,11454,18727
23,23586,2030-12-31,7292,11562,18854
23,23586,2031-12-31,7324,11663,18987
23,23586,2032-12-31,7358,11768,19126
23,23586,2033-12-31,7376,11884,19260
23,23586,2034-12-31,7403,11982,19385
23,23586,2035-12-31,7420,12090,19510
23,23660,1985-12-31,36623,36922,73545
23,23660,1986-12-31,36996,37200,74196
23,23660,1987-12-31,37412,37419,74831
23,23660,1988-12-31,37917,37625,75542
23,23660,1989-12-31,38517,37750,76267
23,23660,1990-12-31,39234,37803,77037
23,23660,1991-12-31,40053,37809,77862
23,23660,1992-12-31,40984,37753,78737
23,23660,1993-12-31,41933,37629,79562
23,23660,1994-12-31,42941,37512,80453
23,23660,1995-12-31,43933,37420,81353
23,23660,1996-12-31,44862,37363,82225
23,23660,1997-12-31,44711,37782,82493
23,23660,1998-12-31,45484,38326,83810
23,23660,1999-12-31,46179,38928,85107
23,23660,2000-12-31,46814,39604,86418
23,23660,2001-12-31,47394,40322,87716
23,23660,2002-12-31,47923,41080,89003
23,23660,2003-12-31,48418,41878,90296
23,23660,2004-12-31,48887,42673,91560
23,23660,2005-12-31,49338,43478,92816
23,23660,2006-12-31,49783,44321,94104
23,23660,2007-12-31,50210,45173,95383
23,23660,2008-12-31,50052,46262,96314
23,23660,2009-12-31,50441,47026,97467
23,23660,2010-12-31,50807,47797,98604
23,23660,2011-12-31,51172,48557,99729
23,23660,2012-12-31,51523,49268,100791
23,23660,2013-12-31,51855,50013,101868
23,23660,2014-12-31,52192,50748,102940
23,23660,2015-12-31,52529,51518,104047
23,23660,2016-12-31,52911,52218,105129
23,23660,2017-12-31,53318,53059,106377
23,23660,2018-12-31,53725,53911,107636
23,23660,2019-12-31,53832,55220,109052
23,23660,2020-12-31,53973,56260,110233
23,23660,2021-12-31,54117,57018,111135
23,23660,2022-12-31,54206,57676,111882
23,23660,2023-12-31,54283,58302,112585
23,23660,2024-12-31,54386,58929,113315
23,23660,2025-12-31,54506,59526,114032
23,23660,2026-12-31,54643,60136,114779
23,23660,2027-12-31,54818,60722,115540
23,23660,2028-12-31,55009,61330,116339
23,23660,2029-12-31,55220,61894,117114
23,23660,2030-12-31,55463,62479,117942
23,23660,2031-12-31,55692,63066,118758
23,23660,2032-12-31,55899,63621,119520
23,23660,2033-12-31,56092,64187,120279
23,23660,2034-12-31,56250,64737,120987
23,23660,2035-12-31,56401,65272,121673
23,23670,1985-12-31,4790,31324,36114
23,23670,1986-12-31,4917,32798,37715
23,23670,1987-12-31,5060,34218,39278
23,23670,1988-12-31,5216,35568,40784
23,23670,1989-12-31,5387,36825,42212
23,23670,1990-12-31,5559,37978,43537
23,23670,1991-12-31,5771,39047,44818
23,23670,1992-12-31,5979,40009,45988
23,23670,1993-12-31,6208,40853,47061
23,23670,1994-12-31,6440,41676,48116
23,23670,1995-12-31,6668,42480,49148
23,23670,1996-12-31,6893,43323,50216
23,23670,1997-12-31,6948,44657,51605
23,23670,1998-12-31,7129,46169,53298
23,23670,1999-12-31,7333,47772,55105
23,23670,2000-12-31,7489,49423,56912
23,23670,2001-12-31,7650,51148,58798
23,23670,2002-12-31,7809,52928,60737
23,23670,2003-12-31,7969,54748,62717
23,23670,2004-12-31,8112,56605,64717
23,23670,2005-12-31,8256,58504,66760
23,23670,2006-12-31,8388,60433,68821
23,23670,2007-12-31,8523,62386,70909
23,23670,2008-12-31,8561,30531,39092
23,23670,2009-12-31,8689,31363,40052
23,23670,2010-12-31,8793,32199,40992
23,23670,2011-12-31,8905,33022,41927
23,23670,2012-12-31,9043,33837,42880
23,23670,2013-12-31,9151,34644,43795
23,23670,2014-12-31,9264,35460,44724
23,23670,2015-12-31,9367,36287,45654
23,23670,2016-12-31,9511,37075,46586
23,23670,2017-12-31,9579,37932,47511
23,23670,2018-12-31,9750,38860,48610
23,23670,2019-12-31,9899,38316,48215
23,23670,2020-12-31,10026,38016,48042
23,23670,2021-12-31,9913,38521,48434
23,23670,2022-12-31,9795,38965,48760
23,23670,2023-12-31,9679,39388,49067
23,23670,2024-12-31,9667,39791,49458
23,23670,2025-12-31,9680,40199,49879
23,23670,2026-12-31,9710,40600,50310
23,23670,2027-12-31,9738,40998,50736
23,23670,2028-12-31,9771,41406,51177
23,23670,2029-12-31,9817,41804,51621
23,23670,2030-12-31,9842,42194,52036
23,23670,2031-12-31,9885,42578,52463
23,23670,2032-12-31,9930,42981,52911
23,23670,2033-12-31,9961,43363,53324
23,23670,2034-12-31,9993,43744,53737
23,23670,2035-12-31,10029,44099,54128
23,23672,1985-12-31,11276,6730,18006
23,23672,1986-12-31,11369,7045,18414
23,23672,1987-12-31,11480,7343,18823
23,23672,1988-12-31,11608,7626,19234
23,23672,1989-12-31,11788,7908,19696
23,23672,1990-12-31,11981,8160,20141
23,23672,1991-12-31,12207,8380,20587
23,23672,1992-12-31,12467,8590,21057
23,23672,1993-12-31,12750,8780,21530
23,23672,1994-12-31,13037,8963,22000
23,23672,1995-12-31,13327,9143,22470
23,23672,1996-12-31,13601,9317,22918
23,23672,1997-12-31,13546,9609,23155
23,23672,1998-12-31,13762,9925,23687
23,23672,1999-12-31,13961,10281,24242
23,23672,2000-12-31,14146,10631,24777
23,23672,2001-12-31,14299,11002,25301
23,23672,2002-12-31,14438,11365,25803
23,23672,2003-12-31,14579,11767,26346
23,23672,2004-12-31,14709,12165,26874
23,23672,2005-12-31,14824,12572,27396
23,23672,2006-12-31,14952,12985,27937
23,23672,2007-12-31,15071,13407,28478
23,23672,2008-12-31,15011,13877,28888
23,23672,2009-12-31,15120,14295,29415
23,23672,2010-12-31,15217,14697,29914
23,23672,2011-12-31,15311,15099,30410
23,23672,2012-12-31,15403,15492,30895
23,23672,2013-12-31,15520,15885,31405
23,23672,2014-12-31,15603,16268,31871
23,23672,2015-12-31,15668,16685,32353
23,23672,2016-12-31,15756,17062,32818
23,23672,2017-12-31,15913,17478,33391
23,23672,2018-12-31,15995,17883,33878
23,23672,2019-12-31,16044,18476,34520
23,23672,2020-12-31,16091,18944,35035
23,23672,2021-12-31,16129,19199,35328
23,23672,2022-12-31,16145,19421,35566
23,23672,2023-12-31,16158,19632,35790
23,23672,2024-12-31,16181,19819,36000
23,23672,2025-12-31,16213,20015,36228
23,23672,2026-12-31,16253,20229,36482
23,23672,2027-12-31,16292,20431,36723
23,23672,2028-12-31,16348,20640,36988
23,23672,2029-12-31,16406,20837,37243
23,23672,2030-12-31,16471,21027,37498
23,23672,2031-12-31,16539,21218,37757
23,23672,2032-12-31,16596,21421,38017
23,23672,2033-12-31,16674,21599,38273
23,23672,2034-12-31,16714,21790,38504
23,23672,2035-12-31,16751,21983,38734
23,23675,1985-12-31,6931,20621,27552
23,23675,1986-12-31,6958,20682,27640
23,23675,1987-12-31,7011,20753,27764
23,23675,1988-12-31,7059,20784,27843
23,23675,1989-12-31,7130,20793,27923
23,23675,1990-12-31,7231,20766,27997
23,23675,1991-12-31,7355,20701,28056
23,23675,1992-12-31,7489,20603,28092
23,23675,1993-12-31,7627,20495,28122
23,23675,1994-12-31,7796,20369,28165
23,23675,1995-12-31,7936,20254,28190
23,23675,1996-12-31,8077,20168,28245
23,23675,1997-12-31,8029,20345,28374
23,23675,1998-12-31,8127,20596,28723
23,23675,1999-12-31,8223,20877,29100
23,23675,2000-12-31,8309,21184,29493
23,23675,2001-12-31,8388,21525,29913
23,23675,2002-12-31,8463,21884,30347
23,23675,2003-12-31,8523,22253,30776
23,23675,2004-12-31,8574,22632,31206
23,23675,2005-12-31,8622,23017,31639
23,23675,2006-12-31,8674,23423,32097
23,23675,2007-12-31,8726,23833,32559
23,23675,2008-12-31,8681,24346,33027
23,23675,2009-12-31,8721,24714,33435
23,23675,2010-12-31,8782,25069,33851
23,23675,2011-12-31,8797,25439,34236
23,23675,2012-12-31,8841,25744,34585
23,23675,2013-12-31,8877,26119,34996
23,23675,2014-12-31,8902,26429,35331
23,23675,2015-12-31,8968,26771,35739
23,23675,2016-12-31,9039,27123,36162
23,23675,2017-12-31,9023,27456,36479
23,23675,2018-12-31,9091,27916,37007
23,23675,2019-12-31,9075,27977,37052
23,23675,2020-12-31,9076,27999,37075
23,23675,2021-12-31,9007,28371,37378
23,23675,2022-12-31,8931,28698,37629
23,23675,2023-12-31,8857,29009,37866
23,23675,2024-12-31,8775,29339,38114
23,23675,2025-12-31,8705,29635,38340
23,23675,2026-12-31,8627,29931,38558
23,23675,2027-12-31,8546,30241,38787
23,23675,2028-12-31,8474,30511,38985
23,23675,2029-12-31,8429,30822,39251
23,23675,2030-12-31,8364,31099,39463
23,23675,2031-12-31,8309,31389,39698
23,23675,2032-12-31,8248,31680,39928
23,23675,2033-12-31,8182,31958,40140
23,23675,2034-12-31,8129,32218,40347
23,23675,2035-12-31,8066,32487,40553
23,23678,1985-12-31,3593,17834,21427
23,23678,1986-12-31,3578,17831,21409
23,23678,1987-12-31,3586,17825,21411
23,23678,1988-12-31,3639,17792,21431
23,23678,1989-12-31,3670,17745,21415
23,23678,1990-12-31,3723,17675,21398
23,23678,1991-12-31,3775,17568,21343
23,23678,1992-12-31,3854,17430,21284
23,23678,1993-12-31,3918,17295,21213
23,23678,1994-12-31,3999,17136,21135
23,23678,1995-12-31,4080,16990,21070
23,23678,1996-12-31,4130,16895,21025
23,23678,1997-12-31,4109,16982,21091
23,23678,1998-12-31,4174,17131,21305
23,23678,1999-12-31,4215,17321,21536
23,23678,2000-12-31,4259,17565,21824
23,23678,2001-12-31,4303,17796,22099
23,23678,2002-12-31,4322,18043,22365
23,23678,2003-12-31,4365,18321,22686
23,23678,2004-12-31,4382,18589,22971
23,23678,2005-12-31,4420,18850,23270
23,23678,2006-12-31,4441,19147,23588
23,23678,2007-12-31,4457,19451,23908
23,23678,2008-12-31,4443,19845,24288
23,23678,2009-12-31,4463,20071,24534
23,23678,2010-12-31,4487,20339,24826
23,23678,2011-12-31,4504,20567,25071
23,23678,2012-12-31,4502,20835,25337
23,23678,2013-12-31,4548,21060,25608
23,23678,2014-12-31,4553,21301,25854
23,23678,2015-12-31,4510,21544,26054
23,23678,2016-12-31,4582,21775,26357
23,23678,2017-12-31,4621,21965,26586
23,23678,2018-12-31,4629,22325,26954
23,23678,2019-12-31,4671,22503,27174
23,23678,2020-12-31,4704,22664,27368
23,23678,2021-12-31,4626,22965,27591
23,23678,2022-12-31,4547,23230,27777
23,23678,2023-12-31,4470,23482,27952
23,23678,2024-12-31,4452,23741,28193
23,23678,2025-12-31,4455,23995,28450
23,23678,2026-12-31,4471,24236,28707
23,23678,2027-12-31,4478,24466,28944
23,23678,2028-12-31,4498,24718,29216
23,23678,2029-12-31,4513,24937,29450
23,23678,2030-12-31,4532,25166,29698
23,23678,2031-12-31,4547,25412,29959
23,23678,2032-12-31,4566,25642,30208
23,23678,2033-12-31,4579,25863,30442
23,23678,2034-12-31,4587,26084,30671
23,23678,2035-12-31,4605,26298,30903
23,23682,1985-12-31,0,0,0
23,23682,1986-12-31,0,0,0
23,23682,1987-12-31,0,0,0
23,23682,1988-12-31,0,0,0
23,23682,1989-12-31,0,0,0
23,23682,1990-12-31,0,0,0
23,23682,1991-12-31,0,0,0
23,23682,1992-12-31,0,0,0
23,23682,1993-12-31,0,0,0
23,23682,1994-12-31,0,0,0
23,23682,1995-12-31,0,0,0
23,23682,1996-12-31,0,0,0
23,23682,1997-12-31,0,0,0
23,23682,1998-12-31,0,0,0
23,23682,1999-12-31,0,0,0
23,23682,2000-12-31,0,0,0
23,23682,2001-12-31,0,0,0
23,23682,2002-12-31,0,0,0
23,23682,2003-12-31,0,0,0
23,23682,2004-12-31,0,0,0
23,23682,2005-12-31,0,0,0
23,23682,2006-12-31,0,0,0
23,23682,2007-12-31,0,0,0
23,23682,2008-12-31,3817,5684,9501
23,23682,2009-12-31,3980,5949,9929
23,23682,2010-12-31,4123,6185,10308
23,23682,2011-12-31,4254,6419,10673
23,23682,2012-12-31,4382,6668,11050
23,23682,2013-12-31,4502,6926,11428
23,23682,2014-12-31,4640,7188,11828
23,23682,2015-12-31,4751,7440,12191
23,23682,2016-12-31,4847,7684,12531
23,23682,2017-12-31,4992,7963,12955
23,23682,2018-12-31,5160,8185,13345
23,23682,2019-12-31,5206,8378,13584
23,23682,2020-12-31,5242,8572,13814
23,23682,2021-12-31,5242,8688,13930
23,23682,2022-12-31,5235,8788,14023
23,23682,2023-12-31,5229,8883,14112
23,23682,2024-12-31,5229,8972,14201
23,23682,2025-12-31,5248,9064,14312
23,23682,2026-12-31,5256,9154,14410
23,23682,2027-12-31,5279,9244,14523
23,23682,2028-12-31,5289,9337,14626
23,23682,2029-12-31,5321,9424,14745
23,23682,2030-12-31,5339,9514,14853
23,23682,2031-12-31,5352,9613,14965
23,23682,2032-12-31,5372,9695,15067
23,23682,2033-12-31,5399,9779,15178
23,23682,2034-12-31,5413,9870,15283
23,23682,2035-12-31,5420,9951,15371
23,23686,1985-12-31,4589,32065,36654
23,23686,1986-12-31,4717,32979,37696
23,23686,1987-12-31,4849,33868,38717
23,23686,1988-12-31,4986,34685,39671
23,23686,1989-12-31,5136,35424,40560
23,23686,1990-12-31,5302,36083,41385
23,23686,1991-12-31,5481,36670,42151
23,23686,1992-12-31,5691,37172,42863
23,23686,1993-12-31,5887,37578,43465
23,23686,1994-12-31,6113,37996,44109
23,23686,1995-12-31,6312,38416,44728
23,23686,1996-12-31,6514,38856,45370
23,23686,1997-12-31,6557,38682,45239
23,23686,1998-12-31,6737,38699,45436
23,23686,1999-12-31,6908,38787,45695
23,23686,2000-12-31,7064,38913,45977
23,23686,2001-12-31,7209,39096,46305
23,23686,2002-12-31,7358,39309,46667
23,23686,2003-12-31,7492,39551,47043
23,23686,2004-12-31,7624,39792,47416
23,23686,2005-12-31,7739,39997,47736
23,23686,2006-12-31,7865,40264,48129
23,23686,2007-12-31,8003,40525,48528
23,23686,2008-12-31,8027,41004,49031
23,23686,2009-12-31,8134,41214,49348
23,23686,2010-12-31,8250,41387,49637
23,23686,2011-12-31,8354,41567,49921
23,23686,2012-12-31,8464,41711,50175
23,23686,2013-12-31,8571,41857,50428
23,23686,2014-12-31,8661,42026,50687
23,23686,2015-12-31,8788,42147,50935
23,23686,2016-12-31,8875,42315,51190
23,23686,2017-12-31,9000,42486,51486
23,23686,2018-12-31,9105,42733,51838
23,23686,2019-12-31,9203,43278,52481
23,23686,2020-12-31,9278,43716,52994
23,23686,2021-12-31,9131,44296,53427
23,23686,2022-12-31,8979,44807,53786
23,23686,2023-12-31,8831,45294,54125
23,23686,2024-12-31,8800,45768,54568
23,23686,2025-12-31,8806,46240,55046
23,23686,2026-12-31,8836,46689,55525
23,23686,2027-12-31,8861,47156,56017
23,23686,2028-12-31,8894,47616,56510
23,23686,2029-12-31,8916,48070,56986
23,23686,2030-12-31,8950,48530,57480
23,23686,2031-12-31,8992,48956,57948
23,23686,2032-12-31,9019,49404,58423
23,23686,2033-12-31,9051,49831,58882
23,23686,2034-12-31,9073,50256,59329
23,23686,2035-12-31,9126,50686,59812
23,23807,1985-12-31,16218,50204,66422
23,23807,1986-12-31,16988,49791,66779
23,23807,1987-12-31,17793,49345,67138
23,23807,1988-12-31,18631,48864,67495
23,23807,1989-12-31,19509,48337,67846
23,23807,1990-12-31,20442,47744,68186
23,23807,1991-12-31,21424,47074,68498
23,23807,1992-12-31,22464,46364,68828
23,23807,1993-12-31,23539,45602,69141
23,23807,1994-12-31,24650,44860,69510
23,23807,1995-12-31,25751,44191,69942
23,23807,1996-12-31,26821,43578,70399
23,23807,1997-12-31,27245,43520,70765
23,23807,1998-12-31,28223,43620,71843
23,23807,1999-12-31,29154,43801,72955
23,23807,2000-12-31,30049,44038,74087
23,23807,2001-12-31,30899,44327,75226
23,23807,2002-12-31,31714,44661,76375
23,23807,2003-12-31,32512,45010,77522
23,23807,2004-12-31,33273,45355,78628
23,23807,2005-12-31,34019,45780,79799
23,23807,2006-12-31,34757,46187,80944
23,23807,2007-12-31,35487,46589,82076
23,23807,2008-12-31,35785,47225,83010
23,23807,2009-12-31,36464,47525,83989
23,23807,2010-12-31,37120,47819,84939
23,23807,2011-12-31,37786,48111,85897
23,23807,2012-12-31,38423,48396,86819
23,23807,2013-12-31,39047,48652,87699
23,23807,2014-12-31,39664,48907,88571
23,23807,2015-12-31,40275,49160,89435
23,23807,2016-12-31,40909,49426,90335
23,23807,2017-12-31,41555,49718,91273
23,23807,2018-12-31,42254,50095,92349
23,23807,2019-12-31,42987,50886,93873
23,23807,2020-12-31,43553,51624,95177
23,23807,2021-12-31,43664,52309,95973
23,23807,2022-12-31,43707,52913,96620
23,23807,2023-12-31,43740,53487,97227
23,23807,2024-12-31,43824,54036,97860
23,23807,2025-12-31,43935,54591,98526
23,23807,2026-12-31,44065,55130,99195
23,23807,2027-12-31,44200,55647,99847
23,23807,2028-12-31,44368,56185,100553
23,23807,2029-12-31,44540,56715,101255
23,23807,2030-12-31,44718,57260,101978
23,23807,2031-12-31,44898,57804,102702
23,23807,2032-12-31,45083,58309,103392
23,23807,2033-12-31,45223,58847,104070
23,23807,2034-12-31,45358,59353,104711
23,23807,2035-12-31,45462,59851,105313
23,23815,1985-12-31,0,0,0
23,23815,1986-12-31,0,0,0
23,23815,1987-12-31,0,0,0
23,23815,1988-12-31,0,0,0
23,23815,1989-12-31,0,0,0
23,23815,1990-12-31,0,0,0
23,23815,1991-12-31,0,0,0
23,23815,1992-12-31,0,0,0
23,23815,1993-12-31,0,0,0
23,23815,1994-12-31,0,0,0
23,23815,1995-12-31,0,0,0
23,23815,1996-12-31,0,0,0
23,23815,1997-12-31,0,0,0
23,23815,1998-12-31,0,0,0
23,23815,1999-12-31,0,0,0
23,23815,2000-12-31,0,0,0
23,23815,2001-12-31,0,0,0
23,23815,2002-12-31,0,0,0
23,23815,2003-12-31,0,0,0
23,23815,2004-12-31,0,0,0
23,23815,2005-12-31,0,0,0
23,23815,2006-12-31,0,0,0
23,23815,2007-12-31,0,0,0
23,23815,2008-12-31,5677,31660,37337
23,23815,2009-12-31,5892,32986,38878
23,23815,2010-12-31,6079,34303,40382
23,23815,2011-12-31,6229,35639,41868
23,23815,2012-12-31,6438,36956,43394
23,23815,2013-12-31,6591,38275,44866
23,23815,2014-12-31,6832,39586,46418
23,23815,2015-12-31,6985,40894,47879
23,23815,2016-12-31,7182,42230,49412
23,23815,2017-12-31,7336,43595,50931
23,23815,2018-12-31,7576,45030,52606
23,23815,2019-12-31,7703,46041,53744
23,23815,2020-12-31,7837,47121,54958
23,23815,2021-12-31,7662,47756,55418
23,23815,2022-12-31,7484,48307,55791
23,23815,2023-12-31,7311,48831,56142
23,23815,2024-12-31,7282,49348,56630
23,23815,2025-12-31,7292,49861,57153
23,23815,2026-12-31,7304,50378,57682
23,23815,2027-12-31,7325,50897,58222
23,23815,2028-12-31,7351,51383,58734
23,23815,2029-12-31,7382,51876,59258
23,23815,2030-12-31,7411,52363,59774
23,23815,2031-12-31,7449,52852,60301
23,23815,2032-12-31,7468,53332,60800
23,23815,2033-12-31,7505,53793,61298
23,23815,2034-12-31,7526,54261,61787
23,23815,2035-12-31,7543,54717,62260
23,23855,1985-12-31,8129,17957,26086
23,23855,1986-12-31,8347,17871,26218
23,23855,1987-12-31,8600,17757,26357
23,23855,1988-12-31,8856,17621,26477
23,23855,1989-12-31,9128,17477,26605
23,23855,1990-12-31,9441,17309,26750
23,23855,1991-12-31,9787,17104,26891
23,23855,1992-12-31,10144,16880,27024
23,23855,1993-12-31,10509,16649,27158
23,23855,1994-12-31,10895,16419,27314
23,23855,1995-12-31,11281,16187,27468
23,23855,1996-12-31,11655,16001,27656
23,23855,1997-12-31,11740,16035,27775
23,23855,1998-12-31,12063,16109,28172
23,23855,1999-12-31,12374,16212,28586
23,23855,2000-12-31,12666,16338,29004
23,23855,2001-12-31,12935,16482,29417
23,23855,2002-12-31,13196,16626,29822
23,23855,2003-12-31,13451,16795,30246
23,23855,2004-12-31,13695,16972,30667
23,23855,2005-12-31,13929,17151,31080
23,23855,2006-12-31,14148,17344,31492
23,23855,2007-12-31,14380,17522,31902
23,23855,2008-12-31,14438,17808,32246
23,23855,2009-12-31,14657,17951,32608
23,23855,2010-12-31,14841,18099,32940
23,23855,2011-12-31,15052,18265,33317
23,23855,2012-12-31,15257,18398,33655
23,23855,2013-12-31,15446,18514,33960
23,23855,2014-12-31,15622,18665,34287
23,23855,2015-12-31,15818,18813,34631
23,23855,2016-12-31,16020,18982,35002
23,23855,2017-12-31,16227,19056,35283
23,23855,2018-12-31,16434,19260,35694
23,23855,2019-12-31,16605,19437,36042
23,23855,2020-12-31,16737,19606,36343
23,23855,2021-12-31,16774,19866,36640
23,23855,2022-12-31,16791,20095,36886
23,23855,2023-12-31,16805,20313,37118
23,23855,2024-12-31,16831,20529,37360
23,23855,2025-12-31,16870,20745,37615
23,23855,2026-12-31,16923,20962,37885
23,23855,2027-12-31,16972,21168,38140
23,23855,2028-12-31,17029,21365,38394
23,23855,2029-12-31,17094,21572,38666
23,23855,2030-12-31,17167,21769,38936
23,23855,2031-12-31,17236,21971,39207
23,23855,2032-12-31,17301,22175,39476
23,23855,2033-12-31,17367,22380,39747
23,23855,2034-12-31,17412,22573,39985
23,23855,2035-12-31,17460,22767,40227
25,25001,1985-12-31,13617,4384,18001
25,25001,1986-12-31,12783,4208,16991
25,25001,1987-12-31,12073,4030,16103
25,25001,1988-12-31,11512,3875,15387
25,25001,1989-12-31,10934,3667,14601
25,25001,1990-12-31,10390,3577,13967
25,25001,1991-12-31,9955,3439,13394
25,25001,1992-12-31,9578,3311,12889
25,25001,1993-12-31,9217,3192,12409
25,25001,1994-12-31,8924,3092,12016
25,25001,1995-12-31,8680,2975,11655
25,25001,1996-12-31,8467,2924,11391
25,25001,1997-12-31,8288,2821,11109
25,25001,1998-12-31,8051,2781,10832
25,25001,1999-12-31,7897,2711,10608
25,25001,2000-12-31,7789,2667,10456
25,25001,2001-12-31,7667,2622,10289
25,25001,2002-12-31,7620,2570,10190
25,25001,2003-12-31,7587,2531,10118
25,25001,2004-12-31,7547,2490,10037
25,25001,2005-12-31,7384,2433,9817
25,25001,2006-12-31,7370,2401,9771
25,25001,2007-12-31,7376,2370,9746
25,25001,2008-12-31,7426,2370,9796
25,25001,2009-12-31,7496,2349,9845
25,25001,2010-12-31,7587,2351,9938
25,25001,2011-12-31,7693,2354,10047
25,25001,2012-12-31,7825,2367,10192
25,25001,2013-12-31,7957,2396,10353
25,25001,2014-12-31,8139,2419,10558
25,25001,2015-12-31,8312,2449,10761
25,25001,2016-12-31,8551,2463,11014
25,25001,2017-12-31,8792,2533,11325
25,25001,2018-12-31,9113,2572,11685
25,25001,2019-12-31,9358,2608,11966
25,25001,2020-12-31,9710,2615,12325
25,25001,2021-12-31,10185,2628,12813
25,25001,2022-12-31,10575,2642,13217
25,25001,2023-12-31,10950,2642,13592
25,25001,2024-12-31,11318,2653,13971
25,25001,2025-12-31,11665,2659,14324
25,25001,2026-12-31,11986,2667,14653
25,25001,2027-12-31,12273,2684,14957
25,25001,2028-12-31,12542,2687,15229
25,25001,2029-12-31,12792,2696,15488
25,25001,2030-12-31,13017,2706,15723
25,25001,2031-12-31,13230,2721,15951
25,25001,2032-12-31,13444,2730,16174
25,25001,2033-12-31,13644,2740,16384
25,25001,2034-12-31,13853,2755,16608
25,25001,2035-12-31,14052,2766,16818
25,25019,1985-12-31,2135,6263,8398
25,25019,1986-12-31,2051,6058,8109
25,25019,1987-12-31,1932,5840,7772
25,25019,1988-12-31,1819,5617,7436
25,25019,1989-12-31,1764,5406,7170
25,25019,1990-12-31,1682,5253,6935
25,25019,1991-12-31,1593,5079,6672
25,25019,1992-12-31,1544,4945,6489
25,25019,1993-12-31,1503,4766,6269
25,25019,1994-12-31,1448,4668,6116
25,25019,1995-12-31,1421,4546,5967
25,25019,1996-12-31,1398,4449,5847
25,25019,1997-12-31,1362,4357,5719
25,25019,1998-12-31,1338,4324,5662
25,25019,1999-12-31,1326,4246,5572
25,25019,2000-12-31,1325,4209,5534
25,25019,2001-12-31,1313,4160,5473
25,25019,2002-12-31,1273,4112,5385
25,25019,2003-12-31,1278,4063,5341
25,25019,2004-12-31,1280,4037,5317
25,25019,2005-12-31,1292,4010,5302
25,25019,2006-12-31,1293,4004,5297
25,25019,2007-12-31,1307,4002,5309
25,25019,2008-12-31,1311,4005,5316
25,25019,2009-12-31,1329,4035,5364
25,25019,2010-12-31,1358,4065,5423
25,25019,2011-12-31,1402,4109,5511
25,25019,2012-12-31,1423,4158,5581
25,25019,2013-12-31,1444,4224,5668
25,25019,2014-12-31,1501,4294,5795
25,25019,2015-12-31,1538,4366,5904
25,25019,2016-12-31,1571,4467,6038
25,25019,2017-12-31,1638,4583,6221
25,25019,2018-12-31,1715,4723,6438
25,25019,2019-12-31,1783,4867,6650
25,25019,2020-12-31,1864,5015,6879
25,25019,2021-12-31,2121,5031,7152
25,25019,2022-12-31,2335,5042,7377
25,25019,2023-12-31,2535,5052,7587
25,25019,2024-12-31,2640,5068,7708
25,25019,2025-12-31,2720,5078,7798
25,25019,2026-12-31,2788,5087,7875
25,25019,2027-12-31,2861,5104,7965
25,25019,2028-12-31,2929,5117,8046
25,25019,2029-12-31,2992,5143,8135
25,25019,2030-12-31,3053,5161,8214
25,25019,2031-12-31,3101,5186,8287
25,25019,2032-12-31,3156,5199,8355
25,25019,2033-12-31,3211,5217,8428
25,25019,2034-12-31,3247,5231,8478
25,25019,2035-12-31,3302,5251,8553
25,25035,1985-12-31,2816,8855,11671
25,25035,1986-12-31,2753,8605,11358
25,25035,1987-12-31,2767,8381,11148
25,25035,1988-12-31,2758,8144,10902
25,25035,1989-12-31,2724,7951,10675
25,25035,1990-12-31,2682,7728,10410
25,25035,1991-12-31,2715,7555,10270
25,25035,1992-12-31,2712,7359,10071
25,25035,1993-12-31,2697,7200,9897
25,25035,1994-12-31,2743,7084,9827
25,25035,1995-12-31,2758,6972,9730
25,25035,1996-12-31,2800,6873,9673
25,25035,1997-12-31,2810,6792,9602
25,25035,1998-12-31,2843,6783,9626
25,25035,1999-12-31,2876,6748,9624
25,25035,2000-12-31,2945,6712,9657
25,25035,2001-12-31,3012,6688,9700
25,25035,2002-12-31,3066,6675,9741
25,25035,2003-12-31,3160,6666,9826
25,25035,2004-12-31,3223,6672,9895
25,25035,2005-12-31,3303,6690,9993
25,25035,2006-12-31,3418,6715,10133
25,25035,2007-12-31,3508,6770,10278
25,25035,2008-12-31,3642,6834,10476
25,25035,2009-12-31,3772,6935,10707
25,25035,2010-12-31,3922,7049,10971
25,25035,2011-12-31,4109,7192,11301
25,25035,2012-12-31,4284,7328,11612
25,25035,2013-12-31,4467,7481,11948
25,25035,2014-12-31,4684,7673,12357
25,25035,2015-12-31,4934,7892,12826
25,25035,2016-12-31,5173,8138,13311
25,25035,2017-12-31,5439,8378,13817
25,25035,2018-12-31,5801,8718,14519
25,25035,2019-12-31,6288,9027,15315
25,25035,2020-12-31,6760,9304,16064
25,25035,2021-12-31,7368,9334,16702
25,25035,2022-12-31,7872,9355,17227
25,25035,2023-12-31,8345,9372,17717
25,25035,2024-12-31,8683,9400,18083
25,25035,2025-12-31,8943,9424,18367
25,25035,2026-12-31,9208,9437,18645
25,25035,2027-12-31,9468,9476,18944
25,25035,2028-12-31,9690,9496,19186
25,25035,2029-12-31,9895,9531,19426
25,25035,2030-12-31,10066,9568,19634
25,25035,2031-12-31,10225,9609,19834
25,25035,2032-12-31,10383,9646,20029
25,25035,2033-12-31,10536,9689,20225
25,25035,2034-12-31,10698,9734,20432
25,25035,2035-12-31,10835,9760,20595
25,25040,1985-12-31,7688,12543,20231
25,25040,1986-12-31,7244,12080,19324
25,25040,1987-12-31,6812,11646,18458
25,25040,1988-12-31,6424,11256,17680
25,25040,1989-12-31,6093,10876,16969
25,25040,1990-12-31,5777,10525,16302
25,25040,1991-12-31,5474,10174,15648
25,25040,1992-12-31,5242,9828,15070
25,25040,1993-12-31,5004,9543,14547
25,25040,1994-12-31,4850,9322,14172
25,25040,1995-12-31,4684,9064,13748
25,25040,1996-12-31,4558,8881,13439
25,25040,1997-12-31,4396,8704,13100
25,25040,1998-12-31,4266,8648,12914
25,25040,1999-12-31,4181,8497,12678
25,25040,2000-12-31,4098,8387,12485
25,25040,2001-12-31,4026,8304,12330
25,25040,2002-12-31,3966,8219,12185
25,25040,2003-12-31,3910,8148,12058
25,25040,2004-12-31,3858,8083,11941
25,25040,2005-12-31,3838,8038,11876
25,25040,2006-12-31,3805,8009,11814
25,25040,2007-12-31,3780,8011,11791
25,25040,2008-12-31,3784,8037,11821
25,25040,2009-12-31,3797,8088,11885
25,25040,2010-12-31,3860,8149,12009
25,25040,2011-12-31,3862,8236,12098
25,25040,2012-12-31,3891,8339,12230
25,25040,2013-12-31,3940,8477,12417
25,25040,2014-12-31,3976,8617,12593
25,25040,2015-12-31,4042,8765,12807
25,25040,2016-12-31,4106,8966,13072
25,25040,2017-12-31,4222,9202,13424
25,25040,2018-12-31,4327,9489,13816
25,25040,2019-12-31,4382,9779,14161
25,25040,2020-12-31,4493,10084,14577
25,25040,2021-12-31,5039,10117,15156
25,25040,2022-12-31,5494,10139,15633
25,25040,2023-12-31,5919,10158,16077
25,25040,2024-12-31,6145,10183,16328
25,25040,2025-12-31,6338,10194,16532
25,25040,2026-12-31,6527,10224,16751
25,25040,2027-12-31,6694,10256,16950
25,25040,2028-12-31,6837,10304,17141
25,25040,2029-12-31,6971,10330,17301
25,25040,2030-12-31,7091,10360,17451
25,25040,2031-12-31,7220,10396,17616
25,25040,2032-12-31,7325,10437,17762
25,25040,2033-12-31,7443,10462,17905
25,25040,2034-12-31,7545,10504,18049
25,25040,2035-12-31,7669,10553,18222
25,25053,1985-12-31,5162,25336,30498
25,25053,1986-12-31,4896,23963,28859
25,25053,1987-12-31,4666,22681,27347
25,25053,1988-12-31,4448,21465,25913
25,25053,1989-12-31,4229,20351,24580
25,25053,1990-12-31,4031,19261,23292
25,25053,1991-12-31,3918,18252,22170
25,25053,1992-12-31,3778,17299,21077
25,25053,1993-12-31,3665,16400,20065
25,25053,1994-12-31,3574,15633,19207
25,25053,1995-12-31,3507,14934,18441
25,25053,1996-12-31,3424,14262,17686
25,25053,1997-12-31,3355,13651,17006
25,25053,1998-12-31,3295,13196,16491
25,25053,1999-12-31,3251,12667,15918
25,25053,2000-12-31,3217,12161,15378
25,25053,2001-12-31,3242,11663,14905
25,25053,2002-12-31,3209,11223,14432
25,25053,2003-12-31,3209,10758,13967
25,25053,2004-12-31,3191,10374,13565
25,25053,2005-12-31,3217,10030,13247
25,25053,2006-12-31,3246,9631,12877
25,25053,2007-12-31,3249,9298,12547
25,25053,2008-12-31,3312,8988,12300
25,25053,2009-12-31,3364,8713,12077
25,25053,2010-12-31,3422,8427,11849
25,25053,2011-12-31,3487,8170,11657
25,25053,2012-12-31,3561,7908,11469
25,25053,2013-12-31,3653,7664,11317
25,25053,2014-12-31,3767,7432,11199
25,25053,2015-12-31,3868,7191,11059
25,25053,2016-12-31,3979,6965,10944
25,25053,2017-12-31,4130,6736,10866
25,25053,2018-12-31,4326,6534,10860
25,25053,2019-12-31,4526,6299,10825
25,25053,2020-12-31,4752,6207,10959
25,25053,2021-12-31,5168,6226,11394
25,25053,2022-12-31,5513,6240,11753
25,25053,2023-12-31,5836,6251,12087
25,25053,2024-12-31,6043,6267,12310
25,25053,2025-12-31,6229,6282,12511
25,25053,2026-12-31,6421,6303,12724
25,25053,2027-12-31,6580,6321,12901
25,25053,2028-12-31,6731,6343,13074
25,25053,2029-12-31,6857,6351,13208
25,25053,2030-12-31,6979,6384,13363
25,25053,2031-12-31,7092,6405,13497
25,25053,2032-12-31,7209,6440,13649
25,25053,2033-12-31,7321,6469,13790
25,25053,2034-12-31,7425,6475,13900
25,25053,2035-12-31,7547,6492,14039
25,25086,1985-12-31,365,2447,2812
25,25086,1986-12-31,336,2336,2672
25,25086,1987-12-31,308,2250,2558
25,25086,1988-12-31,275,2115,2390
25,25086,1989-12-31,305,2039,2344
25,25086,1990-12-31,303,1946,2249
25,25086,1991-12-31,294,1910,2204
25,25086,1992-12-31,336,1844,2180
25,25086,1993-12-31,273,1754,2027
25,25086,1994-12-31,238,1698,1936
25,25086,1995-12-31,249,1646,1895
25,25086,1996-12-31,249,1603,1852
25,25086,1997-12-31,227,1554,1781
25,25086,1998-12-31,244,1534,1778
25,25086,1999-12-31,252,1515,1767
25,25086,2000-12-31,228,1483,1711
25,25086,2001-12-31,254,1437,1691
25,25086,2002-12-31,256,1425,1681
25,25086,2003-12-31,266,1406,1672
25,25086,2004-12-31,280,1386,1666
25,25086,2005-12-31,268,1330,1598
25,25086,2006-12-31,248,1297,1545
25,25086,2007-12-31,232,1325,1557
25,25086,2008-12-31,257,1338,1595
25,25086,2009-12-31,275,1331,1606
25,25086,2010-12-31,277,1324,1601
25,25086,2011-12-31,296,1321,1617
25,25086,2012-12-31,295,1310,1605
25,25086,2013-12-31,322,1321,1643
25,25086,2014-12-31,332,1346,1678
25,25086,2015-12-31,341,1340,1681
25,25086,2016-12-31,348,1385,1733
25,25086,2017-12-31,352,1392,1744
25,25086,2018-12-31,362,1427,1789
25,25086,2019-12-31,380,1452,1832
25,25086,2020-12-31,399,1486,1885
25,25086,2021-12-31,469,1491,1960
25,25086,2022-12-31,528,1494,2022
25,25086,2023-12-31,582,1497,2079
25,25086,2024-12-31,601,1500,2101
25,25086,2025-12-31,619,1509,2128
25,25086,2026-12-31,637,1511,2148
25,25086,2027-12-31,658,1514,2172
25,25086,2028-12-31,674,1511,2185
25,25086,2029-12-31,687,1523,2210
25,25086,2030-12-31,706,1520,2226
25,25086,2031-12-31,715,1522,2237
25,25086,2032-12-31,721,1538,2259
25,25086,2033-12-31,737,1544,2281
25,25086,2034-12-31,752,1548,2300
25,25086,2035-12-31,760,1554,2314
25,25095,1985-12-31,786,3803,4589
25,25095,1986-12-31,735,3665,4400
25,25095,1987-12-31,644,3481,4125
25,25095,1988-12-31,621,3324,3945
25,25095,1989-12-31,598,3190,3788
25,25095,1990-12-31,617,3049,3666
25,25095,1991-12-31,612,2963,3575
25,25095,1992-12-31,565,2838,3403
25,25095,1993-12-31,502,2699,3201
25,25095,1994-12-31,461,2611,3072
25,25095,1995-12-31,443,2530,2973
25,25095,1996-12-31,436,2408,2844
25,25095,1997-12-31,435,2398,2833
25,25095,1998-12-31,404,2327,2731
25,25095,1999-12-31,397,2301,2698
25,25095,2000-12-31,423,2228,2651
25,25095,2001-12-31,404,2199,2603
25,25095,2002-12-31,340,2143,2483
25,25095,2003-12-31,346,2094,2440
25,25095,2004-12-31,370,2056,2426
25,25095,2005-12-31,367,2026,2393
25,25095,2006-12-31,349,1986,2335
25,25095,2007-12-31,343,1954,2297
25,25095,2008-12-31,394,1934,2328
25,25095,2009-12-31,337,1921,2258
25,25095,2010-12-31,339,1911,2250
25,25095,2011-12-31,342,1906,2248
25,25095,2012-12-31,396,1931,2327
25,25095,2013-12-31,443,1914,2357
25,25095,2014-12-31,400,1911,2311
25,25095,2015-12-31,460,1936,2396
25,25095,2016-12-31,420,1950,2370
25,25095,2017-12-31,418,2021,2439
25,25095,2018-12-31,451,2016,2467
25,25095,2019-12-31,460,2047,2507
25,25095,2020-12-31,474,2094,2568
25,25095,2021-12-31,569,2101,2670
25,25095,2022-12-31,649,2105,2754
25,25095,2023-12-31,723,2109,2832
25,25095,2024-12-31,746,2113,2859
25,25095,2025-12-31,784,2116,2900
25,25095,2026-12-31,800,2123,2923
25,25095,2027-12-31,815,2135,2950
25,25095,2028-12-31,838,2136,2974
25,25095,2029-12-31,852,2134,2986
25,25095,2030-12-31,867,2145,3012
25,25095,2031-12-31,887,2152,3039
25,25095,2032-12-31,888,2164,3052
25,25095,2033-12-31,908,2168,3076
25,25095,2034-12-31,930,2170,3100
25,25095,2035-12-31,934,2180,3114
25,25099,1985-12-31,2877,2844,5721
25,25099,1986-12-31,2909,2718,5627
25,25099,1987-12-31,2948,2637,5585
25,25099,1988-12-31,2993,2531,5524
25,25099,1989-12-31,3020,2404,5424
25,25099,1990-12-31,3038,2374,5412
25,25099,1991-12-31,3070,2310,5380
25,25099,1992-12-31,3103,2244,5347
25,25099,1993-12-31,3133,2203,5336
25,25099,1994-12-31,3192,2123,5315
25,25099,1995-12-31,3245,2075,5320
25,25099,1996-12-31,3326,2033,5359
25,25099,1997-12-31,3364,2001,5365
25,25099,1998-12-31,3437,2000,5437
25,25099,1999-12-31,3511,1954,5465
25,25099,2000-12-31,3611,1930,5541
25,25099,2001-12-31,3698,1900,5598
25,25099,2002-12-31,3819,1891,5710
25,25099,2003-12-31,3929,1883,5812
25,25099,2004-12-31,4073,1864,5937
25,25099,2005-12-31,4169,1870,6039
25,25099,2006-12-31,4326,1874,6200
25,25099,2007-12-31,4481,1875,6356
25,25099,2008-12-31,4650,1879,6529
25,25099,2009-12-31,4840,1891,6731
25,25099,2010-12-31,5077,1916,6993
25,25099,2011-12-31,5303,1930,7233
25,25099,2012-12-31,5560,1961,7521
25,25099,2013-12-31,5839,1992,7831
25,25099,2014-12-31,6142,2024,8166
25,25099,2015-12-31,6476,2057,8533
25,25099,2016-12-31,6808,2107,8915
25,25099,2017-12-31,7214,2179,9393
25,25099,2018-12-31,7680,2233,9913
25,25099,2019-12-31,8356,2168,10524
25,25099,2020-12-31,9019,2073,11092
25,25099,2021-12-31,9456,2079,11535
25,25099,2022-12-31,9814,2084,11898
25,25099,2023-12-31,10148,2088,12236
25,25099,2024-12-31,10485,2092,12577
25,25099,2025-12-31,10844,2096,12940
25,25099,2026-12-31,11123,2106,13229
25,25099,2027-12-31,11414,2106,13520
25,25099,2028-12-31,11681,2115,13796
25,25099,2029-12-31,11921,2126,14047
25,25099,2030-12-31,12151,2134,14285
25,25099,2031-12-31,12341,2142,14483
25,25099,2032-12-31,12555,2151,14706
25,25099,2033-12-31,12757,2154,14911
25,25099,2034-12-31,12932,2174,15106
25,25099,2035-12-31,13125,2172,15297
25,25120,1985-12-31,1691,4458,6149
25,25120,1986-12-31,1590,4299,5889
25,25120,1987-12-31,1482,4161,5643
25,25120,1988-12-31,1419,4034,5453
25,25120,1989-12-31,1350,3913,5263
25,25120,1990-12-31,1291,3760,5051
25,25120,1991-12-31,1242,3677,4919
25,25120,1992-12-31,1165,3584,4749
25,25120,1993-12-31,1104,3460,4564
25,25120,1994-12-31,1080,3382,4462
25,25120,1995-12-31,1043,3324,4367
25,25120,1996-12-31,1005,3246,4251
25,25120,1997-12-31,1009,3195,4204
25,25120,1998-12-31,976,3164,4140
25,25120,1999-12-31,975,3128,4103
25,25120,2000-12-31,949,3095,4044
25,25120,2001-12-31,934,3065,3999
25,25120,2002-12-31,918,3035,3953
25,25120,2003-12-31,936,3012,3948
25,25120,2004-12-31,899,3005,3904
25,25120,2005-12-31,905,2983,3888
25,25120,2006-12-31,903,2977,3880
25,25120,2007-12-31,926,2991,3917
25,25120,2008-12-31,925,2996,3921
25,25120,2009-12-31,929,3025,3954
25,25120,2010-12-31,942,3063,4005
25,25120,2011-12-31,950,3098,4048
25,25120,2012-12-31,965,3136,4101
25,25120,2013-12-31,1002,3214,4216
25,25120,2014-12-31,983,3256,4239
25,25120,2015-12-31,1002,3322,4324
25,25120,2016-12-31,1020,3407,4427
25,25120,2017-12-31,1090,3501,4591
25,25120,2018-12-31,1114,3608,4722
25,25120,2019-12-31,1146,3739,4885
25,25120,2020-12-31,1188,3874,5062
25,25120,2021-12-31,1376,3887,5263
25,25120,2022-12-31,1534,3895,5429
25,25120,2023-12-31,1681,3902,5583
25,25120,2024-12-31,1742,3913,5655
25,25120,2025-12-31,1800,3926,5726
25,25120,2026-12-31,1860,3929,5789
25,25120,2027-12-31,1905,3946,5851
25,25120,2028-12-31,1946,3964,5910
25,25120,2029-12-31,1990,3973,5963
25,25120,2030-12-31,2028,3999,6027
25,25120,2031-12-31,2065,4007,6072
25,25120,2032-12-31,2095,4019,6114
25,25120,2033-12-31,2129,4035,6164
25,25120,2034-12-31,2154,4060,6214
25,25120,2035-12-31,2187,4073,6260
25,25123,1985-12-31,4377,8497,12874
25,25123,1986-12-31,4152,8207,12359
25,25123,1987-12-31,3960,7888,11848
25,25123,1988-12-31,3805,7625,11430
25,25123,1989-12-31,3576,7364,10940
25,25123,1990-12-31,3405,7123,10528
25,25123,1991-12-31,3301,6903,10204
25,25123,1992-12-31,3174,6684,9858
25,25123,1993-12-31,3076,6490,9566
25,25123,1994-12-31,2991,6324,9315
25,25123,1995-12-31,2943,6181,9124
25,25123,1996-12-31,2860,6050,8910
25,25123,1997-12-31,2796,5905,8701
25,25123,1998-12-31,2745,5876,8621
25,25123,1999-12-31,2716,5791,8507
25,25123,2000-12-31,2685,5706,8391
25,25123,2001-12-31,2687,5641,8328
25,25123,2002-12-31,2653,5585,8238
25,25123,2003-12-31,2653,5530,8183
25,25123,2004-12-31,2661,5494,8155
25,25123,2005-12-31,2665,5462,8127
25,25123,2006-12-31,2671,5444,8115
25,25123,2007-12-31,2679,5447,8126
25,25123,2008-12-31,2718,5457,8175
25,25123,2009-12-31,2743,5494,8237
25,25123,2010-12-31,2799,5546,8345
25,25123,2011-12-31,2854,5592,8446
25,25123,2012-12-31,2915,5684,8599
25,25123,2013-12-31,3023,5754,8777
25,25123,2014-12-31,3070,5859,8929
25,25123,2015-12-31,3162,5968,9130
25,25123,2016-12-31,3238,6096,9334
25,25123,2017-12-31,3335,6241,9576
25,25123,2018-12-31,3511,6461,9972
25,25123,2019-12-31,3656,6668,10324
25,25123,2020-12-31,3829,6874,10703
25,25123,2021-12-31,4232,6896,11128
25,25123,2022-12-31,4567,6911,11478
25,25123,2023-12-31,4880,6924,11804
25,25123,2024-12-31,5069,6935,12004
25,25123,2025-12-31,5234,6949,12183
25,25123,2026-12-31,5365,6973,12338
25,25123,2027-12-31,5521,6980,12501
25,25123,2028-12-31,5639,7010,12649
25,25123,2029-12-31,5760,7028,12788
25,25123,2030-12-31,5851,7063,12914
25,25123,2031-12-31,5946,7090,13036
25,25123,2032-12-31,6039,7109,13148
25,25123,2033-12-31,6130,7140,13270
25,25123,2034-12-31,6220,7164,13384
25,25123,2035-12-31,6327,7190,13517
25,25126,1985-12-31,14951,16899,31850
25,25126,1986-12-31,15631,16830,32461
25,25126,1987-12-31,16249,16756,33005
25,25126,1988-12-31,16832,16693,33525
25,25126,1989-12-31,17338,16628,33966
25,25126,1990-12-31,17839,16549,34388
25,25126,1991-12-31,18328,16482,34810
25,25126,1992-12-31,18817,16418,35235
25,25126,1993-12-31,19294,16364,35658
25,25126,1994-12-31,19857,16404,36261
25,25126,1995-12-31,20438,16474,36912
25,25126,1996-12-31,21010,16529,37539
25,25126,1997-12-31,21690,16645,38335
25,25126,1998-12-31,22201,16922,39123
25,25126,1999-12-31,22924,17109,40033
25,25126,2000-12-31,23677,17298,40975
25,25126,2001-12-31,24456,17497,41953
25,25126,2002-12-31,25315,17731,43046
25,25126,2003-12-31,26217,17965,44182
25,25126,2004-12-31,27150,18244,45394
25,25126,2005-12-31,28132,18519,46651
25,25126,2006-12-31,29243,18872,48115
25,25126,2007-12-31,30464,19283,49747
25,25126,2008-12-31,31810,19743,51553
25,25126,2009-12-31,33297,20259,53556
25,25126,2010-12-31,34913,20847,55760
25,25126,2011-12-31,36657,21486,58143
25,25126,2012-12-31,38550,22179,60729
25,25126,2013-12-31,40587,22950,63537
25,25126,2014-12-31,42792,23773,66565
25,25126,2015-12-31,45193,24667,69860
25,25126,2016-12-31,47811,25679,73490
25,25126,2017-12-31,50724,26774,77498
25,25126,2018-12-31,54111,28133,82244
25,25126,2019-12-31,59228,28638,87866
25,25126,2020-12-31,64093,28874,92967
25,25126,2021-12-31,67711,28967,96678
25,25126,2022-12-31,70689,29031,99720
25,25126,2023-12-31,73468,29086,102554
25,25126,2024-12-31,76062,29169,105231
25,25126,2025-12-31,78456,29257,107713
25,25126,2026-12-31,80702,29324,110026
25,25126,2027-12-31,82776,29423,112199
25,25126,2028-12-31,84691,29531,114222
25,25126,2029-12-31,86422,29650,116072
25,25126,2030-12-31,87989,29759,117748
25,25126,2031-12-31,89466,29887,119353
25,25126,2032-12-31,90907,30011,120918
25,25126,2033-12-31,92329,30133,122462
25,25126,2034-12-31,93746,30241,123987
25,25126,2035-12-31,95120,30362,125482
25,25148,1985-12-31,4542,22292,26834
25,25148,1986-12-31,4292,21197,25489
25,25148,1987-12-31,4045,20191,24236
25,25148,1988-12-31,3845,19239,23084
25,25148,1989-12-31,3642,18364,22006
25,25148,1990-12-31,3477,17517,20994
25,25148,1991-12-31,3373,16751,20124
25,25148,1992-12-31,3189,15984,19173
25,25148,1993-12-31,3080,15287,18367
25,25148,1994-12-31,2977,14690,17667
25,25148,1995-12-31,2890,14156,17046
25,25148,1996-12-31,2825,13637,16462
25,25148,1997-12-31,2747,13177,15924
25,25148,1998-12-31,2666,12871,15537
25,25148,1999-12-31,2614,12475,15089
25,25148,2000-12-31,2590,12120,14710
25,25148,2001-12-31,2569,11763,14332
25,25148,2002-12-31,2529,11456,13985
25,25148,2003-12-31,2515,11154,13669
25,25148,2004-12-31,2514,10881,13395
25,25148,2005-12-31,2479,10645,13124
25,25148,2006-12-31,2492,10415,12907
25,25148,2007-12-31,2492,10222,12714
25,25148,2008-12-31,2511,10039,12550
25,25148,2009-12-31,2529,9899,12428
25,25148,2010-12-31,2571,9786,12357
25,25148,2011-12-31,2597,9684,12281
25,25148,2012-12-31,2647,9598,12245
25,25148,2013-12-31,2703,9533,12236
25,25148,2014-12-31,2761,9483,12244
25,25148,2015-12-31,2819,9442,12261
25,25148,2016-12-31,2885,9424,12309
25,25148,2017-12-31,2948,9410,12358
25,25148,2018-12-31,3083,9486,12569
25,25148,2019-12-31,3176,9538,12714
25,25148,2020-12-31,3289,9701,12990
25,25148,2021-12-31,3774,9732,13506
25,25148,2022-12-31,4177,9754,13931
25,25148,2023-12-31,4555,9772,14327
25,25148,2024-12-31,4759,9782,14541
25,25148,2025-12-31,4905,9799,14704
25,25148,2026-12-31,5029,9833,14862
25,25148,2027-12-31,5163,9858,15021
25,25148,2028-12-31,5281,9888,15169
25,25148,2029-12-31,5398,9921,15319
25,25148,2030-12-31,5486,9954,15440
25,25148,2031-12-31,5573,9989,15562
25,25148,2032-12-31,5673,10035,15708
25,25148,2033-12-31,5756,10070,15826
25,25148,2034-12-31,5843,10097,15940
25,25148,2035-12-31,5927,10129,16056
25,25151,1985-12-31,7786,17726,25512
25,25151,1986-12-31,7424,16941,24365
25,25151,1987-12-31,7089,16219,23308
25,25151,1988-12-31,6784,15502,22286
25,25151,1989-12-31,6545,14852,21397
25,25151,1990-12-31,6272,14250,20522
25,25151,1991-12-31,6064,13697,19761
25,25151,1992-12-31,5901,13112,19013
25,25151,1993-12-31,5729,12604,18333
25,25151,1994-12-31,5612,12169,17781
25,25151,1995-12-31,5520,11795,17315
25,25151,1996-12-31,5433,11431,16864
25,25151,1997-12-31,5362,11102,16464
25,25151,1998-12-31,5284,10901,16185
25,25151,1999-12-31,5251,10649,15900
25,25151,2000-12-31,5224,10414,15638
25,25151,2001-12-31,5217,10194,15411
25,25151,2002-12-31,5233,9978,15211
25,25151,2003-12-31,5246,9794,15040
25,25151,2004-12-31,5275,9615,14890
25,25151,2005-12-31,5308,9468,14776
25,25151,2006-12-31,5359,9338,14697
25,25151,2007-12-31,5437,9220,14657
25,25151,2008-12-31,5517,9145,14662
25,25151,2009-12-31,5632,9102,14734
25,25151,2010-12-31,5751,9068,14819
25,25151,2011-12-31,5924,9063,14987
25,25151,2012-12-31,6074,9061,15135
25,25151,2013-12-31,6254,9083,15337
25,25151,2014-12-31,6470,9129,15599
25,25151,2015-12-31,6669,9189,15858
25,25151,2016-12-31,6929,9290,16219
25,25151,2017-12-31,7205,9361,16566
25,25151,2018-12-31,7552,9547,17099
25,25151,2019-12-31,7927,9553,17480
25,25151,2020-12-31,8343,9613,17956
25,25151,2021-12-31,9027,9642,18669
25,25151,2022-12-31,9594,9663,19257
25,25151,2023-12-31,10122,9682,19804
25,25151,2024-12-31,10491,9702,20193
25,25151,2025-12-31,10814,9725,20539
25,25151,2026-12-31,11127,9756,20883
25,25151,2027-12-31,11418,9789,21207
25,25151,2028-12-31,11679,9810,21489
25,25151,2029-12-31,11912,9852,21764
25,25151,2030-12-31,12129,9890,22019
25,25151,2031-12-31,12327,9939,22266
25,25151,2032-12-31,12529,9960,22489
25,25151,2033-12-31,12730,9998,22728
25,25151,2034-12-31,12907,10051,22958
25,25151,2035-12-31,13099,10066,23165
25,25154,1985-12-31,1621,12124,13745
25,25154,1986-12-31,1547,11546,13093
25,25154,1987-12-31,1541,11023,12564
25,25154,1988-12-31,1414,10523,11937
25,25154,1989-12-31,1409,10058,11467
25,25154,1990-12-31,1383,9591,10974
25,25154,1991-12-31,1333,9138,10471
25,25154,1992-12-31,1292,8764,10056
25,25154,1993-12-31,1301,8378,9679
25,25154,1994-12-31,1283,8062,9345
25,25154,1995-12-31,1274,7785,9059
25,25154,1996-12-31,1250,7517,8767
25,25154,1997-12-31,1248,7261,8509
25,25154,1998-12-31,1242,7094,8336
25,25154,1999-12-31,1235,6904,8139
25,25154,2000-12-31,1263,6713,7976
25,25154,2001-12-31,1261,6530,7791
25,25154,2002-12-31,1280,6378,7658
25,25154,2003-12-31,1314,6243,7557
25,25154,2004-12-31,1322,6084,7406
25,25154,2005-12-31,1343,5952,7295
25,25154,2006-12-31,1367,5844,7211
25,25154,2007-12-31,1398,5733,7131
25,25154,2008-12-31,1421,5665,7086
25,25154,2009-12-31,1452,5599,7051
25,25154,2010-12-31,1501,5529,7030
25,25154,2011-12-31,1570,5491,7061
25,25154,2012-12-31,1604,5459,7063
25,25154,2013-12-31,1672,5426,7098
25,25154,2014-12-31,1727,5433,7160
25,25154,2015-12-31,1817,5410,7227
25,25154,2016-12-31,1896,5415,7311
25,25154,2017-12-31,1977,5453,7430
25,25154,2018-12-31,2093,5487,7580
25,25154,2019-12-31,2234,5499,7733
25,25154,2020-12-31,2376,5564,7940
25,25154,2021-12-31,2687,5568,8255
25,25154,2022-12-31,2944,5571,8515
25,25154,2023-12-31,3179,5578,8757
25,25154,2024-12-31,3303,5583,8886
25,25154,2025-12-31,3416,5586,9002
25,25154,2026-12-31,3509,5594,9103
25,25154,2027-12-31,3601,5604,9205
25,25154,2028-12-31,3684,5595,9279
25,25154,2029-12-31,3762,5626,9388
25,25154,2030-12-31,3833,5644,9477
25,25154,2031-12-31,3892,5652,9544
25,25154,2032-12-31,3952,5673,9625
25,25154,2033-12-31,4013,5683,9696
25,25154,2034-12-31,4082,5686,9768
25,25154,2035-12-31,4143,5713,9856
25,25168,1985-12-31,1318,6262,7580
25,25168,1986-12-31,1254,5980,7234
25,25168,1987-12-31,1204,5708,6912
25,25168,1988-12-31,1088,5469,6557
25,25168,1989-12-31,1073,5237,6310
25,25168,1990-12-31,1046,5035,6081
25,25168,1991-12-31,982,4809,5791
25,25168,1992-12-31,944,4613,5557
25,25168,1993-12-31,899,4419,5318
25,25168,1994-12-31,886,4271,5157
25,25168,1995-12-31,839,4126,4965
25,25168,1996-12-31,814,4007,4821
25,25168,1997-12-31,806,3885,4691
25,25168,1998-12-31,801,3812,4613
25,25168,1999-12-31,809,3696,4505
25,25168,2000-12-31,761,3599,4360
25,25168,2001-12-31,743,3519,4262
25,25168,2002-12-31,758,3458,4216
25,25168,2003-12-31,736,3386,4122
25,25168,2004-12-31,743,3318,4061
25,25168,2005-12-31,752,3259,4011
25,25168,2006-12-31,758,3198,3956
25,25168,2007-12-31,785,3168,3953
25,25168,2008-12-31,729,3143,3872
25,25168,2009-12-31,750,3124,3874
25,25168,2010-12-31,795,3101,3896
25,25168,2011-12-31,813,3092,3905
25,25168,2012-12-31,790,3089,3879
25,25168,2013-12-31,784,3088,3872
25,25168,2014-12-31,804,3112,3916
25,25168,2015-12-31,830,3117,3947
25,25168,2016-12-31,940,3135,4075
25,25168,2017-12-31,899,3162,4061
25,25168,2018-12-31,952,3230,4182
25,25168,2019-12-31,982,3273,4255
25,25168,2020-12-31,1022,3342,4364
25,25168,2021-12-31,1184,3353,4537
25,25168,2022-12-31,1320,3360,4680
25,25168,2023-12-31,1446,3367,4813
25,25168,2024-12-31,1502,3373,4875
25,25168,2025-12-31,1552,3385,4937
25,25168,2026-12-31,1595,3385,4980
25,25168,2027-12-31,1632,3404,5036
25,25168,2028-12-31,1666,3412,5078
25,25168,2029-12-31,1709,3418,5127
25,25168,2030-12-31,1739,3441,5180
25,25168,2031-12-31,1768,3436,5204
25,25168,2032-12-31,1795,3458,5253
25,25168,2033-12-31,1825,3468,5293
25,25168,2034-12-31,1858,3489,5347
25,25168,2035-12-31,1876,3486,5362
25,25175,1985-12-31,36446,19973,56419
25,25175,1986-12-31,37153,19663,56816
25,25175,1987-12-31,37820,19353,57173
25,25175,1988-12-31,38494,19063,57557
25,25175,1989-12-31,39086,18789,57875
25,25175,1990-12-31,39648,18535,58183
25,25175,1991-12-31,40264,18257,58521
25,25175,1992-12-31,40894,18042,58936
25,25175,1993-12-31,41508,17814,59322
25,25175,1994-12-31,42351,17711,60062
25,25175,1995-12-31,43270,17649,60919
25,25175,1996-12-31,44223,17591,61814
25,25175,1997-12-31,45284,17564,62848
25,25175,1998-12-31,46083,17752,63835
25,25175,1999-12-31,47313,17812,65125
25,25175,2000-12-31,48624,17886,66510
25,25175,2001-12-31,50034,17996,68030
25,25175,2002-12-31,51530,18116,69646
25,25175,2003-12-31,53131,18254,71385
25,25175,2004-12-31,54828,18424,73252
25,25175,2005-12-31,56642,18597,75239
25,25175,2006-12-31,58693,18855,77548
25,25175,2007-12-31,60943,19161,80104
25,25175,2008-12-31,63436,19515,82951
25,25175,2009-12-31,66184,19940,86124
25,25175,2010-12-31,69212,20427,89639
25,25175,2011-12-31,72500,20954,93454
25,25175,2012-12-31,76072,21545,97617
25,25175,2013-12-31,79923,22192,102115
25,25175,2014-12-31,84085,22896,106981
25,25175,2015-12-31,88592,23656,112248
25,25175,2016-12-31,93590,24529,118119
25,25175,2017-12-31,99101,25474,124575
25,25175,2018-12-31,105509,26672,132181
25,25175,2019-12-31,115066,26242,141308
25,25175,2020-12-31,124309,25261,149570
25,25175,2021-12-31,130203,25338,155541
25,25175,2022-12-31,135041,25394,160435
25,25175,2023-12-31,139554,25441,164995
25,25175,2024-12-31,144299,25527,169826
25,25175,2025-12-31,148761,25593,174354
25,25175,2026-12-31,152952,25658,178610
25,25175,2027-12-31,156866,25741,182607
25,25175,2028-12-31,160462,25843,186305
25,25175,2029-12-31,163732,25935,189667
25,25175,2030-12-31,166688,26026,192714
25,25175,2031-12-31,169451,26148,195599
25,25175,2032-12-31,172170,26239,198409
25,25175,2033-12-31,174850,26358,201208
25,25175,2034-12-31,177490,26449,203939
25,25175,2035-12-31,180071,26555,206626
25,25178,1985-12-31,2835,10459,13294
25,25178,1986-12-31,2706,10018,12724
25,25178,1987-12-31,2569,9622,12191
25,25178,1988-12-31,2440,9239,11679
25,25178,1989-12-31,2358,8897,11255
25,25178,1990-12-31,2294,8564,10858
25,25178,1991-12-31,2188,8256,10444
25,25178,1992-12-31,2117,7978,10095
25,25178,1993-12-31,2072,7687,9759
25,25178,1994-12-31,2028,7436,9464
25,25178,1995-12-31,1997,7263,9260
25,25178,1996-12-31,1950,7065,9015
25,25178,1997-12-31,1935,6894,8829
25,25178,1998-12-31,1906,6815,8721
25,25178,1999-12-31,1901,6690,8591
25,25178,2000-12-31,1901,6565,8466
25,25178,2001-12-31,1898,6454,8352
25,25178,2002-12-31,1881,6376,8257
25,25178,2003-12-31,1874,6285,8159
25,25178,2004-12-31,1900,6205,8105
25,25178,2005-12-31,1893,6138,8031
25,25178,2006-12-31,1911,6088,7999
25,25178,2007-12-31,1946,6066,8012
25,25178,2008-12-31,1979,6047,8026
25,25178,2009-12-31,2025,6055,8080
25,25178,2010-12-31,2067,6074,8141
25,25178,2011-12-31,2136,6103,8239
25,25178,2012-12-31,2174,6146,8320
25,25178,2013-12-31,2236,6209,8445
25,25178,2014-12-31,2311,6278,8589
25,25178,2015-12-31,2377,6372,8749
25,25178,2016-12-31,2475,6489,8964
25,25178,2017-12-31,2556,6614,9170
25,25178,2018-12-31,2697,6770,9467
25,25178,2019-12-31,2824,6924,9748
25,25178,2020-12-31,2966,7092,10058
25,25178,2021-12-31,3342,7115,10457
25,25178,2022-12-31,3655,7131,10786
25,25178,2023-12-31,3949,7144,11093
25,25178,2024-12-31,4109,7170,11279
25,25178,2025-12-31,4239,7183,11422
25,25178,2026-12-31,4365,7192,11557
25,25178,2027-12-31,4476,7215,11691
25,25178,2028-12-31,4577,7236,11813
25,25178,2029-12-31,4673,7264,11937
25,25178,2030-12-31,4745,7306,12051
25,25178,2031-12-31,4840,7329,12169
25,25178,2032-12-31,4906,7359,12265
25,25178,2033-12-31,4983,7389,12372
25,25178,2034-12-31,5051,7415,12466
25,25178,2035-12-31,5139,7440,12579
25,25181,1985-12-31,3961,13303,17264
25,25181,1986-12-31,3797,12702,16499
25,25181,1987-12-31,3623,12142,15765
25,25181,1988-12-31,3484,11624,15108
25,25181,1989-12-31,3353,11149,14502
25,25181,1990-12-31,3225,10631,13856
25,25181,1991-12-31,3145,10172,13317
25,25181,1992-12-31,3072,9758,12830
25,25181,1993-12-31,2991,9389,12380
25,25181,1994-12-31,2930,9054,11984
25,25181,1995-12-31,2885,8755,11640
25,25181,1996-12-31,2855,8471,11326
25,25181,1997-12-31,2825,8232,11057
25,25181,1998-12-31,2786,8067,10853
25,25181,1999-12-31,2788,7879,10667
25,25181,2000-12-31,2769,7676,10445
25,25181,2001-12-31,2792,7488,10280
25,25181,2002-12-31,2789,7329,10118
25,25181,2003-12-31,2806,7185,9991
25,25181,2004-12-31,2816,7040,9856
25,25181,2005-12-31,2850,6911,9761
25,25181,2006-12-31,2887,6800,9687
25,25181,2007-12-31,2927,6716,9643
25,25181,2008-12-31,2986,6652,9638
25,25181,2009-12-31,3050,6602,9652
25,25181,2010-12-31,3127,6574,9701
25,25181,2011-12-31,3211,6557,9768
25,25181,2012-12-31,3315,6544,9859
25,25181,2013-12-31,3409,6536,9945
25,25181,2014-12-31,3532,6557,10089
25,25181,2015-12-31,3644,6586,10230
25,25181,2016-12-31,3798,6632,10430
25,25181,2017-12-31,3963,6708,10671
25,25181,2018-12-31,4160,6801,10961
25,25181,2019-12-31,4358,6855,11213
25,25181,2020-12-31,4577,6951,11528
25,25181,2021-12-31,5013,6973,11986
25,25181,2022-12-31,5374,6989,12363
25,25181,2023-12-31,5712,7002,12714
25,25181,2024-12-31,5926,7014,12940
25,25181,2025-12-31,6114,7031,13145
25,25181,2026-12-31,6283,7054,13337
25,25181,2027-12-31,6449,7087,13536
25,25181,2028-12-31,6594,7101,13695
25,25181,2029-12-31,6728,7130,13858
25,25181,2030-12-31,6849,7144,13993
25,25181,2031-12-31,6961,7177,14138
25,25181,2032-12-31,7077,7210,14287
25,25181,2033-12-31,7182,7226,14408
25,25181,2034-12-31,7292,7264,14556
25,25181,2035-12-31,7392,7294,14686
25,25183,1985-12-31,7019,15995,23014
25,25183,1986-12-31,6825,15331,22156
25,25183,1987-12-31,6660,14715,21375
25,25183,1988-12-31,6472,14127,20599
25,25183,1989-12-31,6360,13576,19936
25,25183,1990-12-31,6197,13064,19261
25,25183,1991-12-31,6113,12573,18686
25,25183,1992-12-31,6033,12127,18160
25,25183,1993-12-31,5951,11692,17643
25,25183,1994-12-31,5919,11343,17262
25,25183,1995-12-31,5904,11058,16962
25,25183,1996-12-31,5902,10742,16644
25,25183,1997-12-31,5912,10488,16400
25,25183,1998-12-31,5913,10333,16246
25,25183,1999-12-31,5943,10133,16076
25,25183,2000-12-31,6005,9946,15951
25,25183,2001-12-31,6081,9773,15854
25,25183,2002-12-31,6159,9623,15782
25,25183,2003-12-31,6254,9487,15741
25,25183,2004-12-31,6362,9359,15721
25,25183,2005-12-31,6474,9246,15720
25,25183,2006-12-31,6620,9168,15788
25,25183,2007-12-31,6790,9108,15898
25,25183,2008-12-31,6997,9071,16068
25,25183,2009-12-31,7220,9068,16288
25,25183,2010-12-31,7472,9090,16562
25,25183,2011-12-31,7731,9135,16866
25,25183,2012-12-31,8024,9184,17208
25,25183,2013-12-31,8369,9262,17631
25,25183,2014-12-31,8715,9356,18071
25,25183,2015-12-31,9085,9459,18544
25,25183,2016-12-31,9514,9584,19098
25,25183,2017-12-31,9979,9776,19755
25,25183,2018-12-31,10554,10014,20568
25,25183,2019-12-31,11431,9994,21425
25,25183,2020-12-31,12281,9997,22278
25,25183,2021-12-31,13136,10027,23163
25,25183,2022-12-31,13843,10049,23892
25,25183,2023-12-31,14503,10068,24571
25,25183,2024-12-31,15059,10091,25150
25,25183,2025-12-31,15556,10109,25665
25,25183,2026-12-31,16023,10130,26153
25,25183,2027-12-31,16423,10164,26587
25,25183,2028-12-31,16809,10208,27017
25,25183,2029-12-31,17159,10230,27389
25,25183,2030-12-31,17491,10283,27774
25,25183,2031-12-31,17771,10326,28097
25,25183,2032-12-31,18052,10374,28426
25,25183,2033-12-31,18345,10414,28759
25,25183,2034-12-31,18606,10436,29042
25,25183,2035-12-31,18877,10475,29352
25,25200,1985-12-31,4245,13572,17817
25,25200,1986-12-31,4186,13222,17408
25,25200,1987-12-31,4146,12882,17028
25,25200,1988-12-31,4064,12592,16656
25,25200,1989-12-31,3992,12299,16291
25,25200,1990-12-31,3934,11996,15930
25,25200,1991-12-31,3915,11729,15644
25,25200,1992-12-31,3908,11496,15404
25,25200,1993-12-31,3874,11273,15147
25,25200,1994-12-31,3880,11121,15001
25,25200,1995-12-31,3883,10976,14859
25,25200,1996-12-31,3929,10855,14784
25,25200,1997-12-31,3949,10773,14722
25,25200,1998-12-31,3954,10792,14746
25,25200,1999-12-31,4016,10746,14762
25,25200,2000-12-31,4073,10708,14781
25,25200,2001-12-31,4153,10701,14854
25,25200,2002-12-31,4227,10702,14929
25,25200,2003-12-31,4309,10727,15036
25,25200,2004-12-31,4400,10757,15157
25,25200,2005-12-31,4498,10785,15283
25,25200,2006-12-31,4630,10868,15498
25,25200,2007-12-31,4755,10967,15722
25,25200,2008-12-31,4904,11105,16009
25,25200,2009-12-31,5093,11277,16370
25,25200,2010-12-31,5272,11497,16769
25,25200,2011-12-31,5508,11728,17236
25,25200,2012-12-31,5721,12001,17722
25,25200,2013-12-31,5962,12298,18260
25,25200,2014-12-31,6223,12595,18818
25,25200,2015-12-31,6521,12970,19491
25,25200,2016-12-31,6848,13377,20225
25,25200,2017-12-31,7205,13833,21038
25,25200,2018-12-31,7653,14414,22067
25,25200,2019-12-31,8300,14986,23286
25,25200,2020-12-31,8928,15506,24434
25,25200,2021-12-31,9848,15556,25404
25,25200,2022-12-31,10614,15590,26204
25,25200,2023-12-31,11328,15620,26948
25,25200,2024-12-31,11806,15644,27450
25,25200,2025-12-31,12207,15678,27885
25,25200,2026-12-31,12546,15723,28269
25,25200,2027-12-31,12882,15780,28662
25,25200,2028-12-31,13174,15834,29008
25,25200,2029-12-31,13447,15891,29338
25,25200,2030-12-31,13674,15947,29621
25,25200,2031-12-31,13906,16007,29913
25,25200,2032-12-31,14137,16076,30213
25,25200,2033-12-31,14351,16135,30486
25,25200,2034-12-31,14578,16204,30782
25,25200,2035-12-31,14786,16269,31055
25,25214,1985-12-31,4851,7675,12526
25,25214,1986-12-31,5185,7620,12805
25,25214,1987-12-31,5509,7574,13083
25,25214,1988-12-31,5759,7520,13279
25,25214,1989-12-31,6010,7483,13493
25,25214,1990-12-31,6214,7423,13637
25,25214,1991-12-31,6448,7397,13845
25,25214,1992-12-31,6660,7358,14018
25,25214,1993-12-31,6865,7291,14156
25,25214,1994-12-31,7071,7313,14384
25,25214,1995-12-31,7335,7334,14669
25,25214,1996-12-31,7614,7346,14960
25,25214,1997-12-31,7896,7385,15281
25,25214,1998-12-31,8098,7492,15590
25,25214,1999-12-31,8382,7574,15956
25,25214,2000-12-31,8691,7641,16332
25,25214,2001-12-31,9008,7709,16717
25,25214,2002-12-31,9350,7805,17155
25,25214,2003-12-31,9701,7916,17617
25,25214,2004-12-31,10065,8018,18083
25,25214,2005-12-31,10457,8129,18586
25,25214,2006-12-31,10888,8282,19170
25,25214,2007-12-31,11359,8447,19806
25,25214,2008-12-31,11881,8648,20529
25,25214,2009-12-31,12454,8870,21324
25,25214,2010-12-31,13080,9113,22193
25,25214,2011-12-31,13750,9380,23130
25,25214,2012-12-31,14474,9672,24146
25,25214,2013-12-31,15271,10012,25283
25,25214,2014-12-31,16112,10362,26474
25,25214,2015-12-31,17036,10750,27786
25,25214,2016-12-31,18048,11173,29221
25,25214,2017-12-31,19157,11659,30816
25,25214,2018-12-31,20462,12229,32691
25,25214,2019-12-31,22496,12452,34948
25,25214,2020-12-31,24413,12579,36992
25,25214,2021-12-31,25849,12620,38469
25,25214,2022-12-31,27031,12648,39679
25,25214,2023-12-31,28136,12671,40807
25,25214,2024-12-31,29155,12687,41842
25,25214,2025-12-31,30090,12730,42820
25,25214,2026-12-31,30977,12766,43743
25,25214,2027-12-31,31788,12794,44582
25,25214,2028-12-31,32524,12837,45361
25,25214,2029-12-31,33209,12889,46098
25,25214,2030-12-31,33816,12949,46765
25,25214,2031-12-31,34374,13008,47382
25,25214,2032-12-31,34941,13035,47976
25,25214,2033-12-31,35490,13102,48592
25,25214,2034-12-31,36029,13150,49179
25,25214,2035-12-31,36561,13192,49753
25,25224,1985-12-31,1239,7410,8649
25,25224,1986-12-31,1215,7174,8389
25,25224,1987-12-31,1135,6947,8082
25,25224,1988-12-31,1080,6720,7800
25,25224,1989-12-31,1034,6523,7557
25,25224,1990-12-31,1017,6360,7377
25,25224,1991-12-31,940,6179,7119
25,25224,1992-12-31,923,6021,6944
25,25224,1993-12-31,912,5841,6753
25,25224,1994-12-31,877,5736,6613
25,25224,1995-12-31,857,5632,6489
25,25224,1996-12-31,853,5533,6386
25,25224,1997-12-31,839,5429,6268
25,25224,1998-12-31,793,5420,6213
25,25224,1999-12-31,821,5375,6196
25,25224,2000-12-31,815,5336,6151
25,25224,2001-12-31,789,5300,6089
25,25224,2002-12-31,795,5265,6060
25,25224,2003-12-31,794,5244,6038
25,25224,2004-12-31,795,5211,6006
25,25224,2005-12-31,826,5208,6034
25,25224,2006-12-31,813,5216,6029
25,25224,2007-12-31,829,5258,6087
25,25224,2008-12-31,850,5281,6131
25,25224,2009-12-31,865,5346,6211
25,25224,2010-12-31,883,5413,6296
25,25224,2011-12-31,904,5476,6380
25,25224,2012-12-31,917,5576,6493
25,25224,2013-12-31,942,5688,6630
25,25224,2014-12-31,975,5786,6761
25,25224,2015-12-31,995,5936,6931
25,25224,2016-12-31,1036,6093,7129
25,25224,2017-12-31,1076,6273,7349
25,25224,2018-12-31,1131,6495,7626
25,25224,2019-12-31,1189,6746,7935
25,25224,2020-12-31,1253,7004,8257
25,25224,2021-12-31,1558,7027,8585
25,25224,2022-12-31,1813,7042,8855
25,25224,2023-12-31,2052,7055,9107
25,25224,2024-12-31,2154,7068,9222
25,25224,2025-12-31,2228,7087,9315
25,25224,2026-12-31,2284,7104,9388
25,25224,2027-12-31,2341,7133,9474
25,25224,2028-12-31,2409,7164,9573
25,25224,2029-12-31,2449,7197,9646
25,25224,2030-12-31,2494,7228,9722
25,25224,2031-12-31,2544,7246,9790
25,25224,2032-12-31,2587,7274,9861
25,25224,2033-12-31,2613,7300,9913
25,25224,2034-12-31,2650,7332,9982
25,25224,2035-12-31,2699,7359,10058
25,25245,1985-12-31,7717,14105,21822
25,25245,1986-12-31,7450,13683,21133
25,25245,1987-12-31,7222,13289,20511
25,25245,1988-12-31,7023,12941,19964
25,25245,1989-12-31,6827,12601,19428
25,25245,1990-12-31,6677,12281,18958
25,25245,1991-12-31,6453,11996,18449
25,25245,1992-12-31,6339,11706,18045
25,25245,1993-12-31,6249,11425,17674
25,25245,1994-12-31,6181,11222,17403
25,25245,1995-12-31,6149,11035,17184
25,25245,1996-12-31,6127,10899,17026
25,25245,1997-12-31,6116,10735,16851
25,25245,1998-12-31,6064,10737,16801
25,25245,1999-12-31,6111,10637,16748
25,25245,2000-12-31,6151,10568,16719
25,25245,2001-12-31,6196,10521,16717
25,25245,2002-12-31,6263,10506,16769
25,25245,2003-12-31,6343,10477,16820
25,25245,2004-12-31,6425,10491,16916
25,25245,2005-12-31,6526,10513,17039
25,25245,2006-12-31,6651,10551,17202
25,25245,2007-12-31,6792,10631,17423
25,25245,2008-12-31,6969,10733,17702
25,25245,2009-12-31,7167,10872,18039
25,25245,2010-12-31,7380,11047,18427
25,25245,2011-12-31,7628,11256,18884
25,25245,2012-12-31,7888,11463,19351
25,25245,2013-12-31,8195,11724,19919
25,25245,2014-12-31,8530,12021,20551
25,25245,2015-12-31,8878,12334,21212
25,25245,2016-12-31,9278,12690,21968
25,25245,2017-12-31,9712,13120,22832
25,25245,2018-12-31,10251,13635,23886
25,25245,2019-12-31,10916,14131,25047
25,25245,2020-12-31,11602,14574,26176
25,25245,2021-12-31,12595,14621,27216
25,25245,2022-12-31,13419,14653,28072
25,25245,2023-12-31,14189,14681,28870
25,25245,2024-12-31,14701,14703,29404
25,25245,2025-12-31,15163,14739,29902
25,25245,2026-12-31,15596,14770,30366
25,25245,2027-12-31,15987,14805,30792
25,25245,2028-12-31,16343,14857,31200
25,25245,2029-12-31,16684,14914,31598
25,25245,2030-12-31,16979,14952,31931
25,25245,2031-12-31,17265,15008,32273
25,25245,2032-12-31,17539,15065,32604
25,25245,2033-12-31,17814,15115,32929
25,25245,2034-12-31,18082,15169,33251
25,25245,2035-12-31,18350,15208,33558
25,25258,1985-12-31,613,9328,9941
25,25258,1986-12-31,629,8886,9515
25,25258,1987-12-31,566,8454,9020
25,25258,1988-12-31,548,8107,8655
25,25258,1989-12-31,544,7678,8222
25,25258,1990-12-31,560,7341,7901
25,25258,1991-12-31,542,7015,7557
25,25258,1992-12-31,509,6729,7238
25,25258,1993-12-31,501,6444,6945
25,25258,1994-12-31,450,6159,6609
25,25258,1995-12-31,462,5954,6416
25,25258,1996-12-31,445,5741,6186
25,25258,1997-12-31,478,5528,6006
25,25258,1998-12-31,413,5416,5829
25,25258,1999-12-31,477,5257,5734
25,25258,2000-12-31,424,5115,5539
25,25258,2001-12-31,391,4971,5362
25,25258,2002-12-31,381,4823,5204
25,25258,2003-12-31,387,4713,5100
25,25258,2004-12-31,393,4605,4998
25,25258,2005-12-31,403,4510,4913
25,25258,2006-12-31,390,4417,4807
25,25258,2007-12-31,399,4343,4742
25,25258,2008-12-31,405,4265,4670
25,25258,2009-12-31,417,4210,4627
25,25258,2010-12-31,441,4173,4614
25,25258,2011-12-31,453,4136,4589
25,25258,2012-12-31,460,4113,4573
25,25258,2013-12-31,465,4090,4555
25,25258,2014-12-31,493,4065,4558
25,25258,2015-12-31,508,4053,4561
25,25258,2016-12-31,522,4068,4590
25,25258,2017-12-31,546,4046,4592
25,25258,2018-12-31,577,4104,4681
25,25258,2019-12-31,597,4113,4710
25,25258,2020-12-31,622,4167,4789
25,25258,2021-12-31,800,4179,4979
25,25258,2022-12-31,951,4185,5136
25,25258,2023-12-31,1093,4189,5282
25,25258,2024-12-31,1140,4196,5336
25,25258,2025-12-31,1186,4191,5377
25,25258,2026-12-31,1229,4194,5423
25,25258,2027-12-31,1253,4194,5447
25,25258,2028-12-31,1276,4180,5456
25,25258,2029-12-31,1306,4177,5483
25,25258,2030-12-31,1327,4187,5514
25,25258,2031-12-31,1352,4173,5525
25,25258,2032-12-31,1367,4162,5529
25,25258,2033-12-31,1398,4125,5523
25,25258,2034-12-31,1413,4089,5502
25,25258,2035-12-31,1438,4065,5503
25,25260,1985-12-31,0,0,0
25,25260,1986-12-31,0,0,0
25,25260,1987-12-31,0,0,0
25,25260,1988-12-31,0,0,0
25,25260,1989-12-31,0,0,0
25,25260,1990-12-31,0,0,0
25,25260,1991-12-31,0,0,0
25,25260,1992-12-31,0,0,0
25,25260,1993-12-31,0,0,0
25,25260,1994-12-31,0,0,0
25,25260,1995-12-31,0,0,0
25,25260,1996-12-31,0,0,0
25,25260,1997-12-31,0,0,0
25,25260,1998-12-31,7705,5262,12967
25,25260,1999-12-31,7953,5073,13026
25,25260,2000-12-31,8227,4908,13135
25,25260,2001-12-31,8509,4736,13245
25,25260,2002-12-31,8816,4575,13391
25,25260,2003-12-31,9129,4437,13566
25,25260,2004-12-31,9465,4288,13753
25,25260,2005-12-31,9803,4106,13909
25,25260,2006-12-31,10193,4008,14201
25,25260,2007-12-31,10630,3896,14526
25,25260,2008-12-31,11112,3799,14911
25,25260,2009-12-31,11630,3734,15364
25,25260,2010-12-31,12198,3601,15799
25,25260,2011-12-31,12822,3541,16363
25,25260,2012-12-31,13477,3477,16954
25,25260,2013-12-31,14208,3392,17600
25,25260,2014-12-31,14978,3347,18325
25,25260,2015-12-31,15815,3261,19076
25,25260,2016-12-31,16737,3226,19963
25,25260,2017-12-31,17759,3115,20874
25,25260,2018-12-31,18958,3107,22065
25,25260,2019-12-31,20701,2716,23417
25,25260,2020-12-31,22485,2283,24768
25,25260,2021-12-31,23467,2290,25757
25,25260,2022-12-31,24272,2295,26567
25,25260,2023-12-31,25023,2299,27322
25,25260,2024-12-31,25881,2300,28181
25,25260,2025-12-31,26686,2311,28997
25,25260,2026-12-31,27443,2323,29766
25,25260,2027-12-31,28163,2326,30489
25,25260,2028-12-31,28827,2329,31156
25,25260,2029-12-31,29412,2340,31752
25,25260,2030-12-31,29952,2356,32308
25,25260,2031-12-31,30447,2352,32799
25,25260,2032-12-31,30946,2370,33316
25,25260,2033-12-31,31428,2376,33804
25,25260,2034-12-31,31919,2382,34301
25,25260,2035-12-31,32373,2394,34767
25,25269,1985-12-31,68217,11266,79483
25,25269,1986-12-31,67008,11040,78048
25,25269,1987-12-31,65987,10868,76855
25,25269,1988-12-31,65145,10649,75794
25,25269,1989-12-31,64384,10468,74852
25,25269,1990-12-31,63734,10284,74018
25,25269,1991-12-31,63264,10120,73384
25,25269,1992-12-31,62903,10003,72906
25,25269,1993-12-31,62607,9844,72451
25,25269,1994-12-31,62753,9763,72516
25,25269,1995-12-31,63058,9701,72759
25,25269,1996-12-31,63448,9637,73085
25,25269,1997-12-31,64040,9609,73649
25,25269,1998-12-31,64298,9696,73994
25,25269,1999-12-31,65180,9705,74885
25,25269,2000-12-31,66179,9746,75925
25,25269,2001-12-31,67325,9791,77116
25,25269,2002-12-31,68622,9840,78462
25,25269,2003-12-31,70038,9893,79931
25,25269,2004-12-31,71595,9968,81563
25,25269,2005-12-31,73247,10043,83290
25,25269,2006-12-31,75264,10153,85417
25,25269,2007-12-31,77540,10309,87849
25,25269,2008-12-31,80087,10481,90568
25,25269,2009-12-31,82959,10691,93650
25,25269,2010-12-31,86148,10932,97080
25,25269,2011-12-31,89640,11185,100825
25,25269,2012-12-31,93431,11493,104924
25,25269,2013-12-31,97573,11808,109381
25,25269,2014-12-31,102055,12163,114218
25,25269,2015-12-31,106917,12552,119469
25,25269,2016-12-31,112326,13000,125326
25,25269,2017-12-31,118332,13493,131825
25,25269,2018-12-31,125348,14093,139441
25,25269,2019-12-31,135306,12695,148001
25,25269,2020-12-31,145080,10898,155978
25,25269,2021-12-31,151274,10931,162205
25,25269,2022-12-31,156354,10955,167309
25,25269,2023-12-31,161088,10976,172064
25,25269,2024-12-31,166401,11002,177403
25,25269,2025-12-31,171565,11030,182595
25,25269,2026-12-31,176420,11069,187489
25,25269,2027-12-31,180956,11111,192067
25,25269,2028-12-31,185142,11150,196292
25,25269,2029-12-31,188957,11188,200145
25,25269,2030-12-31,192375,11235,203610
25,25269,2031-12-31,195579,11290,206869
25,25269,2032-12-31,198743,11325,210068
25,25269,2033-12-31,201870,11382,213252
25,25269,2034-12-31,204923,11414,216337
25,25269,2035-12-31,207949,11460,219409
25,25279,1985-12-31,3857,13258,17115
25,25279,1986-12-31,3738,12648,16386
25,25279,1987-12-31,3625,12094,15719
25,25279,1988-12-31,3532,11569,15101
25,25279,1989-12-31,3411,11077,14488
25,25279,1990-12-31,3317,10612,13929
25,25279,1991-12-31,3280,10159,13439
25,25279,1992-12-31,3191,9736,12927
25,25279,1993-12-31,3145,9349,12494
25,25279,1994-12-31,3129,9016,12145
25,25279,1995-12-31,3109,8721,11830
25,25279,1996-12-31,3083,8448,11531
25,25279,1997-12-31,3073,8191,11264
25,25279,1998-12-31,3065,8041,11106
25,25279,1999-12-31,3069,7823,10892
25,25279,2000-12-31,3102,7649,10751
25,25279,2001-12-31,3135,7459,10594
25,25279,2002-12-31,3155,7317,10472
25,25279,2003-12-31,3196,7147,10343
25,25279,2004-12-31,3253,7014,10267
25,25279,2005-12-31,3280,6895,10175
25,25279,2006-12-31,3344,6789,10133
25,25279,2007-12-31,3430,6706,10136
25,25279,2008-12-31,3518,6623,10141
25,25279,2009-12-31,3638,6582,10220
25,25279,2010-12-31,3742,6550,10292
25,25279,2011-12-31,3874,6532,10406
25,25279,2012-12-31,4011,6523,10534
25,25279,2013-12-31,4158,6519,10677
25,25279,2014-12-31,4309,6543,10852
25,25279,2015-12-31,4499,6573,11072
25,25279,2016-12-31,4706,6619,11325
25,25279,2017-12-31,4928,6705,11633
25,25279,2018-12-31,5203,6783,11986
25,25279,2019-12-31,5555,6812,12367
25,25279,2020-12-31,5904,6899,12803
25,25279,2021-12-31,6390,6921,13311
25,25279,2022-12-31,6793,6937,13730
25,25279,2023-12-31,7171,6950,14121
25,25279,2024-12-31,7439,6962,14401
25,25279,2025-12-31,7668,6980,14648
25,25279,2026-12-31,7890,6997,14887
25,25279,2027-12-31,8094,7012,15106
25,25279,2028-12-31,8273,7024,15297
25,25279,2029-12-31,8443,7066,15509
25,25279,2030-12-31,8600,7088,15688
25,25279,2031-12-31,8738,7124,15862
25,25279,2032-12-31,8875,7152,16027
25,25279,2033-12-31,9018,7169,16187
25,25279,2034-12-31,9151,7211,16362
25,25279,2035-12-31,9294,7219,16513
25,25281,1985-12-31,1717,8613,10330
25,25281,1986-12-31,1628,8223,9851
25,25281,1987-12-31,1520,7863,9383
25,25281,1988-12-31,1478,7474,8952
25,25281,1989-12-31,1398,7185,8583
25,25281,1990-12-31,1344,6888,8232
25,25281,1991-12-31,1275,6599,7874
25,25281,1992-12-31,1229,6329,7558
25,25281,1993-12-31,1177,6090,7267
25,25281,1994-12-31,1135,5866,7001
25,25281,1995-12-31,1125,5649,6774
25,25281,1996-12-31,1097,5485,6582
25,25281,1997-12-31,1104,5328,6432
25,25281,1998-12-31,1058,5228,6286
25,25281,1999-12-31,1041,5099,6140
25,25281,2000-12-31,1050,4974,6024
25,25281,2001-12-31,1042,4840,5882
25,25281,2002-12-31,1043,4769,5812
25,25281,2003-12-31,1015,4654,5669
25,25281,2004-12-31,1013,4575,5588
25,25281,2005-12-31,1027,4491,5518
25,25281,2006-12-31,1039,4429,5468
25,25281,2007-12-31,1054,4357,5411
25,25281,2008-12-31,1051,4309,5360
25,25281,2009-12-31,1098,4283,5381
25,25281,2010-12-31,1103,4274,5377
25,25281,2011-12-31,1110,4254,5364
25,25281,2012-12-31,1122,4249,5371
25,25281,2013-12-31,1157,4258,5415
25,25281,2014-12-31,1185,4255,5440
25,25281,2015-12-31,1211,4279,5490
25,25281,2016-12-31,1250,4300,5550
25,25281,2017-12-31,1303,4348,5651
25,25281,2018-12-31,1367,4417,5784
25,25281,2019-12-31,1428,4464,5892
25,25281,2020-12-31,1496,4542,6038
25,25281,2021-12-31,1721,4557,6278
25,25281,2022-12-31,1908,4567,6475
25,25281,2023-12-31,2084,4575,6659
25,25281,2024-12-31,2171,4578,6749
25,25281,2025-12-31,2239,4597,6836
25,25281,2026-12-31,2301,4614,6915
25,25281,2027-12-31,2367,4615,6982
25,25281,2028-12-31,2424,4646,7070
25,25281,2029-12-31,2461,4663,7124
25,25281,2030-12-31,2499,4655,7154
25,25281,2031-12-31,2557,4681,7238
25,25281,2032-12-31,2587,4702,7289
25,25281,2033-12-31,2639,4728,7367
25,25281,2034-12-31,2668,4744,7412
25,25281,2035-12-31,2715,4762,7477
25,25286,1985-12-31,37687,4291,41978
25,25286,1986-12-31,37761,4141,41902
25,25286,1987-12-31,37888,3950,41838
25,25286,1988-12-31,38043,3777,41820
25,25286,1989-12-31,38166,3632,41798
25,25286,1990-12-31,38322,3480,41802
25,25286,1991-12-31,38538,3365,41903
25,25286,1992-12-31,38803,3248,42051
25,25286,1993-12-31,39059,3115,42174
25,25286,1994-12-31,39564,3037,42601
25,25286,1995-12-31,40166,2931,43097
25,25286,1996-12-31,40796,2861,43657
25,25286,1997-12-31,41519,2772,44291
25,25286,1998-12-31,42035,2741,44776
25,25286,1999-12-31,42940,2681,45621
25,25286,2000-12-31,43930,2631,46561
25,25286,2001-12-31,45008,2579,47587
25,25286,2002-12-31,46168,2530,48698
25,25286,2003-12-31,47421,2495,49916
25,25286,2004-12-31,48760,2457,51217
25,25286,2005-12-31,50179,2419,52598
25,25286,2006-12-31,51838,2384,54222
25,25286,2007-12-31,53684,2366,56050
25,25286,2008-12-31,55712,2357,58069
25,25286,2009-12-31,57988,2348,60336
25,25286,2010-12-31,60480,2308,62788
25,25286,2011-12-31,63200,2324,65524
25,25286,2012-12-31,66146,2339,68485
25,25286,2013-12-31,69345,2340,71685
25,25286,2014-12-31,72818,2335,75153
25,25286,2015-12-31,76543,2367,78910
25,25286,2016-12-31,80721,2418,83139
25,25286,2017-12-31,85305,2422,87727
25,25286,2018-12-31,90671,2483,93154
25,25286,2019-12-31,97203,2184,99387
25,25286,2020-12-31,103270,1816,105086
25,25286,2021-12-31,107459,1822,109281
25,25286,2022-12-31,110894,1826,112720
25,25286,2023-12-31,114094,1829,115923
25,25286,2024-12-31,117605,1833,119438
25,25286,2025-12-31,121112,1840,122952
25,25286,2026-12-31,124489,1843,126332
25,25286,2027-12-31,127655,1848,129503
25,25286,2028-12-31,130592,1853,132445
25,25286,2029-12-31,133283,1857,135140
25,25286,2030-12-31,135693,1868,137561
25,25286,2031-12-31,137961,1877,139838
25,25286,2032-12-31,140182,1887,142069
25,25286,2033-12-31,142375,1889,144264
25,25286,2034-12-31,144540,1896,146436
25,25286,2035-12-31,146690,1912,148602
25,25288,1985-12-31,298,6995,7293
25,25288,1986-12-31,255,6725,6980
25,25288,1987-12-31,233,6460,6693
25,25288,1988-12-31,226,6203,6429
25,25288,1989-12-31,204,5985,6189
25,25288,1990-12-31,283,5772,6055
25,25288,1991-12-31,187,5564,5751
25,25288,1992-12-31,266,5374,5640
25,25288,1993-12-31,242,5190,5432
25,25288,1994-12-31,162,5049,5211
25,25288,1995-12-31,174,4925,5099
25,25288,1996-12-31,173,4794,4967
25,25288,1997-12-31,171,4672,4843
25,25288,1998-12-31,168,4638,4806
25,25288,1999-12-31,206,4551,4757
25,25288,2000-12-31,182,4483,4665
25,25288,2001-12-31,166,4421,4587
25,25288,2002-12-31,194,4360,4554
25,25288,2003-12-31,197,4311,4508
25,25288,2004-12-31,204,4257,4461
25,25288,2005-12-31,206,4205,4411
25,25288,2006-12-31,164,4187,4351
25,25288,2007-12-31,175,4183,4358
25,25288,2008-12-31,181,4177,4358
25,25288,2009-12-31,177,4185,4362
25,25288,2010-12-31,177,4203,4380
25,25288,2011-12-31,172,4239,4411
25,25288,2012-12-31,160,4269,4429
25,25288,2013-12-31,164,4324,4488
25,25288,2014-12-31,163,4367,4530
25,25288,2015-12-31,165,4449,4614
25,25288,2016-12-31,165,4509,4674
25,25288,2017-12-31,167,4603,4770
25,25288,2018-12-31,168,4736,4904
25,25288,2019-12-31,172,4875,5047
25,25288,2020-12-31,179,5032,5211
25,25288,2021-12-31,370,5048,5418
25,25288,2022-12-31,529,5059,5588
25,25288,2023-12-31,678,5069,5747
25,25288,2024-12-31,717,5086,5803
25,25288,2025-12-31,755,5096,5851
25,25288,2026-12-31,774,5108,5882
25,25288,2027-12-31,785,5128,5913
25,25288,2028-12-31,809,5145,5954
25,25288,2029-12-31,831,5163,5994
25,25288,2030-12-31,843,5173,6016
25,25288,2031-12-31,862,5199,6061
25,25288,2032-12-31,871,5222,6093
25,25288,2033-12-31,888,5231,6119
25,25288,2034-12-31,895,5253,6148
25,25288,2035-12-31,911,5265,6176
25,25290,1985-12-31,63137,24117,87254
25,25290,1986-12-31,61946,23427,85373
25,25290,1987-12-31,60949,22776,83725
25,25290,1988-12-31,60159,22174,82333
25,25290,1989-12-31,59406,21601,81007
25,25290,1990-12-31,58777,21063,79840
25,25290,1991-12-31,58305,20583,78888
25,25290,1992-12-31,57961,20057,78018
25,25290,1993-12-31,57687,19620,77307
25,25290,1994-12-31,57790,19295,77085
25,25290,1995-12-31,58042,19019,77061
25,25290,1996-12-31,58374,18749,77123
25,25290,1997-12-31,58903,18548,77451
25,25290,1998-12-31,59117,18555,77672
25,25290,1999-12-31,59909,18428,78337
25,25290,2000-12-31,60835,18344,79179
25,25290,2001-12-31,61870,18280,80150
25,25290,2002-12-31,63038,18240,81278
25,25290,2003-12-31,64335,18217,82552
25,25290,2004-12-31,65752,18237,83989
25,25290,2005-12-31,67372,18262,85634
25,25290,2006-12-31,69162,18354,87516
25,25290,2007-12-31,71184,18505,89689
25,25290,2008-12-31,73486,18694,92180
25,25290,2009-12-31,76079,18938,95017
25,25290,2010-12-31,78977,19249,98226
25,25290,2011-12-31,82132,19601,101733
25,25290,2012-12-31,85597,19995,105592
25,25290,2013-12-31,89356,20452,109808
25,25290,2014-12-31,93461,20948,114409
25,25290,2015-12-31,97906,21503,119409
25,25290,2016-12-31,102856,22154,125010
25,25290,2017-12-31,108345,22869,131214
25,25290,2018-12-31,114722,23776,138498
25,25290,2019-12-31,123754,22802,146556
25,25290,2020-12-31,132633,21510,154143
25,25290,2021-12-31,138721,21575,160296
25,25290,2022-12-31,143717,21623,165340
25,25290,2023-12-31,148375,21664,170039
25,25290,2024-12-31,153251,21713,174964
25,25290,2025-12-31,157955,21759,179714
25,25290,2026-12-31,162353,21810,184163
25,25290,2027-12-31,166482,21885,188367
25,25290,2028-12-31,170263,21962,192225
25,25290,2029-12-31,173699,22023,195722
25,25290,2030-12-31,176796,22107,198903
25,25290,2031-12-31,179667,22183,201850
25,25290,2032-12-31,182529,22270,204799
25,25290,2033-12-31,185310,22370,207680
25,25290,2034-12-31,188079,22448,210527
25,25290,2035-12-31,190793,22507,213300
25,25293,1985-12-31,3765,9150,12915
25,25293,1986-12-31,3527,8679,12206
25,25293,1987-12-31,3285,8216,11501
25,25293,1988-12-31,3085,7788,10873
25,25293,1989-12-31,2893,7404,10297
25,25293,1990-12-31,2730,7034,9764
25,25293,1991-12-31,2587,6687,9274
25,25293,1992-12-31,2470,6365,8835
25,25293,1993-12-31,2320,6050,8370
25,25293,1994-12-31,2238,5789,8027
25,25293,1995-12-31,2142,5540,7682
25,25293,1996-12-31,2056,5281,7337
25,25293,1997-12-31,1987,5063,7050
25,25293,1998-12-31,1900,4921,6821
25,25293,1999-12-31,1835,4738,6573
25,25293,2000-12-31,1789,4570,6359
25,25293,2001-12-31,1747,4410,6157
25,25293,2002-12-31,1709,4272,5981
25,25293,2003-12-31,1666,4123,5789
25,25293,2004-12-31,1642,3993,5635
25,25293,2005-12-31,1611,3855,5466
25,25293,2006-12-31,1581,3748,5329
25,25293,2007-12-31,1538,3633,5171
25,25293,2008-12-31,1578,3543,5121
25,25293,2009-12-31,1565,3454,5019
25,25293,2010-12-31,1506,3366,4872
25,25293,2011-12-31,1527,3306,4833
25,25293,2012-12-31,1509,3241,4750
25,25293,2013-12-31,1479,3173,4652
25,25293,2014-12-31,1485,3106,4591
25,25293,2015-12-31,1509,3040,4549
25,25293,2016-12-31,1513,2989,4502
25,25293,2017-12-31,1529,2903,4432
25,25293,2018-12-31,1546,2890,4436
25,25293,2019-12-31,1542,2844,4386
25,25293,2020-12-31,1560,2845,4405
25,25293,2021-12-31,1726,2854,4580
25,25293,2022-12-31,1864,2860,4724
25,25293,2023-12-31,1993,2865,4858
25,25293,2024-12-31,2056,2865,4921
25,25293,2025-12-31,2122,2875,4997
25,25293,2026-12-31,2181,2885,5066
25,25293,2027-12-31,2242,2902,5144
25,25293,2028-12-31,2291,2894,5185
25,25293,2029-12-31,2333,2912,5245
25,25293,2030-12-31,2381,2919,5300
25,25293,2031-12-31,2418,2933,5351
25,25293,2032-12-31,2456,2944,5400
25,25293,2033-12-31,2496,2950,5446
25,25293,2034-12-31,2536,2957,5493
25,25293,2035-12-31,2569,2959,5528
25,25295,1985-12-31,1763,3652,5415
25,25295,1986-12-31,2008,3584,5592
25,25295,1987-12-31,2236,3563,5799
25,25295,1988-12-31,2421,3560,5981
25,25295,1989-12-31,2619,3541,6160
25,25295,1990-12-31,2820,3487,6307
25,25295,1991-12-31,2968,3501,6469
25,25295,1992-12-31,3097,3495,6592
25,25295,1993-12-31,3307,3487,6794
25,25295,1994-12-31,3453,3457,6910
25,25295,1995-12-31,3618,3475,7093
25,25295,1996-12-31,3774,3483,7257
25,25295,1997-12-31,3944,3515,7459
25,25295,1998-12-31,4083,3557,7640
25,25295,1999-12-31,4269,3573,7842
25,25295,2000-12-31,4435,3608,8043
25,25295,2001-12-31,4651,3677,8328
25,25295,2002-12-31,4840,3672,8512
25,25295,2003-12-31,5100,3740,8840
25,25295,2004-12-31,5314,3770,9084
25,25295,2005-12-31,5523,3816,9339
25,25295,2006-12-31,5783,3891,9674
25,25295,2007-12-31,6046,3990,10036
25,25295,2008-12-31,6345,4087,10432
25,25295,2009-12-31,6685,4192,10877
25,25295,2010-12-31,7051,4311,11362
25,25295,2011-12-31,7420,4446,11866
25,25295,2012-12-31,7852,4574,12426
25,25295,2013-12-31,8305,4728,13033
25,25295,2014-12-31,8782,4897,13679
25,25295,2015-12-31,9302,5091,14393
25,25295,2016-12-31,9887,5260,15147
25,25295,2017-12-31,10501,5511,16012
25,25295,2018-12-31,11252,5774,17026
25,25295,2019-12-31,12451,5813,18264
25,25295,2020-12-31,13570,5806,19376
25,25295,2021-12-31,14326,5824,20150
25,25295,2022-12-31,14948,5836,20784
25,25295,2023-12-31,15527,5847,21374
25,25295,2024-12-31,16072,5873,21945
25,25295,2025-12-31,16564,5878,22442
25,25295,2026-12-31,17050,5900,22950
25,25295,2027-12-31,17475,5916,23391
25,25295,2028-12-31,17901,5947,23848
25,25295,2029-12-31,18265,5962,24227
25,25295,2030-12-31,18590,5990,24580
25,25295,2031-12-31,18916,6022,24938
25,25295,2032-12-31,19215,6039,25254
25,25295,2033-12-31,19523,6062,25585
25,25295,2034-12-31,19831,6092,25923
25,25295,2035-12-31,20125,6115,26240
25,25297,1985-12-31,4674,15354,20028
25,25297,1986-12-31,4421,14564,18985
25,25297,1987-12-31,4189,13817,18006
25,25297,1988-12-31,3950,13115,17065
25,25297,1989-12-31,3759,12462,16221
25,25297,1990-12-31,3585,11864,15449
25,25297,1991-12-31,3458,11331,14789
25,25297,1992-12-31,3330,10700,14030
25,25297,1993-12-31,3209,10185,13394
25,25297,1994-12-31,3123,9727,12850
25,25297,1995-12-31,3029,9334,12363
25,25297,1996-12-31,2944,8935,11879
25,25297,1997-12-31,2888,8581,11469
25,25297,1998-12-31,2819,8339,11158
25,25297,1999-12-31,2788,8027,10815
25,25297,2000-12-31,2742,7747,10489
25,25297,2001-12-31,2721,7479,10200
25,25297,2002-12-31,2697,7241,9938
25,25297,2003-12-31,2678,7014,9692
25,25297,2004-12-31,2675,6784,9459
25,25297,2005-12-31,2661,6573,9234
25,25297,2006-12-31,2683,6383,9066
25,25297,2007-12-31,2680,6196,8876
25,25297,2008-12-31,2701,6056,8757
25,25297,2009-12-31,2732,5913,8645
25,25297,2010-12-31,2758,5784,8542
25,25297,2011-12-31,2830,5661,8491
25,25297,2012-12-31,2867,5551,8418
25,25297,2013-12-31,2925,5443,8368
25,25297,2014-12-31,2991,5330,8321
25,25297,2015-12-31,3080,5256,8336
25,25297,2016-12-31,3138,5158,8296
25,25297,2017-12-31,3238,5096,8334
25,25297,2018-12-31,3388,5037,8425
25,25297,2019-12-31,3489,4950,8439
25,25297,2020-12-31,3624,4915,8539
25,25297,2021-12-31,3948,4930,8878
25,25297,2022-12-31,4216,4941,9157
25,25297,2023-12-31,4468,4950,9418
25,25297,2024-12-31,4626,4962,9588
25,25297,2025-12-31,4765,4960,9725
25,25297,2026-12-31,4899,4982,9881
25,25297,2027-12-31,5023,4991,10014
25,25297,2028-12-31,5133,4997,10130
25,25297,2029-12-31,5255,5028,10283
25,25297,2030-12-31,5349,5047,10396
25,25297,2031-12-31,5439,5053,10492
25,25297,2032-12-31,5517,5084,10601
25,25297,2033-12-31,5604,5086,10690
25,25297,2034-12-31,5678,5113,10791
25,25297,2035-12-31,5758,5136,10894
25,25299,1985-12-31,700,5875,6575
25,25299,1986-12-31,705,5593,6298
25,25299,1987-12-31,618,5328,5946
25,25299,1988-12-31,573,5095,5668
25,25299,1989-12-31,599,4841,5440
25,25299,1990-12-31,617,4625,5242
25,25299,1991-12-31,597,4395,4992
25,25299,1992-12-31,564,4189,4753
25,25299,1993-12-31,524,4023,4547
25,25299,1994-12-31,481,3855,4336
25,25299,1995-12-31,475,3697,4172
25,25299,1996-12-31,477,3566,4043
25,25299,1997-12-31,478,3434,3912
25,25299,1998-12-31,472,3367,3839
25,25299,1999-12-31,478,3245,3723
25,25299,2000-12-31,476,3160,3636
25,25299,2001-12-31,491,3069,3560
25,25299,2002-12-31,509,2977,3486
25,25299,2003-12-31,507,2888,3395
25,25299,2004-12-31,479,2816,3295
25,25299,2005-12-31,471,2744,3215
25,25299,2006-12-31,493,2700,3193
25,25299,2007-12-31,530,2654,3184
25,25299,2008-12-31,541,2587,3128
25,25299,2009-12-31,545,2554,3099
25,25299,2010-12-31,553,2503,3056
25,25299,2011-12-31,551,2488,3039
25,25299,2012-12-31,573,2449,3022
25,25299,2013-12-31,583,2450,3033
25,25299,2014-12-31,601,2435,3036
25,25299,2015-12-31,634,2410,3044
25,25299,2016-12-31,652,2390,3042
25,25299,2017-12-31,675,2433,3108
25,25299,2018-12-31,710,2410,3120
25,25299,2019-12-31,748,2404,3152
25,25299,2020-12-31,789,2425,3214
25,25299,2021-12-31,914,2428,3342
25,25299,2022-12-31,1014,2433,3447
25,25299,2023-12-31,1107,2438,3545
25,25299,2024-12-31,1151,2440,3591
25,25299,2025-12-31,1191,2446,3637
25,25299,2026-12-31,1223,2445,3668
25,25299,2027-12-31,1257,2459,3716
25,25299,2028-12-31,1287,2469,3756
25,25299,2029-12-31,1313,2473,3786
25,25299,2030-12-31,1329,2475,3804
25,25299,2031-12-31,1358,2495,3853
25,25299,2032-12-31,1374,2506,3880
25,25299,2033-12-31,1396,2515,3911
25,25299,2034-12-31,1414,2513,3927
25,25299,2035-12-31,1437,2521,3958
25,25307,1985-12-31,103271,5687,108958
25,25307,1986-12-31,98058,5525,103583
25,25307,1987-12-31,93552,5384,98936
25,25307,1988-12-31,89586,5218,94804
25,25307,1989-12-31,85948,5093,91041
25,25307,1990-12-31,82716,4966,87682
25,25307,1991-12-31,79867,4855,84722
25,25307,1992-12-31,77382,4739,82121
25,25307,1993-12-31,75093,4632,79725
25,25307,1994-12-31,73412,4543,77955
25,25307,1995-12-31,72028,4482,76510
25,25307,1996-12-31,70799,4417,75216
25,25307,1997-12-31,69866,4399,74265
25,25307,1998-12-31,68633,4370,73003
25,25307,1999-12-31,68105,4331,72436
25,25307,2000-12-31,67753,4320,72073
25,25307,2001-12-31,67553,4308,71861
25,25307,2002-12-31,67519,4304,71823
25,25307,2003-12-31,67612,4281,71893
25,25307,2004-12-31,67850,4288,72138
25,25307,2005-12-31,68278,4287,72565
25,25307,2006-12-31,68884,4309,73193
25,25307,2007-12-31,69709,4347,74056
25,25307,2008-12-31,70785,4396,75181
25,25307,2009-12-31,72101,4460,76561
25,25307,2010-12-31,73669,4546,78215
25,25307,2011-12-31,75451,4601,80052
25,25307,2012-12-31,77444,4704,82148
25,25307,2013-12-31,79666,4824,84490
25,25307,2014-12-31,82132,4931,87063
25,25307,2015-12-31,84824,5063,89887
25,25307,2016-12-31,87860,5212,93072
25,25307,2017-12-31,91313,5381,96694
25,25307,2018-12-31,95427,5591,101018
25,25307,2019-12-31,100376,5003,105379
25,25307,2020-12-31,105896,3896,109792
25,25307,2021-12-31,110244,3908,114152
25,25307,2022-12-31,113828,3916,117744
25,25307,2023-12-31,117166,3924,121090
25,25307,2024-12-31,120472,3939,124411
25,25307,2025-12-31,123674,3947,127621
25,25307,2026-12-31,126734,3955,130689
25,25307,2027-12-31,129642,3969,133611
25,25307,2028-12-31,132354,3986,136340
25,25307,2029-12-31,134835,4003,138838
25,25307,2030-12-31,137098,4016,141114
25,25307,2031-12-31,139221,4021,143242
25,25307,2032-12-31,141362,4031,145393
25,25307,2033-12-31,143485,4061,147546
25,25307,2034-12-31,145575,4075,149650
25,25307,2035-12-31,147661,4094,151755
25,25312,1985-12-31,0,0,0
25,25312,1986-12-31,0,0,0
25,25312,1987-12-31,0,0,0
25,25312,1988-12-31,0,0,0
25,25312,1989-12-31,0,0,0
25,25312,1990-12-31,0,0,0
25,25312,1991-12-31,0,0,0
25,25312,1992-12-31,0,0,0
25,25312,1993-12-31,0,0,0
25,25312,1994-12-31,0,0,0
25,25312,1995-12-31,0,0,0
25,25312,1996-12-31,927,3488,4415
25,25312,1997-12-31,931,3490,4421
25,25312,1998-12-31,932,3534,4466
25,25312,1999-12-31,967,3535,4502
25,25312,2000-12-31,991,3555,4546
25,25312,2001-12-31,981,3596,4577
25,25312,2002-12-31,972,3614,4586
25,25312,2003-12-31,1003,3648,4651
25,25312,2004-12-31,1021,3685,4706
25,25312,2005-12-31,1056,3718,4774
25,25312,2006-12-31,1092,3749,4841
25,25312,2007-12-31,1139,3822,4961
25,25312,2008-12-31,1169,3877,5046
25,25312,2009-12-31,1232,3972,5204
25,25312,2010-12-31,1280,4069,5349
25,25312,2011-12-31,1337,4169,5506
25,25312,2012-12-31,1362,4288,5650
25,25312,2013-12-31,1440,4416,5856
25,25312,2014-12-31,1490,4571,6061
25,25312,2015-12-31,1564,4716,6280
25,25312,2016-12-31,1650,4885,6535
25,25312,2017-12-31,1712,5134,6846
25,25312,2018-12-31,1840,5339,7179
25,25312,2019-12-31,1992,5574,7566
25,25312,2020-12-31,2140,5791,7931
25,25312,2021-12-31,2436,5810,8246
25,25312,2022-12-31,2682,5823,8505
25,25312,2023-12-31,2913,5834,8747
25,25312,2024-12-31,3044,5841,8885
25,25312,2025-12-31,3145,5862,9007
25,25312,2026-12-31,3236,5884,9120
25,25312,2027-12-31,3320,5898,9218
25,25312,2028-12-31,3395,5908,9303
25,25312,2029-12-31,3467,5946,9413
25,25312,2030-12-31,3526,5971,9497
25,25312,2031-12-31,3582,5986,9568
25,25312,2032-12-31,3637,6020,9657
25,25312,2033-12-31,3698,6034,9732
25,25312,2034-12-31,3760,6050,9810
25,25312,2035-12-31,3813,6077,9890
25,25317,1985-12-31,3950,13090,17040
25,25317,1986-12-31,3856,12516,16372
25,25317,1987-12-31,3756,11987,15743
25,25317,1988-12-31,3613,11501,15114
25,25317,1989-12-31,3554,10988,14542
25,25317,1990-12-31,3505,10539,14044
25,25317,1991-12-31,3429,10125,13554
25,25317,1992-12-31,3391,9743,13134
25,25317,1993-12-31,3347,9380,12727
25,25317,1994-12-31,3330,9071,12401
25,25317,1995-12-31,3318,8783,12101
25,25317,1996-12-31,3305,8536,11841
25,25317,1997-12-31,3322,8286,11608
25,25317,1998-12-31,3321,8169,11490
25,25317,1999-12-31,3333,7984,11317
25,25317,2000-12-31,3361,7809,11170
25,25317,2001-12-31,3411,7654,11065
25,25317,2002-12-31,3453,7505,10958
25,25317,2003-12-31,3515,7373,10888
25,25317,2004-12-31,3566,7263,10829
25,25317,2005-12-31,3639,7147,10786
25,25317,2006-12-31,3726,7052,10778
25,25317,2007-12-31,3821,6981,10802
25,25317,2008-12-31,3929,6940,10869
25,25317,2009-12-31,4047,6917,10964
25,25317,2010-12-31,4199,6902,11101
25,25317,2011-12-31,4349,6907,11256
25,25317,2012-12-31,4503,6926,11429
25,25317,2013-12-31,4697,6942,11639
25,25317,2014-12-31,4885,6975,11860
25,25317,2015-12-31,5106,7033,12139
25,25317,2016-12-31,5338,7109,12447
25,25317,2017-12-31,5608,7211,12819
25,25317,2018-12-31,5928,7357,13285
25,25317,2019-12-31,6232,7517,13749
25,25317,2020-12-31,6519,7722,14241
25,25317,2021-12-31,7060,7747,14807
25,25317,2022-12-31,7508,7764,15272
25,25317,2023-12-31,7927,7779,15706
25,25317,2024-12-31,8216,7791,16007
25,25317,2025-12-31,8484,7819,16303
25,25317,2026-12-31,8719,7840,16559
25,25317,2027-12-31,8947,7860,16807
25,25317,2028-12-31,9149,7882,17031
25,25317,2029-12-31,9335,7908,17243
25,25317,2030-12-31,9504,7943,17447
25,25317,2031-12-31,9664,7974,17638
25,25317,2032-12-31,9834,8008,17842
25,25317,2033-12-31,9978,8034,18012
25,25317,2034-12-31,10134,8078,18212
25,25317,2035-12-31,10279,8095,18374
25,25320,1985-12-31,9178,22278,31456
25,25320,1986-12-31,8915,21454,30369
25,25320,1987-12-31,8676,20692,29368
25,25320,1988-12-31,8482,19972,28454
25,25320,1989-12-31,8302,19307,27609
25,25320,1990-12-31,8102,18666,26768
25,25320,1991-12-31,7966,18099,26065
25,25320,1992-12-31,7866,17506,25372
25,25320,1993-12-31,7746,16973,24719
25,25320,1994-12-31,7701,16549,24250
25,25320,1995-12-31,7677,16167,23844
25,25320,1996-12-31,7646,15829,23475
25,25320,1997-12-31,7717,15517,23234
25,25320,1998-12-31,7646,15392,23038
25,25320,1999-12-31,7729,15176,22905
25,25320,2000-12-31,7802,14950,22752
25,25320,2001-12-31,7891,14790,22681
25,25320,2002-12-31,7996,14630,22626
25,25320,2003-12-31,8120,14507,22627
25,25320,2004-12-31,8247,14407,22654
25,25320,2005-12-31,8410,14319,22729
25,25320,2006-12-31,8593,14281,22874
25,25320,2007-12-31,8791,14280,23071
25,25320,2008-12-31,9046,14325,23371
25,25320,2009-12-31,9327,14414,23741
25,25320,2010-12-31,9642,14514,24156
25,25320,2011-12-31,9987,14692,24679
25,25320,2012-12-31,10372,14891,25263
25,25320,2013-12-31,10785,15104,25889
25,25320,2014-12-31,11232,15357,26589
25,25320,2015-12-31,11727,15643,27370
25,25320,2016-12-31,12285,15989,28274
25,25320,2017-12-31,12884,16389,29273
25,25320,2018-12-31,13614,16910,30524
25,25320,2019-12-31,14755,17114,31869
25,25320,2020-12-31,15862,17350,33212
25,25320,2021-12-31,17125,17406,34531
25,25320,2022-12-31,18173,17444,35617
25,25320,2023-12-31,19153,17477,36630
25,25320,2024-12-31,19907,17517,37424
25,25320,2025-12-31,20568,17563,38131
25,25320,2026-12-31,21175,17613,38788
25,25320,2027-12-31,21697,17666,39363
25,25320,2028-12-31,22196,17743,39939
25,25320,2029-12-31,22664,17800,40464
25,25320,2030-12-31,23067,17874,40941
25,25320,2031-12-31,23429,17943,41372
25,25320,2032-12-31,23809,18008,41817
25,25320,2033-12-31,24181,18094,42275
25,25320,2034-12-31,24534,18148,42682
25,25320,2035-12-31,24895,18216,43111
25,25322,1985-12-31,2576,15432,18008
25,25322,1986-12-31,2576,14765,17341
25,25322,1987-12-31,2592,14143,16735
25,25322,1988-12-31,2613,13572,16185
25,25322,1989-12-31,2583,13029,15612
25,25322,1990-12-31,2600,12520,15120
25,25322,1991-12-31,2607,12023,14630
25,25322,1992-12-31,2648,11594,14242
25,25322,1993-12-31,2657,11189,13846
25,25322,1994-12-31,2688,10839,13527
25,25322,1995-12-31,2723,10529,13252
25,25322,1996-12-31,2765,10238,13003
25,25322,1997-12-31,2815,9988,12803
25,25322,1998-12-31,2861,9815,12676
25,25322,1999-12-31,2904,9615,12519
25,25322,2000-12-31,2966,9417,12383
25,25322,2001-12-31,3054,9245,12299
25,25322,2002-12-31,3128,9086,12214
25,25322,2003-12-31,3212,8945,12157
25,25322,2004-12-31,3315,8817,12132
25,25322,2005-12-31,3399,8690,12089
25,25322,2006-12-31,3506,8608,12114
25,25322,2007-12-31,3613,8536,12149
25,25322,2008-12-31,3771,8490,12261
25,25322,2009-12-31,3911,8499,12410
25,25322,2010-12-31,4073,8484,12557
25,25322,2011-12-31,4264,8502,12766
25,25322,2012-12-31,4463,8543,13006
25,25322,2013-12-31,4677,8601,13278
25,25322,2014-12-31,4914,8688,13602
25,25322,2015-12-31,5168,8770,13938
25,25322,2016-12-31,5445,8868,14313
25,25322,2017-12-31,5758,9041,14799
25,25322,2018-12-31,6121,9227,15348
25,25322,2019-12-31,6646,9520,16166
25,25322,2020-12-31,7153,9781,16934
25,25322,2021-12-31,7794,9813,17607
25,25322,2022-12-31,8326,9834,18160
25,25322,2023-12-31,8824,9853,18677
25,25322,2024-12-31,9193,9874,19067
25,25322,2025-12-31,9499,9895,19394
25,25322,2026-12-31,9775,9922,19697
25,25322,2027-12-31,10033,9960,19993
25,25322,2028-12-31,10276,10003,20279
25,25322,2029-12-31,10461,10028,20489
25,25322,2030-12-31,10659,10053,20712
25,25322,2031-12-31,10842,10106,20948
25,25322,2032-12-31,11016,10144,21160
25,25322,2033-12-31,11191,10185,21376
25,25322,2034-12-31,11357,10228,21585
25,25322,2035-12-31,11522,10284,21806
25,25324,1985-12-31,1934,2051,3985
25,25324,1986-12-31,1791,1987,3778
25,25324,1987-12-31,1739,1880,3619
25,25324,1988-12-31,1596,1837,3433
25,25324,1989-12-31,1524,1759,3283
25,25324,1990-12-31,1457,1685,3142
25,25324,1991-12-31,1371,1659,3030
25,25324,1992-12-31,1297,1642,2939
25,25324,1993-12-31,1269,1575,2844
25,25324,1994-12-31,1237,1532,2769
25,25324,1995-12-31,1195,1491,2686
25,25324,1996-12-31,1150,1495,2645
25,25324,1997-12-31,1098,1476,2574
25,25324,1998-12-31,1117,1463,2580
25,25324,1999-12-31,1047,1443,2490
25,25324,2000-12-31,1022,1432,2454
25,25324,2001-12-31,1043,1408,2451
25,25324,2002-12-31,1012,1387,2399
25,25324,2003-12-31,1003,1369,2372
25,25324,2004-12-31,1011,1348,2359
25,25324,2005-12-31,1028,1394,2422
25,25324,2006-12-31,1004,1356,2360
25,25324,2007-12-31,1011,1371,2382
25,25324,2008-12-31,1023,1371,2394
25,25324,2009-12-31,987,1386,2373
25,25324,2010-12-31,1044,1372,2416
25,25324,2011-12-31,1034,1424,2458
25,25324,2012-12-31,1064,1419,2483
25,25324,2013-12-31,1061,1457,2518
25,25324,2014-12-31,1048,1468,2516
25,25324,2015-12-31,1071,1499,2570
25,25324,2016-12-31,1111,1543,2654
25,25324,2017-12-31,1172,1590,2762
25,25324,2018-12-31,1204,1644,2848
25,25324,2019-12-31,1234,1577,2811
25,25324,2020-12-31,1279,1493,2772
25,25324,2021-12-31,1384,1498,2882
25,25324,2022-12-31,1472,1501,2973
25,25324,2023-12-31,1553,1504,3057
25,25324,2024-12-31,1603,1497,3100
25,25324,2025-12-31,1650,1509,3159
25,25324,2026-12-31,1690,1521,3211
25,25324,2027-12-31,1736,1518,3254
25,25324,2028-12-31,1779,1523,3302
25,25324,2029-12-31,1814,1522,3336
25,25324,2030-12-31,1847,1523,3370
25,25324,2031-12-31,1872,1543,3415
25,25324,2032-12-31,1911,1545,3456
25,25324,2033-12-31,1937,1553,3490
25,25324,2034-12-31,1980,1565,3545
25,25324,2035-12-31,1997,1554,3551
25,25326,1985-12-31,1712,6168,7880
25,25326,1986-12-31,1677,5923,7600
25,25326,1987-12-31,1602,5684,7286
25,25326,1988-12-31,1553,5463,7016
25,25326,1989-12-31,1466,5259,6725
25,25326,1990-12-31,1442,5100,6542
25,25326,1991-12-31,1433,4904,6337
25,25326,1992-12-31,1400,4749,6149
25,25326,1993-12-31,1368,4578,5946
25,25326,1994-12-31,1383,4467,5850
25,25326,1995-12-31,1356,4307,5663
25,25326,1996-12-31,1332,4206,5538
25,25326,1997-12-31,1336,4124,5460
25,25326,1998-12-31,1326,4081,5407
25,25326,1999-12-31,1337,4002,5339
25,25326,2000-12-31,1338,3937,5275
25,25326,2001-12-31,1343,3863,5206
25,25326,2002-12-31,1362,3816,5178
25,25326,2003-12-31,1385,3771,5156
25,25326,2004-12-31,1396,3716,5112
25,25326,2005-12-31,1414,3685,5099
25,25326,2006-12-31,1442,3669,5111
25,25326,2007-12-31,1475,3650,5125
25,25326,2008-12-31,1496,3645,5141
25,25326,2009-12-31,1535,3645,5180
25,25326,2010-12-31,1584,3670,5254
25,25326,2011-12-31,1661,3686,5347
25,25326,2012-12-31,1704,3721,5425
25,25326,2013-12-31,1762,3762,5524
25,25326,2014-12-31,1828,3817,5645
25,25326,2015-12-31,1915,3848,5763
25,25326,2016-12-31,2005,3920,5925
25,25326,2017-12-31,2084,3990,6074
25,25326,2018-12-31,2212,4113,6325
25,25326,2019-12-31,2356,4205,6561
25,25326,2020-12-31,2503,4308,6811
25,25326,2021-12-31,2760,4322,7082
25,25326,2022-12-31,2973,4331,7304
25,25326,2023-12-31,3172,4340,7512
25,25326,2024-12-31,3290,4350,7640
25,25326,2025-12-31,3396,4361,7757
25,25326,2026-12-31,3499,4380,7879
25,25326,2027-12-31,3579,4387,7966
25,25326,2028-12-31,3664,4394,8058
25,25326,2029-12-31,3744,4430,8174
25,25326,2030-12-31,3817,4442,8259
25,25326,2031-12-31,3883,4462,8345
25,25326,2032-12-31,3932,4472,8404
25,25326,2033-12-31,3998,4488,8486
25,25326,2034-12-31,4052,4507,8559
25,25326,2035-12-31,4113,4525,8638
25,25328,1985-12-31,1106,4746,5852
25,25328,1986-12-31,1051,4571,5622
25,25328,1987-12-31,998,4401,5399
25,25328,1988-12-31,956,4234,5190
25,25328,1989-12-31,947,4065,5012
25,25328,1990-12-31,949,3960,4909
25,25328,1991-12-31,912,3815,4727
25,25328,1992-12-31,865,3718,4583
25,25328,1993-12-31,837,3556,4393
25,25328,1994-12-31,780,3489,4269
25,25328,1995-12-31,777,3378,4155
25,25328,1996-12-31,774,3321,4095
25,25328,1997-12-31,756,3222,3978
25,25328,1998-12-31,723,3186,3909
25,25328,1999-12-31,722,3144,3866
25,25328,2000-12-31,735,3106,3841
25,25328,2001-12-31,711,3068,3779
25,25328,2002-12-31,723,3011,3734
25,25328,2003-12-31,704,3012,3716
25,25328,2004-12-31,725,2981,3706
25,25328,2005-12-31,728,2980,3708
25,25328,2006-12-31,746,2955,3701
25,25328,2007-12-31,772,2938,3710
25,25328,2008-12-31,782,2951,3733
25,25328,2009-12-31,741,2950,3691
25,25328,2010-12-31,811,2994,3805
25,25328,2011-12-31,822,3012,3834
25,25328,2012-12-31,803,3042,3845
25,25328,2013-12-31,826,3067,3893
25,25328,2014-12-31,841,3112,3953
25,25328,2015-12-31,877,3199,4076
25,25328,2016-12-31,977,3247,4224
25,25328,2017-12-31,970,3317,4287
25,25328,2018-12-31,1018,3426,4444
25,25328,2019-12-31,1067,3520,4587
25,25328,2020-12-31,1124,3619,4743
25,25328,2021-12-31,1300,3631,4931
25,25328,2022-12-31,1448,3639,5087
25,25328,2023-12-31,1585,3646,5231
25,25328,2024-12-31,1646,3649,5295
25,25328,2025-12-31,1704,3655,5359
25,25328,2026-12-31,1743,3667,5410
25,25328,2027-12-31,1790,3684,5474
25,25328,2028-12-31,1828,3690,5518
25,25328,2029-12-31,1869,3699,5568
25,25328,2030-12-31,1911,3721,5632
25,25328,2031-12-31,1930,3736,5666
25,25328,2032-12-31,1969,3746,5715
25,25328,2033-12-31,2000,3756,5756
25,25328,2034-12-31,2023,3769,5792
25,25328,2035-12-31,2060,3778,5838
25,25335,1985-12-31,1522,4708,6230
25,25335,1986-12-31,1473,4586,6059
25,25335,1987-12-31,1420,4458,5878
25,25335,1988-12-31,1412,4308,5720
25,25335,1989-12-31,1384,4194,5578
25,25335,1990-12-31,1331,4074,5405
25,25335,1991-12-31,1279,3966,5245
25,25335,1992-12-31,1237,3887,5124
25,25335,1993-12-31,1222,3780,5002
25,25335,1994-12-31,1229,3675,4904
25,25335,1995-12-31,1202,3617,4819
25,25335,1996-12-31,1173,3576,4749
25,25335,1997-12-31,1164,3515,4679
25,25335,1998-12-31,1192,3512,4704
25,25335,1999-12-31,1179,3476,4655
25,25335,2000-12-31,1192,3444,4636
25,25335,2001-12-31,1194,3428,4622
25,25335,2002-12-31,1200,3409,4609
25,25335,2003-12-31,1223,3392,4615
25,25335,2004-12-31,1242,3370,4612
25,25335,2005-12-31,1275,3383,4658
25,25335,2006-12-31,1261,3393,4654
25,25335,2007-12-31,1316,3414,4730
25,25335,2008-12-31,1321,3421,4742
25,25335,2009-12-31,1380,3462,4842
25,25335,2010-12-31,1430,3523,4953
25,25335,2011-12-31,1485,3579,5064
25,25335,2012-12-31,1522,3653,5175
25,25335,2013-12-31,1559,3738,5297
25,25335,2014-12-31,1638,3811,5449
25,25335,2015-12-31,1692,3901,5593
25,25335,2016-12-31,1785,4008,5793
25,25335,2017-12-31,1853,4116,5969
25,25335,2018-12-31,1967,4265,6232
25,25335,2019-12-31,2085,4400,6485
25,25335,2020-12-31,2208,4536,6744
25,25335,2021-12-31,2461,4551,7012
25,25335,2022-12-31,2671,4561,7232
25,25335,2023-12-31,2869,4569,7438
25,25335,2024-12-31,2977,4579,7556
25,25335,2025-12-31,3081,4593,7674
25,25335,2026-12-31,3166,4597,7763
25,25335,2027-12-31,3246,4622,7868
25,25335,2028-12-31,3312,4643,7955
25,25335,2029-12-31,3386,4650,8036
25,25335,2030-12-31,3458,4669,8127
25,25335,2031-12-31,3504,4698,8202
25,25335,2032-12-31,3572,4721,8293
25,25335,2033-12-31,3623,4732,8355
25,25335,2034-12-31,3685,4749,8434
25,25335,2035-12-31,3736,4767,8503
25,25339,1985-12-31,1189,4750,5939
25,25339,1986-12-31,1179,4535,5714
25,25339,1987-12-31,1027,4338,5365
25,25339,1988-12-31,1031,4111,5142
25,25339,1989-12-31,992,3965,4957
25,25339,1990-12-31,960,3759,4719
25,25339,1991-12-31,897,3667,4564
25,25339,1992-12-31,884,3496,4380
25,25339,1993-12-31,834,3354,4188
25,25339,1994-12-31,792,3231,4023
25,25339,1995-12-31,840,3138,3978
25,25339,1996-12-31,805,3046,3851
25,25339,1997-12-31,804,2943,3747
25,25339,1998-12-31,786,2890,3676
25,25339,1999-12-31,753,2804,3557
25,25339,2000-12-31,748,2747,3495
25,25339,2001-12-31,735,2680,3415
25,25339,2002-12-31,729,2620,3349
25,25339,2003-12-31,710,2563,3273
25,25339,2004-12-31,718,2511,3229
25,25339,2005-12-31,734,2475,3209
25,25339,2006-12-31,735,2425,3160
25,25339,2007-12-31,736,2415,3151
25,25339,2008-12-31,742,2375,3117
25,25339,2009-12-31,751,2356,3107
25,25339,2010-12-31,787,2356,3143
25,25339,2011-12-31,804,2326,3130
25,25339,2012-12-31,799,2345,3144
25,25339,2013-12-31,836,2340,3176
25,25339,2014-12-31,835,2335,3170
25,25339,2015-12-31,853,2381,3234
25,25339,2016-12-31,916,2370,3286
25,25339,2017-12-31,966,2390,3356
25,25339,2018-12-31,983,2427,3410
25,25339,2019-12-31,1025,2453,3478
25,25339,2020-12-31,1072,2495,3567
25,25339,2021-12-31,1206,2503,3709
25,25339,2022-12-31,1316,2509,3825
25,25339,2023-12-31,1421,2513,3934
25,25339,2024-12-31,1474,2517,3991
25,25339,2025-12-31,1516,2521,4037
25,25339,2026-12-31,1557,2522,4079
25,25339,2027-12-31,1604,2533,4137
25,25339,2028-12-31,1639,2540,4179
25,25339,2029-12-31,1685,2558,4243
25,25339,2030-12-31,1707,2571,4278
25,25339,2031-12-31,1731,2584,4315
25,25339,2032-12-31,1760,2589,4349
25,25339,2033-12-31,1790,2592,4382
25,25339,2034-12-31,1811,2611,4422
25,25339,2035-12-31,1844,2616,4460
25,25368,1985-12-31,1243,4357,5600
25,25368,1986-12-31,1198,4153,5351
25,25368,1987-12-31,1049,3917,4966
25,25368,1988-12-31,1007,3755,4762
25,25368,1989-12-31,971,3512,4483
25,25368,1990-12-31,975,3343,4318
25,25368,1991-12-31,917,3199,4116
25,25368,1992-12-31,878,3064,3942
25,25368,1993-12-31,811,2907,3718
25,25368,1994-12-31,797,2795,3592
25,25368,1995-12-31,757,2661,3418
25,25368,1996-12-31,780,2557,3337
25,25368,1997-12-31,774,2441,3215
25,25368,1998-12-31,751,2384,3135
25,25368,1999-12-31,708,2289,2997
25,25368,2000-12-31,722,2216,2938
25,25368,2001-12-31,690,2158,2848
25,25368,2002-12-31,685,2070,2755
25,25368,2003-12-31,662,2017,2679
25,25368,2004-12-31,665,1952,2617
25,25368,2005-12-31,680,1885,2565
25,25368,2006-12-31,642,1841,2483
25,25368,2007-12-31,645,1787,2432
25,25368,2008-12-31,664,1752,2416
25,25368,2009-12-31,676,1702,2378
25,25368,2010-12-31,643,1663,2306
25,25368,2011-12-31,655,1664,2319
25,25368,2012-12-31,683,1616,2299
25,25368,2013-12-31,672,1585,2257
25,25368,2014-12-31,696,1559,2255
25,25368,2015-12-31,731,1510,2241
25,25368,2016-12-31,826,1493,2319
25,25368,2017-12-31,753,1541,2294
25,25368,2018-12-31,800,1481,2281
25,25368,2019-12-31,818,1465,2283
25,25368,2020-12-31,844,1471,2315
25,25368,2021-12-31,932,1475,2407
25,25368,2022-12-31,1004,1479,2483
25,25368,2023-12-31,1071,1482,2553
25,25368,2024-12-31,1106,1488,2594
25,25368,2025-12-31,1141,1486,2627
25,25368,2026-12-31,1167,1486,2653
25,25368,2027-12-31,1206,1489,2695
25,25368,2028-12-31,1239,1492,2731
25,25368,2029-12-31,1260,1508,2768
25,25368,2030-12-31,1283,1512,2795
25,25368,2031-12-31,1302,1511,2813
25,25368,2032-12-31,1320,1525,2845
25,25368,2033-12-31,1343,1532,2875
25,25368,2034-12-31,1358,1536,2894
25,25368,2035-12-31,1395,1532,2927
25,25372,1985-12-31,905,12118,13023
25,25372,1986-12-31,824,11528,12352
25,25372,1987-12-31,801,10968,11769
25,25372,1988-12-31,703,10454,11157
25,25372,1989-12-31,677,9987,10664
25,25372,1990-12-31,685,9504,10189
25,25372,1991-12-31,672,9079,9751
25,25372,1992-12-31,637,8636,9273
25,25372,1993-12-31,621,8251,8872
25,25372,1994-12-31,606,7938,8544
25,25372,1995-12-31,599,7651,8250
25,25372,1996-12-31,583,7355,7938
25,25372,1997-12-31,591,7089,7680
25,25372,1998-12-31,564,6915,7479
25,25372,1999-12-31,577,6699,7276
25,25372,2000-12-31,571,6509,7080
25,25372,2001-12-31,568,6314,6882
25,25372,2002-12-31,580,6152,6732
25,25372,2003-12-31,581,5998,6579
25,25372,2004-12-31,586,5832,6418
25,25372,2005-12-31,586,5687,6273
25,25372,2006-12-31,567,5572,6139
25,25372,2007-12-31,628,5463,6091
25,25372,2008-12-31,629,5356,5985
25,25372,2009-12-31,628,5280,5908
25,25372,2010-12-31,631,5219,5850
25,25372,2011-12-31,650,5147,5797
25,25372,2012-12-31,659,5093,5752
25,25372,2013-12-31,679,5047,5726
25,25372,2014-12-31,703,5014,5717
25,25372,2015-12-31,734,5000,5734
25,25372,2016-12-31,764,4973,5737
25,25372,2017-12-31,785,4966,5751
25,25372,2018-12-31,833,4990,5823
25,25372,2019-12-31,871,5049,5920
25,25372,2020-12-31,914,5160,6074
25,25372,2021-12-31,1138,5177,6315
25,25372,2022-12-31,1326,5188,6514
25,25372,2023-12-31,1501,5198,6699
25,25372,2024-12-31,1573,5209,6782
25,25372,2025-12-31,1621,5222,6843
25,25372,2026-12-31,1676,5234,6910
25,25372,2027-12-31,1721,5252,6973
25,25372,2028-12-31,1759,5259,7018
25,25372,2029-12-31,1796,5282,7078
25,25372,2030-12-31,1817,5305,7122
25,25372,2031-12-31,1852,5314,7166
25,25372,2032-12-31,1878,5321,7199
25,25372,2033-12-31,1904,5353,7257
25,25372,2034-12-31,1937,5376,7313
25,25372,2035-12-31,1969,5386,7355
25,25377,1985-12-31,6370,17405,23775
25,25377,1986-12-31,6320,16866,23186
25,25377,1987-12-31,6300,16380,22680
25,25377,1988-12-31,6279,15925,22204
25,25377,1989-12-31,6281,15473,21754
25,25377,1990-12-31,6194,15072,21266
25,25377,1991-12-31,6197,14665,20862
25,25377,1992-12-31,6217,14311,20528
25,25377,1993-12-31,6225,13969,20194
25,25377,1994-12-31,6284,13710,19994
25,25377,1995-12-31,6340,13501,19841
25,25377,1996-12-31,6410,13305,19715
25,25377,1997-12-31,6495,13137,19632
25,25377,1998-12-31,6545,13126,19671
25,25377,1999-12-31,6643,13023,19666
25,25377,2000-12-31,6797,12928,19725
25,25377,2001-12-31,6921,12869,19790
25,25377,2002-12-31,7084,12816,19900
25,25377,2003-12-31,7261,12801,20062
25,25377,2004-12-31,7431,12784,20215
25,25377,2005-12-31,7653,12790,20443
25,25377,2006-12-31,7894,12836,20730
25,25377,2007-12-31,8132,12917,21049
25,25377,2008-12-31,8429,13044,21473
25,25377,2009-12-31,8756,13185,21941
25,25377,2010-12-31,9112,13413,22525
25,25377,2011-12-31,9499,13640,23139
25,25377,2012-12-31,9917,13895,23812
25,25377,2013-12-31,10389,14193,24582
25,25377,2014-12-31,10877,14519,25396
25,25377,2015-12-31,11421,14887,26308
25,25377,2016-12-31,12019,15303,27322
25,25377,2017-12-31,12682,15780,28462
25,25377,2018-12-31,13470,16398,29868
25,25377,2019-12-31,14601,16831,31432
25,25377,2020-12-31,15697,17220,32917
25,25377,2021-12-31,16948,17276,34224
25,25377,2022-12-31,17987,17314,35301
25,25377,2023-12-31,18958,17346,36304
25,25377,2024-12-31,19712,17375,37087
25,25377,2025-12-31,20367,17412,37779
25,25377,2026-12-31,20965,17459,38424
25,25377,2027-12-31,21504,17508,39012
25,25377,2028-12-31,22017,17585,39602
25,25377,2029-12-31,22460,17644,40104
25,25377,2030-12-31,22865,17706,40571
25,25377,2031-12-31,23251,17781,41032
25,25377,2032-12-31,23618,17856,41474
25,25377,2033-12-31,23988,17934,41922
25,25377,2034-12-31,24367,17976,42343
25,25377,2035-12-31,24707,18049,42756
25,25386,1985-12-31,8940,15978,24918
25,25386,1986-12-31,8801,15528,24329
25,25386,1987-12-31,8685,15092,23777
25,25386,1988-12-31,8591,14698,23289
25,25386,1989-12-31,8517,14333,22850
25,25386,1990-12-31,8376,13988,22364
25,25386,1991-12-31,8336,13660,21996
25,25386,1992-12-31,8318,13318,21636
25,25386,1993-12-31,8292,13033,21325
25,25386,1994-12-31,8322,12797,21119
25,25386,1995-12-31,8370,12623,20993
25,25386,1996-12-31,8426,12432,20858
25,25386,1997-12-31,8506,12286,20792
25,25386,1998-12-31,8551,12299,20850
25,25386,1999-12-31,8691,12210,20901
25,25386,2000-12-31,8843,12143,20986
25,25386,2001-12-31,8992,12088,21080
25,25386,2002-12-31,9173,12062,21235
25,25386,2003-12-31,9372,12059,21431
25,25386,2004-12-31,9588,12058,21646
25,25386,2005-12-31,9835,12095,21930
25,25386,2006-12-31,10096,12166,22262
25,25386,2007-12-31,10403,12258,22661
25,25386,2008-12-31,10747,12395,23142
25,25386,2009-12-31,11126,12564,23690
25,25386,2010-12-31,11556,12777,24333
25,25386,2011-12-31,12022,13017,25039
25,25386,2012-12-31,12535,13263,25798
25,25386,2013-12-31,13094,13599,26693
25,25386,2014-12-31,13704,13928,27632
25,25386,2015-12-31,14346,14311,28657
25,25386,2016-12-31,15084,14739,29823
25,25386,2017-12-31,15901,15212,31113
25,25386,2018-12-31,16854,15840,32694
25,25386,2019-12-31,18269,16196,34465
25,25386,2020-12-31,19641,16488,36129
25,25386,2021-12-31,21023,16541,37564
25,25386,2022-12-31,22168,16578,38746
25,25386,2023-12-31,23238,16609,39847
25,25386,2024-12-31,24139,16645,40784
25,25386,2025-12-31,24926,16682,41608
25,25386,2026-12-31,25674,16726,42400
25,25386,2027-12-31,26331,16774,43105
25,25386,2028-12-31,26915,16833,43748
25,25386,2029-12-31,27473,16884,44357
25,25386,2030-12-31,27971,16945,44916
25,25386,2031-12-31,28423,17022,45445
25,25386,2032-12-31,28893,17070,45963
25,25386,2033-12-31,29328,17129,46457
25,25386,2034-12-31,29771,17209,46980
25,25386,2035-12-31,30201,17261,47462
25,25394,1985-12-31,6692,13989,20681
25,25394,1986-12-31,6293,13291,19584
25,25394,1987-12-31,5944,12627,18571
25,25394,1988-12-31,5621,12025,17646
25,25394,1989-12-31,5281,11449,16730
25,25394,1990-12-31,5045,10931,15976
25,25394,1991-12-31,4806,10405,15211
25,25394,1992-12-31,4612,9903,14515
25,25394,1993-12-31,4423,9452,13875
25,25394,1994-12-31,4285,9077,13362
25,25394,1995-12-31,4169,8703,12872
25,25394,1996-12-31,4047,8372,12419
25,25394,1997-12-31,3938,8068,12006
25,25394,1998-12-31,3816,7863,11679
25,25394,1999-12-31,3724,7590,11314
25,25394,2000-12-31,3674,7340,11014
25,25394,2001-12-31,3619,7101,10720
25,25394,2002-12-31,3585,6895,10480
25,25394,2003-12-31,3548,6701,10249
25,25394,2004-12-31,3518,6529,10047
25,25394,2005-12-31,3509,6372,9881
25,25394,2006-12-31,3488,6219,9707
25,25394,2007-12-31,3472,6071,9543
25,25394,2008-12-31,3522,5933,9455
25,25394,2009-12-31,3507,5832,9339
25,25394,2010-12-31,3526,5739,9265
25,25394,2011-12-31,3585,5670,9255
25,25394,2012-12-31,3618,5587,9205
25,25394,2013-12-31,3679,5503,9182
25,25394,2014-12-31,3731,5459,9190
25,25394,2015-12-31,3802,5408,9210
25,25394,2016-12-31,3885,5366,9251
25,25394,2017-12-31,4016,5327,9343
25,25394,2018-12-31,4125,5342,9467
25,25394,2019-12-31,4227,5361,9588
25,25394,2020-12-31,4383,5427,9810
25,25394,2021-12-31,4756,5444,10200
25,25394,2022-12-31,5065,5456,10521
25,25394,2023-12-31,5353,5467,10820
25,25394,2024-12-31,5538,5471,11009
25,25394,2025-12-31,5716,5488,11204
25,25394,2026-12-31,5872,5498,11370
25,25394,2027-12-31,6022,5505,11527
25,25394,2028-12-31,6166,5515,11681
25,25394,2029-12-31,6283,5520,11803
25,25394,2030-12-31,6394,5543,11937
25,25394,2031-12-31,6500,5541,12041
25,25394,2032-12-31,6600,5568,12168
25,25394,2033-12-31,6709,5579,12288
25,25394,2034-12-31,6812,5593,12405
25,25394,2035-12-31,6905,5607,12512
25,25398,1985-12-31,1556,10891,12447
25,25398,1986-12-31,1484,10378,11862
25,25398,1987-12-31,1382,9885,11267
25,25398,1988-12-31,1318,9434,10752
25,25398,1989-12-31,1250,9002,10252
25,25398,1990-12-31,1196,8605,9801
25,25398,1991-12-31,1130,8228,9358
25,25398,1992-12-31,1094,7866,8960
25,25398,1993-12-31,1043,7532,8575
25,25398,1994-12-31,1020,7243,8263
25,25398,1995-12-31,992,7000,7992
25,25398,1996-12-31,942,6743,7685
25,25398,1997-12-31,943,6510,7453
25,25398,1998-12-31,894,6364,7258
25,25398,1999-12-31,872,6186,7058
25,25398,2000-12-31,876,6003,6879
25,25398,2001-12-31,843,5856,6699
25,25398,2002-12-31,836,5696,6532
25,25398,2003-12-31,828,5574,6402
25,25398,2004-12-31,840,5440,6280
25,25398,2005-12-31,833,5322,6155
25,25398,2006-12-31,843,5221,6064
25,25398,2007-12-31,842,5126,5968
25,25398,2008-12-31,832,5061,5893
25,25398,2009-12-31,843,4990,5833
25,25398,2010-12-31,887,4934,5821
25,25398,2011-12-31,889,4908,5797
25,25398,2012-12-31,899,4859,5758
25,25398,2013-12-31,903,4846,5749
25,25398,2014-12-31,890,4835,5725
25,25398,2015-12-31,895,4809,5704
25,25398,2016-12-31,979,4834,5813
25,25398,2017-12-31,972,4827,5799
25,25398,2018-12-31,1023,4888,5911
25,25398,2019-12-31,1053,4923,5976
25,25398,2020-12-31,1094,5001,6095
25,25398,2021-12-31,1320,5017,6337
25,25398,2022-12-31,1508,5028,6536
25,25398,2023-12-31,1684,5038,6722
25,25398,2024-12-31,1757,5043,6800
25,25398,2025-12-31,1823,5048,6871
25,25398,2026-12-31,1865,5047,6912
25,25398,2027-12-31,1912,5059,6971
25,25398,2028-12-31,1963,5057,7020
25,25398,2029-12-31,2002,5059,7061
25,25398,2030-12-31,2039,5063,7102
25,25398,2031-12-31,2064,5052,7116
25,25398,2032-12-31,2088,5034,7122
25,25398,2033-12-31,2134,5010,7144
25,25398,2034-12-31,2165,4969,7134
25,25398,2035-12-31,2189,4922,7111
25,25402,1985-12-31,3337,10888,14225
25,25402,1986-12-31,3291,10594,13885
25,25402,1987-12-31,3254,10286,13540
25,25402,1988-12-31,3192,10016,13208
25,25402,1989-12-31,3184,9772,12956
25,25402,1990-12-31,3146,9526,12672
25,25402,1991-12-31,3093,9301,12394
25,25402,1992-12-31,3102,9073,12175
25,25402,1993-12-31,3085,8860,11945
25,25402,1994-12-31,3086,8711,11797
25,25402,1995-12-31,3103,8581,11684
25,25402,1996-12-31,3138,8473,11611
25,25402,1997-12-31,3158,8383,11541
25,25402,1998-12-31,3185,8388,11573
25,25402,1999-12-31,3223,8325,11548
25,25402,2000-12-31,3279,8288,11567
25,25402,2001-12-31,3335,8256,11591
25,25402,2002-12-31,3383,8241,11624
25,25402,2003-12-31,3452,8232,11684
25,25402,2004-12-31,3545,8230,11775
25,25402,2005-12-31,3628,8250,11878
25,25402,2006-12-31,3730,8290,12020
25,25402,2007-12-31,3846,8361,12207
25,25402,2008-12-31,3975,8456,12431
25,25402,2009-12-31,4115,8572,12687
25,25402,2010-12-31,4267,8712,12979
25,25402,2011-12-31,4435,8866,13301
25,25402,2012-12-31,4619,9049,13668
25,25402,2013-12-31,4820,9256,14076
25,25402,2014-12-31,5046,9471,14517
25,25402,2015-12-31,5291,9731,15022
25,25402,2016-12-31,5552,10009,15561
25,25402,2017-12-31,5844,10354,16198
25,25402,2018-12-31,6213,10773,16986
25,25402,2019-12-31,6694,11136,17830
25,25402,2020-12-31,7168,11474,18642
25,25402,2021-12-31,7871,11511,19382
25,25402,2022-12-31,8456,11536,19992
25,25402,2023-12-31,9002,11558,20560
25,25402,2024-12-31,9353,11590,20943
25,25402,2025-12-31,9660,11610,21270
25,25402,2026-12-31,9930,11647,21577
25,25402,2027-12-31,10185,11660,21845
25,25402,2028-12-31,10409,11712,22121
25,25402,2029-12-31,10627,11758,22385
25,25402,2030-12-31,10802,11790,22592
25,25402,2031-12-31,11001,11839,22840
25,25402,2032-12-31,11164,11889,23053
25,25402,2033-12-31,11327,11936,23263
25,25402,2034-12-31,11497,11984,23481
25,25402,2035-12-31,11672,12032,23704
25,25407,1985-12-31,2668,10631,13299
25,25407,1986-12-31,2546,10197,12743
25,25407,1987-12-31,2423,9797,12220
25,25407,1988-12-31,2333,9452,11785
25,25407,1989-12-31,2256,9106,11362
25,25407,1990-12-31,2184,8746,10930
25,25407,1991-12-31,2105,8465,10570
25,25407,1992-12-31,2064,8190,10254
25,25407,1993-12-31,2005,7910,9915
25,25407,1994-12-31,1962,7689,9651
25,25407,1995-12-31,1929,7506,9435
25,25407,1996-12-31,1910,7315,9225
25,25407,1997-12-31,1938,7170,9108
25,25407,1998-12-31,1894,7085,8979
25,25407,1999-12-31,1871,6960,8831
25,25407,2000-12-31,1868,6848,8716
25,25407,2001-12-31,1874,6769,8643
25,25407,2002-12-31,1862,6677,8539
25,25407,2003-12-31,1886,6598,8484
25,25407,2004-12-31,1892,6526,8418
25,25407,2005-12-31,1922,6463,8385
25,25407,2006-12-31,1902,6409,8311
25,25407,2007-12-31,1965,6402,8367
25,25407,2008-12-31,2008,6398,8406
25,25407,2009-12-31,2041,6407,8448
25,25407,2010-12-31,2084,6441,8525
25,25407,2011-12-31,2150,6490,8640
25,25407,2012-12-31,2219,6549,8768
25,25407,2013-12-31,2287,6634,8921
25,25407,2014-12-31,2380,6711,9091
25,25407,2015-12-31,2460,6812,9272
25,25407,2016-12-31,2538,6933,9471
25,25407,2017-12-31,2641,7083,9724
25,25407,2018-12-31,2798,7282,10080
25,25407,2019-12-31,2950,7474,10424
25,25407,2020-12-31,3110,7684,10794
25,25407,2021-12-31,3514,7709,11223
25,25407,2022-12-31,3850,7726,11576
25,25407,2023-12-31,4165,7740,11905
25,25407,2024-12-31,4329,7748,12077
25,25407,2025-12-31,4475,7778,12253
25,25407,2026-12-31,4599,7797,12396
25,25407,2027-12-31,4721,7826,12547
25,25407,2028-12-31,4833,7855,12688
25,25407,2029-12-31,4930,7880,12810
25,25407,2030-12-31,5019,7919,12938
25,25407,2031-12-31,5105,7954,13059
25,25407,2032-12-31,5186,7982,13168
25,25407,2033-12-31,5273,8002,13275
25,25407,2034-12-31,5355,8040,13395
25,25407,2035-12-31,5439,8067,13506
25,25426,1985-12-31,1409,12166,13575
25,25426,1986-12-31,1363,11566,12929
25,25426,1987-12-31,1310,11008,12318
25,25426,1988-12-31,1230,10443,11673
25,25426,1989-12-31,1200,9970,11170
25,25426,1990-12-31,1167,9483,10650
25,25426,1991-12-31,1115,9036,10151
25,25426,1992-12-31,1116,8593,9709
25,25426,1993-12-31,1083,8177,9260
25,25426,1994-12-31,1068,7854,8922
25,25426,1995-12-31,1057,7547,8604
25,25426,1996-12-31,1056,7239,8295
25,25426,1997-12-31,1053,6972,8025
25,25426,1998-12-31,1052,6768,7820
25,25426,1999-12-31,1036,6616,7652
25,25426,2000-12-31,1033,6311,7344
25,25426,2001-12-31,1053,6175,7228
25,25426,2002-12-31,1040,5949,6989
25,25426,2003-12-31,1043,5790,6833
25,25426,2004-12-31,1035,5638,6673
25,25426,2005-12-31,1065,5492,6557
25,25426,2006-12-31,1058,5349,6407
25,25426,2007-12-31,1120,5222,6342
25,25426,2008-12-31,1133,5104,6237
25,25426,2009-12-31,1156,5015,6171
25,25426,2010-12-31,1193,4933,6126
25,25426,2011-12-31,1199,4849,6048
25,25426,2012-12-31,1238,4788,6026
25,25426,2013-12-31,1303,4720,6023
25,25426,2014-12-31,1317,4661,5978
25,25426,2015-12-31,1378,4625,6003
25,25426,2016-12-31,1429,4580,6009
25,25426,2017-12-31,1513,4548,6061
25,25426,2018-12-31,1584,4540,6124
25,25426,2019-12-31,1677,4494,6171
25,25426,2020-12-31,1775,4503,6278
25,25426,2021-12-31,2010,4517,6527
25,25426,2022-12-31,2206,4527,6733
25,25426,2023-12-31,2389,4535,6924
25,25426,2024-12-31,2488,4554,7042
25,25426,2025-12-31,2567,4540,7107
25,25426,2026-12-31,2650,4567,7217
25,25426,2027-12-31,2702,4586,7288
25,25426,2028-12-31,2773,4594,7367
25,25426,2029-12-31,2830,4609,7439
25,25426,2030-12-31,2881,4622,7503
25,25426,2031-12-31,2914,4650,7564
25,25426,2032-12-31,2978,4661,7639
25,25426,2033-12-31,3019,4681,7700
25,25426,2034-12-31,3055,4685,7740
25,25426,2035-12-31,3110,4708,7818
25,25430,1985-12-31,33122,7175,40297
25,25430,1986-12-31,34004,7049,41053
25,25430,1987-12-31,34843,6941,41784
25,25430,1988-12-31,35650,6848,42498
25,25430,1989-12-31,36346,6751,43097
25,25430,1990-12-31,37036,6636,43672
25,25430,1991-12-31,37743,6574,44317
25,25430,1992-12-31,38450,6515,44965
25,25430,1993-12-31,39135,6422,45557
25,25430,1994-12-31,40054,6347,46401
25,25430,1995-12-31,41022,6325,47347
25,25430,1996-12-31,42000,6334,48334
25,25430,1997-12-31,43103,6294,49397
25,25430,1998-12-31,43954,6375,50329
25,25430,1999-12-31,45194,6371,51565
25,25430,2000-12-31,46531,6406,52937
25,25430,2001-12-31,47941,6449,54390
25,25430,2002-12-31,49447,6506,55953
25,25430,2003-12-31,51052,6542,57594
25,25430,2004-12-31,52734,6603,59337
25,25430,2005-12-31,54516,6659,61175
25,25430,2006-12-31,56559,6750,63309
25,25430,2007-12-31,58818,6869,65687
25,25430,2008-12-31,61281,6996,68277
25,25430,2009-12-31,64017,7148,71165
25,25430,2010-12-31,67014,7318,74332
25,25430,2011-12-31,70251,7521,77772
25,25430,2012-12-31,73758,7711,81469
25,25430,2013-12-31,77549,7940,85489
25,25430,2014-12-31,81658,8190,89848
25,25430,2015-12-31,86095,8472,94567
25,25430,2016-12-31,91001,8780,99781
25,25430,2017-12-31,96419,9126,105545
25,25430,2018-12-31,102710,9544,112254
25,25430,2019-12-31,111961,8106,120067
25,25430,2020-12-31,120823,6315,127138
25,25430,2021-12-31,125880,6334,132214
25,25430,2022-12-31,130026,6348,136374
25,25430,2023-12-31,133889,6360,140249
25,25430,2024-12-31,138462,6379,144841
25,25430,2025-12-31,142785,6388,149173
25,25430,2026-12-31,146840,6402,153242
25,25430,2027-12-31,150638,6422,157060
25,25430,2028-12-31,154127,6441,160568
25,25430,2029-12-31,157320,6469,163789
25,25430,2030-12-31,160187,6498,166685
25,25430,2031-12-31,162877,6526,169403
25,25430,2032-12-31,165522,6558,172080
25,25430,2033-12-31,168141,6591,174732
25,25430,2034-12-31,170714,6611,177325
25,25430,2035-12-31,173219,6637,179856
25,25436,1985-12-31,1180,7724,8904
25,25436,1986-12-31,1146,7315,8461
25,25436,1987-12-31,1067,6956,8023
25,25436,1988-12-31,934,6609,7543
25,25436,1989-12-31,925,6300,7225
25,25436,1990-12-31,959,6017,6976
25,25436,1991-12-31,912,5712,6624
25,25436,1992-12-31,872,5424,6296
25,25436,1993-12-31,826,5170,5996
25,25436,1994-12-31,814,4979,5793
25,25436,1995-12-31,784,4754,5538
25,25436,1996-12-31,767,4596,5363
25,25436,1997-12-31,755,4418,5173
25,25436,1998-12-31,758,4270,5028
25,25436,1999-12-31,766,4117,4883
25,25436,2000-12-31,747,3973,4720
25,25436,2001-12-31,736,3850,4586
25,25436,2002-12-31,737,3723,4460
25,25436,2003-12-31,731,3605,4336
25,25436,2004-12-31,745,3512,4257
25,25436,2005-12-31,723,3402,4125
25,25436,2006-12-31,756,3301,4057
25,25436,2007-12-31,787,3214,4001
25,25436,2008-12-31,790,3157,3947
25,25436,2009-12-31,783,3112,3895
25,25436,2010-12-31,799,3050,3849
25,25436,2011-12-31,801,2996,3797
25,25436,2012-12-31,812,2918,3730
25,25436,2013-12-31,830,2903,3733
25,25436,2014-12-31,850,2858,3708
25,25436,2015-12-31,879,2829,3708
25,25436,2016-12-31,923,2760,3683
25,25436,2017-12-31,939,2770,3709
25,25436,2018-12-31,990,2747,3737
25,25436,2019-12-31,1037,2758,3795
25,25436,2020-12-31,1091,2802,3893
25,25436,2021-12-31,1237,2811,4048
25,25436,2022-12-31,1358,2817,4175
25,25436,2023-12-31,1471,2823,4294
25,25436,2024-12-31,1530,2825,4355
25,25436,2025-12-31,1579,2835,4414
25,25436,2026-12-31,1620,2840,4460
25,25436,2027-12-31,1658,2847,4505
25,25436,2028-12-31,1704,2861,4565
25,25436,2029-12-31,1737,2868,4605
25,25436,2030-12-31,1773,2884,4657
25,25436,2031-12-31,1801,2877,4678
25,25436,2032-12-31,1829,2885,4714
25,25436,2033-12-31,1851,2893,4744
25,25436,2034-12-31,1874,2912,4786
25,25436,2035-12-31,1905,2927,4832
25,25438,1985-12-31,3031,16226,19257
25,25438,1986-12-31,2929,15328,18257
25,25438,1987-12-31,2846,14497,17343
25,25438,1988-12-31,2760,13713,16473
25,25438,1989-12-31,2681,12960,15641
25,25438,1990-12-31,2652,12283,14935
25,25438,1991-12-31,2573,11624,14197
25,25438,1992-12-31,2520,11025,13545
25,25438,1993-12-31,2483,10434,12917
25,25438,1994-12-31,2452,9935,12387
25,25438,1995-12-31,2439,9453,11892
25,25438,1996-12-31,2418,9048,11466
25,25438,1997-12-31,2427,8646,11073
25,25438,1998-12-31,2418,8353,10771
25,25438,1999-12-31,2436,7996,10432
25,25438,2000-12-31,2451,7670,10121
25,25438,2001-12-31,2467,7362,9829
25,25438,2002-12-31,2486,7070,9556
25,25438,2003-12-31,2518,6791,9309
25,25438,2004-12-31,2552,6530,9082
25,25438,2005-12-31,2605,6263,8868
25,25438,2006-12-31,2649,6033,8682
25,25438,2007-12-31,2707,5797,8504
25,25438,2008-12-31,2782,5637,8419
25,25438,2009-12-31,2862,5424,8286
25,25438,2010-12-31,2937,5271,8208
25,25438,2011-12-31,3036,5037,8073
25,25438,2012-12-31,3148,4891,8039
25,25438,2013-12-31,3269,4710,7979
25,25438,2014-12-31,3399,4532,7931
25,25438,2015-12-31,3539,4400,7939
25,25438,2016-12-31,3700,4221,7921
25,25438,2017-12-31,3882,4046,7928
25,25438,2018-12-31,4103,3911,8014
25,25438,2019-12-31,4381,3683,8064
25,25438,2020-12-31,4666,3545,8211
25,25438,2021-12-31,4981,3556,8537
25,25438,2022-12-31,5242,3564,8806
25,25438,2023-12-31,5486,3570,9056
25,25438,2024-12-31,5681,3587,9268
25,25438,2025-12-31,5850,3594,9444
25,25438,2026-12-31,6022,3604,9626
25,25438,2027-12-31,6175,3616,9791
25,25438,2028-12-31,6312,3622,9934
25,25438,2029-12-31,6456,3629,10085
25,25438,2030-12-31,6571,3656,10227
25,25438,2031-12-31,6673,3667,10340
25,25438,2032-12-31,6774,3688,10462
25,25438,2033-12-31,6882,3697,10579
25,25438,2034-12-31,6985,3710,10695
25,25438,2035-12-31,7095,3712,10807
25,25473,1985-12-31,15269,3659,18928
25,25473,1986-12-31,18506,3527,22033
25,25473,1987-12-31,21428,3377,24805
25,25473,1988-12-31,24136,3236,27372
25,25473,1989-12-31,26550,3110,29660
25,25473,1990-12-31,28797,2989,31786
25,25473,1991-12-31,30932,2891,33823
25,25473,1992-12-31,32984,2781,35765
25,25473,1993-12-31,34877,2666,37543
25,25473,1994-12-31,36927,2604,39531
25,25473,1995-12-31,38954,2533,41487
25,25473,1996-12-31,40951,2452,43403
25,25473,1997-12-31,43027,2373,45400
25,25473,1998-12-31,44814,2346,47160
25,25473,1999-12-31,46968,2310,49278
25,25473,2000-12-31,49198,2259,51457
25,25473,2001-12-31,51502,2235,53737
25,25473,2002-12-31,53910,2202,56112
25,25473,2003-12-31,56386,2161,58547
25,25473,2004-12-31,58994,2128,61122
25,25473,2005-12-31,61690,2094,63784
25,25473,2006-12-31,64685,2080,66765
25,25473,2007-12-31,67916,2055,69971
25,25473,2008-12-31,71436,2015,73451
25,25473,2009-12-31,75260,2036,77296
25,25473,2010-12-31,79427,2035,81462
25,25473,2011-12-31,83897,2042,85939
25,25473,2012-12-31,88723,2050,90773
25,25473,2013-12-31,93923,2050,95973
25,25473,2014-12-31,99532,2073,101605
25,25473,2015-12-31,105567,2107,107674
25,25473,2016-12-31,112212,2136,114348
25,25473,2017-12-31,119554,2165,121719
25,25473,2018-12-31,128012,2209,130221
25,25473,2019-12-31,139225,1946,141171
25,25473,2020-12-31,148715,1950,150665
25,25473,2021-12-31,154724,1956,156680
25,25473,2022-12-31,159650,1960,161610
25,25473,2023-12-31,164239,1964,166203
25,25473,2024-12-31,169651,1975,171626
25,25473,2025-12-31,174933,1976,176909
25,25473,2026-12-31,179892,1978,181870
25,25473,2027-12-31,184522,1989,186511
25,25473,2028-12-31,188809,1981,190790
25,25473,2029-12-31,192694,1994,194688
25,25473,2030-12-31,196194,2008,198202
25,25473,2031-12-31,199480,2021,201501
25,25473,2032-12-31,202730,2026,204756
25,25473,2033-12-31,205891,2028,207919
25,25473,2034-12-31,209038,2042,211080
25,25473,2035-12-31,212121,2042,214163
25,25483,1985-12-31,2134,1182,3316
25,25483,1986-12-31,2023,1164,3187
25,25483,1987-12-31,1892,1059,2951
25,25483,1988-12-31,1830,1015,2845
25,25483,1989-12-31,1744,969,2713
25,25483,1990-12-31,1680,952,2632
25,25483,1991-12-31,1581,928,2509
25,25483,1992-12-31,1526,926,2452
25,25483,1993-12-31,1472,864,2336
25,25483,1994-12-31,1435,837,2272
25,25483,1995-12-31,1391,819,2210
25,25483,1996-12-31,1370,777,2147
25,25483,1997-12-31,1342,731,2073
25,25483,1998-12-31,1334,729,2063
25,25483,1999-12-31,1288,697,1985
25,25483,2000-12-31,1277,695,1972
25,25483,2001-12-31,1252,692,1944
25,25483,2002-12-31,1265,676,1941
25,25483,2003-12-31,1241,661,1902
25,25483,2004-12-31,1260,660,1920
25,25483,2005-12-31,1280,663,1943
25,25483,2006-12-31,1278,646,1924
25,25483,2007-12-31,1297,641,1938
25,25483,2008-12-31,1284,627,1911
25,25483,2009-12-31,1306,636,1942
25,25483,2010-12-31,1316,635,1951
25,25483,2011-12-31,1355,629,1984
25,25483,2012-12-31,1366,635,2001
25,25483,2013-12-31,1421,635,2056
25,25483,2014-12-31,1455,656,2111
25,25483,2015-12-31,1502,674,2176
25,25483,2016-12-31,1483,662,2145
25,25483,2017-12-31,1609,671,2280
25,25483,2018-12-31,1641,692,2333
25,25483,2019-12-31,1701,694,2395
25,25483,2020-12-31,1774,690,2464
25,25483,2021-12-31,1870,692,2562
25,25483,2022-12-31,1948,694,2642
25,25483,2023-12-31,2023,695,2718
25,25483,2024-12-31,2088,692,2780
25,25483,2025-12-31,2156,690,2846
25,25483,2026-12-31,2207,691,2898
25,25483,2027-12-31,2266,694,2960
25,25483,2028-12-31,2328,695,3023
25,25483,2029-12-31,2370,707,3077
25,25483,2030-12-31,2411,710,3121
25,25483,2031-12-31,2455,707,3162
25,25483,2032-12-31,2488,697,3185
25,25483,2033-12-31,2531,706,3237
25,25483,2034-12-31,2563,714,3277
25,25483,2035-12-31,2598,720,3318
25,25486,1985-12-31,5072,5353,10425
25,25486,1986-12-31,4881,5280,10161
25,25486,1987-12-31,4699,5185,9884
25,25486,1988-12-31,4539,5085,9624
25,25486,1989-12-31,4418,4994,9412
25,25486,1990-12-31,4265,4895,9160
25,25486,1991-12-31,4203,4857,9060
25,25486,1992-12-31,4119,4789,8908
25,25486,1993-12-31,4045,4705,8750
25,25486,1994-12-31,3995,4673,8668
25,25486,1995-12-31,3959,4654,8613
25,25486,1996-12-31,3927,4615,8542
25,25486,1997-12-31,3928,4606,8534
25,25486,1998-12-31,3892,4639,8531
25,25486,1999-12-31,3901,4664,8565
25,25486,2000-12-31,3910,4675,8585
25,25486,2001-12-31,3950,4708,8658
25,25486,2002-12-31,3983,4698,8681
25,25486,2003-12-31,4024,4731,8755
25,25486,2004-12-31,4068,4767,8835
25,25486,2005-12-31,4119,4795,8914
25,25486,2006-12-31,4198,4866,9064
25,25486,2007-12-31,4272,4931,9203
25,25486,2008-12-31,4381,5023,9404
25,25486,2009-12-31,4506,5127,9633
25,25486,2010-12-31,4645,5237,9882
25,25486,2011-12-31,4788,5378,10166
25,25486,2012-12-31,4956,5515,10471
25,25486,2013-12-31,5138,5678,10816
25,25486,2014-12-31,5339,5847,11186
25,25486,2015-12-31,5563,6039,11602
25,25486,2016-12-31,5796,6247,12043
25,25486,2017-12-31,6069,6488,12557
25,25486,2018-12-31,6389,6782,13171
25,25486,2019-12-31,6796,7072,13868
25,25486,2020-12-31,7211,7321,14532
25,25486,2021-12-31,7764,7345,15109
25,25486,2022-12-31,8224,7361,15585
25,25486,2023-12-31,8652,7375,16027
25,25486,2024-12-31,8971,7393,16364
25,25486,2025-12-31,9260,7404,16664
25,25486,2026-12-31,9505,7436,16941
25,25486,2027-12-31,9759,7462,17221
25,25486,2028-12-31,9975,7491,17466
25,25486,2029-12-31,10177,7512,17689
25,25486,2030-12-31,10376,7535,17911
25,25486,2031-12-31,10551,7576,18127
25,25486,2032-12-31,10717,7605,18322
25,25486,2033-12-31,10882,7645,18527
25,25486,2034-12-31,11053,7671,18724
25,25486,2035-12-31,11215,7697,18912
25,25488,1985-12-31,779,4238,5017
25,25488,1986-12-31,859,4237,5096
25,25488,1987-12-31,819,4257,5076
25,25488,1988-12-31,866,4274,5140
25,25488,1989-12-31,896,4270,5166
25,25488,1990-12-31,962,4291,5253
25,25488,1991-12-31,932,4309,5241
25,25488,1992-12-31,990,4316,5306
25,25488,1993-12-31,1035,4316,5351
25,25488,1994-12-31,1055,4364,5419
25,25488,1995-12-31,1062,4406,5468
25,25488,1996-12-31,1116,4452,5568
25,25488,1997-12-31,1153,4486,5639
25,25488,1998-12-31,1148,4555,5703
25,25488,1999-12-31,1207,4674,5881
25,25488,2000-12-31,1235,4813,6048
25,25488,2001-12-31,1277,4949,6226
25,25488,2002-12-31,1310,5050,6360
25,25488,2003-12-31,1356,5151,6507
25,25488,2004-12-31,1405,5245,6650
25,25488,2005-12-31,1466,5321,6787
25,25488,2006-12-31,1511,5420,6931
25,25488,2007-12-31,1562,5529,7091
25,25488,2008-12-31,1644,5670,7314
25,25488,2009-12-31,1706,5824,7530
25,25488,2010-12-31,1782,5976,7758
25,25488,2011-12-31,1894,6175,8069
25,25488,2012-12-31,1959,6381,8340
25,25488,2013-12-31,2084,6585,8669
25,25488,2014-12-31,2192,6833,9025
25,25488,2015-12-31,2297,7082,9379
25,25488,2016-12-31,2420,7382,9802
25,25488,2017-12-31,2549,7699,10248
25,25488,2018-12-31,2752,8067,10819
25,25488,2019-12-31,3039,8402,11441
25,25488,2020-12-31,3328,8700,12028
25,25488,2021-12-31,3780,8728,12508
25,25488,2022-12-31,4155,8747,12902
25,25488,2023-12-31,4504,8764,13268
25,25488,2024-12-31,4731,8797,13528
25,25488,2025-12-31,4911,8818,13729
25,25488,2026-12-31,5064,8846,13910
25,25488,2027-12-31,5190,8869,14059
25,25488,2028-12-31,5313,8904,14217
25,25488,2029-12-31,5430,8944,14374
25,25488,2030-12-31,5526,8981,14507
25,25488,2031-12-31,5611,9006,14617
25,25488,2032-12-31,5699,9036,14735
25,25488,2033-12-31,5800,9074,14874
25,25488,2034-12-31,5882,9118,15000
25,25488,2035-12-31,5968,9144,15112
25,25489,1985-12-31,687,5734,6421
25,25489,1986-12-31,607,5478,6085
25,25489,1987-12-31,579,5239,5818
25,25489,1988-12-31,504,4983,5487
25,25489,1989-12-31,525,4787,5312
25,25489,1990-12-31,560,4561,5121
25,25489,1991-12-31,533,4371,4904
25,25489,1992-12-31,537,4201,4738
25,25489,1993-12-31,462,4059,4521
25,25489,1994-12-31,508,3896,4404
25,25489,1995-12-31,433,3761,4194
25,25489,1996-12-31,445,3631,4076
25,25489,1997-12-31,471,3540,4011
25,25489,1998-12-31,415,3468,3883
25,25489,1999-12-31,452,3364,3816
25,25489,2000-12-31,441,3283,3724
25,25489,2001-12-31,428,3206,3634
25,25489,2002-12-31,427,3137,3564
25,25489,2003-12-31,442,3068,3510
25,25489,2004-12-31,461,2993,3454
25,25489,2005-12-31,459,2937,3396
25,25489,2006-12-31,464,2906,3370
25,25489,2007-12-31,471,2873,3344
25,25489,2008-12-31,479,2859,3338
25,25489,2009-12-31,490,2829,3319
25,25489,2010-12-31,505,2828,3333
25,25489,2011-12-31,504,2791,3295
25,25489,2012-12-31,530,2793,3323
25,25489,2013-12-31,571,2786,3357
25,25489,2014-12-31,587,2817,3404
25,25489,2015-12-31,675,2804,3479
25,25489,2016-12-31,702,2830,3532
25,25489,2017-12-31,695,2861,3556
25,25489,2018-12-31,685,2904,3589
25,25489,2019-12-31,743,2922,3665
25,25489,2020-12-31,798,2965,3763
25,25489,2021-12-31,937,2975,3912
25,25489,2022-12-31,1055,2981,4036
25,25489,2023-12-31,1163,2987,4150
25,25489,2024-12-31,1217,2992,4209
25,25489,2025-12-31,1260,3001,4261
25,25489,2026-12-31,1298,3011,4309
25,25489,2027-12-31,1328,3009,4337
25,25489,2028-12-31,1352,3028,4380
25,25489,2029-12-31,1391,3038,4429
25,25489,2030-12-31,1415,3035,4450
25,25489,2031-12-31,1432,3051,4483
25,25489,2032-12-31,1456,3082,4538
25,25489,2033-12-31,1475,3083,4558
25,25489,2034-12-31,1504,3086,4590
25,25489,2035-12-31,1519,3092,4611
25,25491,1985-12-31,2212,6805,9017
25,25491,1986-12-31,2101,6523,8624
25,25491,1987-12-31,2016,6261,8277
25,25491,1988-12-31,1877,6002,7879
25,25491,1989-12-31,1809,5768,7577
25,25491,1990-12-31,1761,5566,7327
25,25491,1991-12-31,1687,5354,7041
25,25491,1992-12-31,1613,5158,6771
25,25491,1993-12-31,1573,4975,6548
25,25491,1994-12-31,1543,4832,6375
25,25491,1995-12-31,1532,4670,6202
25,25491,1996-12-31,1469,4551,6020
25,25491,1997-12-31,1448,4436,5884
25,25491,1998-12-31,1427,4364,5791
25,25491,1999-12-31,1415,4276,5691
25,25491,2000-12-31,1414,4191,5605
25,25491,2001-12-31,1387,4114,5501
25,25491,2002-12-31,1381,4041,5422
25,25491,2003-12-31,1373,3979,5352
25,25491,2004-12-31,1385,3920,5305
25,25491,2005-12-31,1406,3880,5286
25,25491,2006-12-31,1427,3845,5272
25,25491,2007-12-31,1426,3820,5246
25,25491,2008-12-31,1438,3796,5234
25,25491,2009-12-31,1473,3794,5267
25,25491,2010-12-31,1490,3798,5288
25,25491,2011-12-31,1549,3828,5377
25,25491,2012-12-31,1552,3833,5385
25,25491,2013-12-31,1608,3864,5472
25,25491,2014-12-31,1667,3899,5566
25,25491,2015-12-31,1696,3932,5628
25,25491,2016-12-31,1751,4019,5770
25,25491,2017-12-31,1850,4055,5905
25,25491,2018-12-31,1918,4174,6092
25,25491,2019-12-31,2004,4313,6317
25,25491,2020-12-31,2103,4459,6562
25,25491,2021-12-31,2350,4473,6823
25,25491,2022-12-31,2554,4483,7037
25,25491,2023-12-31,2745,4492,7237
25,25491,2024-12-31,2851,4501,7352
25,25491,2025-12-31,2936,4506,7442
25,25491,2026-12-31,3029,4527,7556
25,25491,2027-12-31,3107,4533,7640
25,25491,2028-12-31,3164,4563,7727
25,25491,2029-12-31,3238,4560,7798
25,25491,2030-12-31,3294,4578,7872
25,25491,2031-12-31,3351,4602,7953
25,25491,2032-12-31,3398,4618,8016
25,25491,2033-12-31,3465,4635,8100
25,25491,2034-12-31,3508,4653,8161
25,25491,2035-12-31,3551,4680,8231
25,25506,1985-12-31,1397,5399,6796
25,25506,1986-12-31,1351,5137,6488
25,25506,1987-12-31,1238,4912,6150
25,25506,1988-12-31,1223,4722,5945
25,25506,1989-12-31,1135,4525,5660
25,25506,1990-12-31,1134,4334,5468
25,25506,1991-12-31,1075,4188,5263
25,25506,1992-12-31,1050,4029,5079
25,25506,1993-12-31,991,3865,4856
25,25506,1994-12-31,955,3745,4700
25,25506,1995-12-31,932,3618,4550
25,25506,1996-12-31,906,3507,4413
25,25506,1997-12-31,924,3403,4327
25,25506,1998-12-31,926,3358,4284
25,25506,1999-12-31,900,3279,4179
25,25506,2000-12-31,886,3201,4087
25,25506,2001-12-31,867,3137,4004
25,25506,2002-12-31,875,3085,3960
25,25506,2003-12-31,877,3022,3899
25,25506,2004-12-31,885,2973,3858
25,25506,2005-12-31,909,2926,3835
25,25506,2006-12-31,925,2882,3807
25,25506,2007-12-31,935,2857,3792
25,25506,2008-12-31,902,2827,3729
25,25506,2009-12-31,922,2827,3749
25,25506,2010-12-31,945,2819,3764
25,25506,2011-12-31,940,2827,3767
25,25506,2012-12-31,1000,2832,3832
25,25506,2013-12-31,1035,2852,3887
25,25506,2014-12-31,1053,2864,3917
25,25506,2015-12-31,1058,2896,3954
25,25506,2016-12-31,1095,2912,4007
25,25506,2017-12-31,1171,2955,4126
25,25506,2018-12-31,1202,3016,4218
25,25506,2019-12-31,1250,3070,4320
25,25506,2020-12-31,1306,3143,4449
25,25506,2021-12-31,1473,3153,4626
25,25506,2022-12-31,1611,3160,4771
25,25506,2023-12-31,1741,3166,4907
25,25506,2024-12-31,1811,3173,4984
25,25506,2025-12-31,1866,3182,5048
25,25506,2026-12-31,1923,3185,5108
25,25506,2027-12-31,1972,3203,5175
25,25506,2028-12-31,2016,3209,5225
25,25506,2029-12-31,2059,3213,5272
25,25506,2030-12-31,2090,3234,5324
25,25506,2031-12-31,2124,3241,5365
25,25506,2032-12-31,2167,3249,5416
25,25506,2033-12-31,2206,3264,5470
25,25506,2034-12-31,2230,3277,5507
25,25506,2035-12-31,2264,3278,5542
25,25513,1985-12-31,13516,23648,37164
25,25513,1986-12-31,12828,22548,35376
25,25513,1987-12-31,12251,21533,33784
25,25513,1988-12-31,11750,20589,32339
25,25513,1989-12-31,11294,19677,30971
25,25513,1990-12-31,10831,18827,29658
25,25513,1991-12-31,10479,18066,28545
25,25513,1992-12-31,10163,17287,27450
25,25513,1993-12-31,9861,16584,26445
25,25513,1994-12-31,9660,15992,25652
25,25513,1995-12-31,9484,15453,24937
25,25513,1996-12-31,9321,14932,24253
25,25513,1997-12-31,9196,14475,23671
25,25513,1998-12-31,9052,14191,23243
25,25513,1999-12-31,8984,13801,22785
25,25513,2000-12-31,8942,13445,22387
25,25513,2001-12-31,8911,13124,22035
25,25513,2002-12-31,8935,12833,21768
25,25513,2003-12-31,8943,12559,21502
25,25513,2004-12-31,8976,12304,21280
25,25513,2005-12-31,9044,12094,21138
25,25513,2006-12-31,9122,11886,21008
25,25513,2007-12-31,9245,11713,20958
25,25513,2008-12-31,9381,11582,20963
25,25513,2009-12-31,9558,11491,21049
25,25513,2010-12-31,9773,11421,21194
25,25513,2011-12-31,10022,11383,21405
25,25513,2012-12-31,10307,11338,21645
25,25513,2013-12-31,10584,11339,21923
25,25513,2014-12-31,10920,11345,22265
25,25513,2015-12-31,11281,11376,22657
25,25513,2016-12-31,11698,11442,23140
25,25513,2017-12-31,12140,11520,23660
25,25513,2018-12-31,12714,11699,24413
25,25513,2019-12-31,13385,11661,25046
25,25513,2020-12-31,14127,11676,25803
25,25513,2021-12-31,15117,11711,26828
25,25513,2022-12-31,15935,11737,27672
25,25513,2023-12-31,16699,11759,28458
25,25513,2024-12-31,17276,11771,29047
25,25513,2025-12-31,17818,11807,29625
25,25513,2026-12-31,18316,11838,30154
25,25513,2027-12-31,18768,11857,30625
25,25513,2028-12-31,19199,11900,31099
25,25513,2029-12-31,19593,11943,31536
25,25513,2030-12-31,19940,11983,31923
25,25513,2031-12-31,20271,12029,32300
25,25513,2032-12-31,20594,12083,32677
25,25513,2033-12-31,20912,12114,33026
25,25513,2034-12-31,21229,12159,33388
25,25513,2035-12-31,21539,12200,33739
25,25518,1985-12-31,1090,9139,10229
25,25518,1986-12-31,1001,8691,9692
25,25518,1987-12-31,896,8282,9178
25,25518,1988-12-31,849,7883,8732
25,25518,1989-12-31,829,7505,8334
25,25518,1990-12-31,784,7151,7935
25,25518,1991-12-31,801,6836,7637
25,25518,1992-12-31,738,6501,7239
25,25518,1993-12-31,698,6223,6921
25,25518,1994-12-31,673,5971,6644
25,25518,1995-12-31,630,5746,6376
25,25518,1996-12-31,616,5519,6135
25,25518,1997-12-31,597,5334,5931
25,25518,1998-12-31,571,5200,5771
25,25518,1999-12-31,566,5041,5607
25,25518,2000-12-31,547,4879,5426
25,25518,2001-12-31,521,4737,5258
25,25518,2002-12-31,509,4610,5119
25,25518,2003-12-31,495,4491,4986
25,25518,2004-12-31,511,4365,4876
25,25518,2005-12-31,469,4264,4733
25,25518,2006-12-31,459,4162,4621
25,25518,2007-12-31,452,4084,4536
25,25518,2008-12-31,443,4005,4448
25,25518,2009-12-31,437,3936,4373
25,25518,2010-12-31,442,3873,4315
25,25518,2011-12-31,442,3825,4267
25,25518,2012-12-31,431,3778,4209
25,25518,2013-12-31,459,3748,4207
25,25518,2014-12-31,493,3723,4216
25,25518,2015-12-31,538,3694,4232
25,25518,2016-12-31,503,3684,4187
25,25518,2017-12-31,479,3641,4120
25,25518,2018-12-31,507,3679,4186
25,25518,2019-12-31,509,3697,4206
25,25518,2020-12-31,519,3760,4279
25,25518,2021-12-31,677,3772,4449
25,25518,2022-12-31,809,3780,4589
25,25518,2023-12-31,931,3788,4719
25,25518,2024-12-31,974,3802,4776
25,25518,2025-12-31,1004,3804,4808
25,25518,2026-12-31,1025,3817,4842
25,25518,2027-12-31,1059,3829,4888
25,25518,2028-12-31,1085,3838,4923
25,25518,2029-12-31,1110,3854,4964
25,25518,2030-12-31,1135,3857,4992
25,25518,2031-12-31,1156,3881,5037
25,25518,2032-12-31,1164,3898,5062
25,25518,2033-12-31,1181,3899,5080
25,25518,2034-12-31,1195,3925,5120
25,25518,2035-12-31,1222,3935,5157
25,25524,1985-12-31,1233,5277,6510
25,25524,1986-12-31,1219,5074,6293
25,25524,1987-12-31,1171,4914,6085
25,25524,1988-12-31,1024,4707,5731
25,25524,1989-12-31,1009,4563,5572
25,25524,1990-12-31,1001,4384,5385
25,25524,1991-12-31,965,4266,5231
25,25524,1992-12-31,911,4135,5046
25,25524,1993-12-31,898,3996,4894
25,25524,1994-12-31,886,3932,4818
25,25524,1995-12-31,864,3779,4643
25,25524,1996-12-31,798,3702,4500
25,25524,1997-12-31,819,3619,4438
25,25524,1998-12-31,823,3594,4417
25,25524,1999-12-31,798,3528,4326
25,25524,2000-12-31,799,3498,4297
25,25524,2001-12-31,786,3452,4238
25,25524,2002-12-31,792,3414,4206
25,25524,2003-12-31,775,3369,4144
25,25524,2004-12-31,785,3346,4131
25,25524,2005-12-31,805,3309,4114
25,25524,2006-12-31,805,3314,4119
25,25524,2007-12-31,795,3309,4104
25,25524,2008-12-31,792,3319,4111
25,25524,2009-12-31,823,3337,4160
25,25524,2010-12-31,876,3365,4241
25,25524,2011-12-31,860,3394,4254
25,25524,2012-12-31,889,3417,4306
25,25524,2013-12-31,900,3481,4381
25,25524,2014-12-31,917,3540,4457
25,25524,2015-12-31,938,3594,4532
25,25524,2016-12-31,1052,3663,4715
25,25524,2017-12-31,1055,3771,4826
25,25524,2018-12-31,1097,3876,4973
25,25524,2019-12-31,1148,3998,5146
25,25524,2020-12-31,1207,4127,5334
25,25524,2021-12-31,1406,4140,5546
25,25524,2022-12-31,1571,4149,5720
25,25524,2023-12-31,1726,4157,5883
25,25524,2024-12-31,1795,4157,5952
25,25524,2025-12-31,1845,4175,6020
25,25524,2026-12-31,1910,4176,6086
25,25524,2027-12-31,1957,4189,6146
25,25524,2028-12-31,2002,4216,6218
25,25524,2029-12-31,2035,4222,6257
25,25524,2030-12-31,2065,4245,6310
25,25524,2031-12-31,2115,4264,6379
25,25524,2032-12-31,2140,4269,6409
25,25524,2033-12-31,2170,4298,6468
25,25524,2034-12-31,2206,4307,6513
25,25524,2035-12-31,2246,4317,6563
25,25530,1985-12-31,1325,4768,6093
25,25530,1986-12-31,1356,4636,5992
25,25530,1987-12-31,1367,4517,5884
25,25530,1988-12-31,1391,4414,5805
25,25530,1989-12-31,1359,4292,5651
25,25530,1990-12-31,1375,4195,5570
25,25530,1991-12-31,1410,4110,5520
25,25530,1992-12-31,1417,4023,5440
25,25530,1993-12-31,1445,3952,5397
25,25530,1994-12-31,1456,3875,5331
25,25530,1995-12-31,1481,3828,5309
25,25530,1996-12-31,1496,3775,5271
25,25530,1997-12-31,1543,3736,5279
25,25530,1998-12-31,1573,3742,5315
25,25530,1999-12-31,1603,3726,5329
25,25530,2000-12-31,1644,3696,5340
25,25530,2001-12-31,1691,3690,5381
25,25530,2002-12-31,1733,3673,5406
25,25530,2003-12-31,1760,3687,5447
25,25530,2004-12-31,1818,3681,5499
25,25530,2005-12-31,1847,3706,5553
25,25530,2006-12-31,1953,3731,5684
25,25530,2007-12-31,2015,3737,5752
25,25530,2008-12-31,2105,3809,5914
25,25530,2009-12-31,2202,3850,6052
25,25530,2010-12-31,2276,3905,6181
25,25530,2011-12-31,2388,4012,6400
25,25530,2012-12-31,2500,4094,6594
25,25530,2013-12-31,2633,4202,6835
25,25530,2014-12-31,2761,4301,7062
25,25530,2015-12-31,2910,4393,7303
25,25530,2016-12-31,3072,4514,7586
25,25530,2017-12-31,3235,4704,7939
25,25530,2018-12-31,3455,4873,8328
25,25530,2019-12-31,3746,5040,8786
25,25530,2020-12-31,4028,5190,9218
25,25530,2021-12-31,4377,5207,9584
25,25530,2022-12-31,4668,5218,9886
25,25530,2023-12-31,4939,5228,10167
25,25530,2024-12-31,5148,5237,10385
25,25530,2025-12-31,5310,5258,10568
25,25530,2026-12-31,5469,5264,10733
25,25530,2027-12-31,5610,5285,10895
25,25530,2028-12-31,5738,5293,11031
25,25530,2029-12-31,5865,5324,11189
25,25530,2030-12-31,5967,5353,11320
25,25530,2031-12-31,6078,5368,11446
25,25530,2032-12-31,6178,5380,11558
25,25530,2033-12-31,6268,5404,11672
25,25530,2034-12-31,6359,5419,11778
25,25530,2035-12-31,6450,5446,11896
25,25535,1985-12-31,2869,11725,14594
25,25535,1986-12-31,2750,11203,13953
25,25535,1987-12-31,2608,10743,13351
25,25535,1988-12-31,2505,10266,12771
25,25535,1989-12-31,2387,9834,12221
25,25535,1990-12-31,2304,9411,11715
25,25535,1991-12-31,2234,9035,11269
25,25535,1992-12-31,2175,8687,10862
25,25535,1993-12-31,2127,8349,10476
25,25535,1994-12-31,2066,8056,10122
25,25535,1995-12-31,2030,7822,9852
25,25535,1996-12-31,1997,7569,9566
25,25535,1997-12-31,1969,7368,9337
25,25535,1998-12-31,1945,7239,9184
25,25535,1999-12-31,1927,7065,8992
25,25535,2000-12-31,1932,6910,8842
25,25535,2001-12-31,1939,6763,8702
25,25535,2002-12-31,1931,6617,8548
25,25535,2003-12-31,1931,6500,8431
25,25535,2004-12-31,1926,6376,8302
25,25535,2005-12-31,1958,6259,8217
25,25535,2006-12-31,1978,6192,8170
25,25535,2007-12-31,2004,6129,8133
25,25535,2008-12-31,2019,6065,8084
25,25535,2009-12-31,2061,6044,8105
25,25535,2010-12-31,2106,6027,8133
25,25535,2011-12-31,2164,6021,8185
25,25535,2012-12-31,2206,6032,8238
25,25535,2013-12-31,2295,6041,8336
25,25535,2014-12-31,2349,6059,8408
25,25535,2015-12-31,2445,6098,8543
25,25535,2016-12-31,2533,6158,8691
25,25535,2017-12-31,2611,6230,8841
25,25535,2018-12-31,2763,6342,9105
25,25535,2019-12-31,2907,6434,9341
25,25535,2020-12-31,3065,6561,9626
25,25535,2021-12-31,3426,6582,10008
25,25535,2022-12-31,3726,6597,10323
25,25535,2023-12-31,4008,6609,10617
25,25535,2024-12-31,4163,6619,10782
25,25535,2025-12-31,4294,6645,10939
25,25535,2026-12-31,4417,6653,11070
25,25535,2027-12-31,4527,6673,11200
25,25535,2028-12-31,4634,6712,11346
25,25535,2029-12-31,4730,6721,11451
25,25535,2030-12-31,4824,6751,11575
25,25535,2031-12-31,4895,6792,11687
25,25535,2032-12-31,4987,6806,11793
25,25535,2033-12-31,5049,6823,11872
25,25535,2034-12-31,5138,6854,11992
25,25535,2035-12-31,5206,6879,12085
25,25572,1985-12-31,10667,7026,17693
25,25572,1986-12-31,10177,6747,16924
25,25572,1987-12-31,9758,6468,16226
25,25572,1988-12-31,9388,6194,15582
25,25572,1989-12-31,9049,5937,14986
25,25572,1990-12-31,8690,5731,14421
25,25572,1991-12-31,8444,5518,13962
25,25572,1992-12-31,8221,5329,13550
25,25572,1993-12-31,8025,5140,13165
25,25572,1994-12-31,7864,4990,12854
25,25572,1995-12-31,7749,4847,12596
25,25572,1996-12-31,7649,4703,12352
25,25572,1997-12-31,7571,4586,12157
25,25572,1998-12-31,7476,4528,12004
25,25572,1999-12-31,7430,4439,11869
25,25572,2000-12-31,7420,4359,11779
25,25572,2001-12-31,7419,4276,11695
25,25572,2002-12-31,7451,4208,11659
25,25572,2003-12-31,7475,4146,11621
25,25572,2004-12-31,7539,4084,11623
25,25572,2005-12-31,7594,4042,11636
25,25572,2006-12-31,7696,4009,11705
25,25572,2007-12-31,7814,3980,11794
25,25572,2008-12-31,7962,3962,11924
25,25572,2009-12-31,8140,3965,12105
25,25572,2010-12-31,8350,3972,12322
25,25572,2011-12-31,8571,3996,12567
25,25572,2012-12-31,8847,4012,12859
25,25572,2013-12-31,9106,4056,13162
25,25572,2014-12-31,9423,4099,13522
25,25572,2015-12-31,9759,4137,13896
25,25572,2016-12-31,10128,4192,14320
25,25572,2017-12-31,10562,4265,14827
25,25572,2018-12-31,11082,4371,15453
25,25572,2019-12-31,11696,4362,16058
25,25572,2020-12-31,12352,4319,16671
25,25572,2021-12-31,13001,4332,17333
25,25572,2022-12-31,13536,4342,17878
25,25572,2023-12-31,14037,4350,18387
25,25572,2024-12-31,14490,4356,18846
25,25572,2025-12-31,14918,4375,19293
25,25572,2026-12-31,15341,4386,19727
25,25572,2027-12-31,15726,4402,20128
25,25572,2028-12-31,16087,4416,20503
25,25572,2029-12-31,16401,4427,20828
25,25572,2030-12-31,16695,4450,21145
25,25572,2031-12-31,16963,4460,21423
25,25572,2032-12-31,17240,4497,21737
25,25572,2033-12-31,17510,4513,22023
25,25572,2034-12-31,17768,4520,22288
25,25572,2035-12-31,18028,4537,22565
25,25580,1985-12-31,843,5549,6392
25,25580,1986-12-31,766,5314,6080
25,25580,1987-12-31,682,5079,5761
25,25580,1988-12-31,662,4804,5466
25,25580,1989-12-31,680,4594,5274
25,25580,1990-12-31,675,4412,5087
25,25580,1991-12-31,660,4232,4892
25,25580,1992-12-31,618,4035,4653
25,25580,1993-12-31,588,3874,4462
25,25580,1994-12-31,539,3715,4254
25,25580,1995-12-31,495,3594,4089
25,25580,1996-12-31,489,3493,3982
25,25580,1997-12-31,486,3366,3852
25,25580,1998-12-31,492,3310,3802
25,25580,1999-12-31,499,3214,3713
25,25580,2000-12-31,537,3134,3671
25,25580,2001-12-31,533,3035,3568
25,25580,2002-12-31,533,2958,3491
25,25580,2003-12-31,527,2891,3418
25,25580,2004-12-31,473,2840,3313
25,25580,2005-12-31,492,2794,3286
25,25580,2006-12-31,493,2729,3222
25,25580,2007-12-31,498,2700,3198
25,25580,2008-12-31,494,2663,3157
25,25580,2009-12-31,499,2620,3119
25,25580,2010-12-31,512,2607,3119
25,25580,2011-12-31,520,2588,3108
25,25580,2012-12-31,539,2600,3139
25,25580,2013-12-31,548,2569,3117
25,25580,2014-12-31,601,2581,3182
25,25580,2015-12-31,611,2592,3203
25,25580,2016-12-31,650,2577,3227
25,25580,2017-12-31,652,2631,3283
25,25580,2018-12-31,679,2648,3327
25,25580,2019-12-31,709,2660,3369
25,25580,2020-12-31,742,2696,3438
25,25580,2021-12-31,870,2705,3575
25,25580,2022-12-31,976,2711,3687
25,25580,2023-12-31,1076,2716,3792
25,25580,2024-12-31,1116,2726,3842
25,25580,2025-12-31,1151,2715,3866
25,25580,2026-12-31,1193,2716,3909
25,25580,2027-12-31,1225,2717,3942
25,25580,2028-12-31,1249,2720,3969
25,25580,2029-12-31,1274,2730,4004
25,25580,2030-12-31,1297,2730,4027
25,25580,2031-12-31,1318,2729,4047
25,25580,2032-12-31,1340,2729,4069
25,25580,2033-12-31,1362,2735,4097
25,25580,2034-12-31,1374,2731,4105
25,25580,2035-12-31,1400,2728,4128
25,25592,1985-12-31,467,8250,8717
25,25592,1986-12-31,458,7866,8324
25,25592,1987-12-31,377,7529,7906
25,25592,1988-12-31,348,7193,7541
25,25592,1989-12-31,370,6866,7236
25,25592,1990-12-31,346,6598,6944
25,25592,1991-12-31,366,6323,6689
25,25592,1992-12-31,343,6075,6418
25,25592,1993-12-31,320,5832,6152
25,25592,1994-12-31,347,5635,5982
25,25592,1995-12-31,291,5453,5744
25,25592,1996-12-31,383,5264,5647
25,25592,1997-12-31,388,5115,5503
25,25592,1998-12-31,360,5010,5370
25,25592,1999-12-31,289,4898,5187
25,25592,2000-12-31,275,4779,5054
25,25592,2001-12-31,302,4670,4972
25,25592,2002-12-31,306,4570,4876
25,25592,2003-12-31,269,4467,4736
25,25592,2004-12-31,275,4397,4672
25,25592,2005-12-31,301,4325,4626
25,25592,2006-12-31,298,4256,4554
25,25592,2007-12-31,299,4210,4509
25,25592,2008-12-31,298,4178,4476
25,25592,2009-12-31,300,4139,4439
25,25592,2010-12-31,300,4126,4426
25,25592,2011-12-31,307,4112,4419
25,25592,2012-12-31,411,4112,4523
25,25592,2013-12-31,344,4100,4444
25,25592,2014-12-31,377,4112,4489
25,25592,2015-12-31,373,4150,4523
25,25592,2016-12-31,389,4182,4571
25,25592,2017-12-31,405,4192,4597
25,25592,2018-12-31,426,4298,4724
25,25592,2019-12-31,444,4363,4807
25,25592,2020-12-31,465,4462,4927
25,25592,2021-12-31,647,4476,5123
25,25592,2022-12-31,798,4486,5284
25,25592,2023-12-31,939,4495,5434
25,25592,2024-12-31,990,4503,5493
25,25592,2025-12-31,1027,4520,5547
25,25592,2026-12-31,1055,4530,5585
25,25592,2027-12-31,1077,4547,5624
25,25592,2028-12-31,1106,4548,5654
25,25592,2029-12-31,1125,4572,5697
25,25592,2030-12-31,1144,4595,5739
25,25592,2031-12-31,1162,4611,5773
25,25592,2032-12-31,1190,4626,5816
25,25592,2033-12-31,1203,4630,5833
25,25592,2034-12-31,1225,4662,5887
25,25592,2035-12-31,1240,4663,5903
25,25594,1985-12-31,1373,7406,8779
25,25594,1986-12-31,1337,7079,8416
25,25594,1987-12-31,1224,6758,7982
25,25594,1988-12-31,1216,6461,7677
25,25594,1989-12-31,1162,6173,7335
25,25594,1990-12-31,1142,5954,7096
25,25594,1991-12-31,1118,5674,6792
25,25594,1992-12-31,1056,5438,6494
25,25594,1993-12-31,1027,5198,6225
25,25594,1994-12-31,1001,5036,6037
25,25594,1995-12-31,998,4852,5850
25,25594,1996-12-31,973,4694,5667
25,25594,1997-12-31,955,4556,5511
25,25594,1998-12-31,941,4469,5410
25,25594,1999-12-31,948,4353,5301
25,25594,2000-12-31,945,4236,5181
25,25594,2001-12-31,942,4152,5094
25,25594,2002-12-31,955,4065,5020
25,25594,2003-12-31,937,3982,4919
25,25594,2004-12-31,958,3885,4843
25,25594,2005-12-31,982,3807,4789
25,25594,2006-12-31,986,3762,4748
25,25594,2007-12-31,996,3708,4704
25,25594,2008-12-31,989,3677,4666
25,25594,2009-12-31,1026,3632,4658
25,25594,2010-12-31,1039,3608,4647
25,25594,2011-12-31,1059,3607,4666
25,25594,2012-12-31,1084,3606,4690
25,25594,2013-12-31,1120,3591,4711
25,25594,2014-12-31,1144,3601,4745
25,25594,2015-12-31,1209,3601,4810
25,25594,2016-12-31,1235,3657,4892
25,25594,2017-12-31,1294,3646,4940
25,25594,2018-12-31,1358,3714,5072
25,25594,2019-12-31,1426,3750,5176
25,25594,2020-12-31,1500,3815,5315
25,25594,2021-12-31,1699,3827,5526
25,25594,2022-12-31,1864,3836,5700
25,25594,2023-12-31,2019,3843,5862
25,25594,2024-12-31,2101,3851,5952
25,25594,2025-12-31,2164,3859,6023
25,25594,2026-12-31,2229,3881,6110
25,25594,2027-12-31,2283,3877,6160
25,25594,2028-12-31,2346,3893,6239
25,25594,2029-12-31,2383,3915,6298
25,25594,2030-12-31,2435,3926,6361
25,25594,2031-12-31,2473,3941,6414
25,25594,2032-12-31,2511,3951,6462
25,25594,2033-12-31,2556,3968,6524
25,25594,2034-12-31,2594,3981,6575
25,25594,2035-12-31,2620,4007,6627
25,25596,1985-12-31,1180,13105,14285
25,25596,1986-12-31,1107,12470,13577
25,25596,1987-12-31,1033,11883,12916
25,25596,1988-12-31,889,11337,12226
25,25596,1989-12-31,905,10814,11719
25,25596,1990-12-31,902,10334,11236
25,25596,1991-12-31,837,9861,10698
25,25596,1992-12-31,784,9416,10200
25,25596,1993-12-31,774,9014,9788
25,25596,1994-12-31,715,8661,9376
25,25596,1995-12-31,719,8329,9048
25,25596,1996-12-31,670,8046,8716
25,25596,1997-12-31,692,7770,8462
25,25596,1998-12-31,630,7584,8214
25,25596,1999-12-31,658,7351,8009
25,25596,2000-12-31,610,7141,7751
25,25596,2001-12-31,584,6935,7519
25,25596,2002-12-31,583,6754,7337
25,25596,2003-12-31,574,6583,7157
25,25596,2004-12-31,588,6422,7010
25,25596,2005-12-31,587,6278,6865
25,25596,2006-12-31,561,6143,6704
25,25596,2007-12-31,592,6023,6615
25,25596,2008-12-31,583,5934,6517
25,25596,2009-12-31,536,5855,6391
25,25596,2010-12-31,583,5793,6376
25,25596,2011-12-31,543,5731,6274
25,25596,2012-12-31,551,5676,6227
25,25596,2013-12-31,555,5645,6200
25,25596,2014-12-31,615,5618,6233
25,25596,2015-12-31,665,5597,6262
25,25596,2016-12-31,626,5590,6216
25,25596,2017-12-31,621,5599,6220
25,25596,2018-12-31,656,5635,6291
25,25596,2019-12-31,667,5713,6380
25,25596,2020-12-31,688,5848,6536
25,25596,2021-12-31,929,5867,6796
25,25596,2022-12-31,1129,5880,7009
25,25596,2023-12-31,1318,5891,7209
25,25596,2024-12-31,1374,5897,7271
25,25596,2025-12-31,1431,5912,7343
25,25596,2026-12-31,1468,5933,7401
25,25596,2027-12-31,1509,5947,7456
25,25596,2028-12-31,1538,5969,7507
25,25596,2029-12-31,1575,5992,7567
25,25596,2030-12-31,1614,6004,7618
25,25596,2031-12-31,1631,6037,7668
25,25596,2032-12-31,1662,6049,7711
25,25596,2033-12-31,1682,6064,7746
25,25596,2034-12-31,1710,6080,7790
25,25596,2035-12-31,1721,6104,7825
25,25599,1985-12-31,4766,6260,11026
25,25599,1986-12-31,4502,6026,10528
25,25599,1987-12-31,4256,5830,10086
25,25599,1988-12-31,4070,5622,9692
25,25599,1989-12-31,3833,5454,9287
25,25599,1990-12-31,3669,5253,8922
25,25599,1991-12-31,3501,5072,8573
25,25599,1992-12-31,3402,4906,8308
25,25599,1993-12-31,3272,4744,8016
25,25599,1994-12-31,3184,4638,7822
25,25599,1995-12-31,3109,4532,7641
25,25599,1996-12-31,3026,4421,7447
25,25599,1997-12-31,2978,4344,7322
25,25599,1998-12-31,2903,4302,7205
25,25599,1999-12-31,2900,4222,7122
25,25599,2000-12-31,2825,4171,6996
25,25599,2001-12-31,2831,4116,6947
25,25599,2002-12-31,2786,4071,6857
25,25599,2003-12-31,2754,4037,6791
25,25599,2004-12-31,2739,4005,6744
25,25599,2005-12-31,2755,3971,6726
25,25599,2006-12-31,2780,3958,6738
25,25599,2007-12-31,2758,3954,6712
25,25599,2008-12-31,2785,3968,6753
25,25599,2009-12-31,2837,3978,6815
25,25599,2010-12-31,2875,4016,6891
25,25599,2011-12-31,2916,4076,6992
25,25599,2012-12-31,2981,4125,7106
25,25599,2013-12-31,3056,4168,7224
25,25599,2014-12-31,3112,4245,7357
25,25599,2015-12-31,3200,4311,7511
25,25599,2016-12-31,3270,4407,7677
25,25599,2017-12-31,3375,4515,7890
25,25599,2018-12-31,3539,4653,8192
25,25599,2019-12-31,3667,4790,8457
25,25599,2020-12-31,3827,4920,8747
25,25599,2021-12-31,4158,4936,9094
25,25599,2022-12-31,4434,4947,9381
25,25599,2023-12-31,4691,4956,9647
25,25599,2024-12-31,4857,4964,9821
25,25599,2025-12-31,5014,4971,9985
25,25599,2026-12-31,5143,4995,10138
25,25599,2027-12-31,5268,5005,10273
25,25599,2028-12-31,5404,5023,10427
25,25599,2029-12-31,5526,5045,10571
25,25599,2030-12-31,5608,5066,10674
25,25599,2031-12-31,5702,5069,10771
25,25599,2032-12-31,5797,5103,10900
25,25599,2033-12-31,5873,5124,10997
25,25599,2034-12-31,5984,5136,11120
25,25599,2035-12-31,6052,5155,11207
25,25612,1985-12-31,1794,5412,7206
25,25612,1986-12-31,1891,5252,7143
25,25612,1987-12-31,1971,5154,7125
25,25612,1988-12-31,2036,5026,7062
25,25612,1989-12-31,2110,4947,7057
25,25612,1990-12-31,2188,4810,6998
25,25612,1991-12-31,2229,4735,6964
25,25612,1992-12-31,2328,4661,6989
25,25612,1993-12-31,2392,4603,6995
25,25612,1994-12-31,2444,4481,6925
25,25612,1995-12-31,2550,4459,7009
25,25612,1996-12-31,2632,4398,7030
25,25612,1997-12-31,2721,4376,7097
25,25612,1998-12-31,2788,4393,7181
25,25612,1999-12-31,2881,4385,7266
25,25612,2000-12-31,2967,4378,7345
25,25612,2001-12-31,3073,4364,7437
25,25612,2002-12-31,3185,4364,7549
25,25612,2003-12-31,3310,4387,7697
25,25612,2004-12-31,3417,4394,7811
25,25612,2005-12-31,3549,4416,7965
25,25612,2006-12-31,3700,4469,8169
25,25612,2007-12-31,3838,4515,8353
25,25612,2008-12-31,4009,4577,8586
25,25612,2009-12-31,4216,4644,8860
25,25612,2010-12-31,4423,4727,9150
25,25612,2011-12-31,4634,4854,9488
25,25612,2012-12-31,4896,4971,9867
25,25612,2013-12-31,5152,5071,10223
25,25612,2014-12-31,5418,5251,10669
25,25612,2015-12-31,5728,5376,11104
25,25612,2016-12-31,6056,5565,11621
25,25612,2017-12-31,6424,5780,12204
25,25612,2018-12-31,6867,6014,12881
25,25612,2019-12-31,7533,6119,13652
25,25612,2020-12-31,8162,6205,14367
25,25612,2021-12-31,8716,6225,14941
25,25612,2022-12-31,9172,6239,15411
25,25612,2023-12-31,9598,6251,15849
25,25612,2024-12-31,9991,6254,16245
25,25612,2025-12-31,10346,6274,16620
25,25612,2026-12-31,10692,6294,16986
25,25612,2027-12-31,11007,6319,17326
25,25612,2028-12-31,11271,6339,17610
25,25612,2029-12-31,11522,6352,17874
25,25612,2030-12-31,11739,6386,18125
25,25612,2031-12-31,11953,6409,18362
25,25612,2032-12-31,12141,6422,18563
25,25612,2033-12-31,12348,6447,18795
25,25612,2034-12-31,12536,6481,19017
25,25612,2035-12-31,12736,6512,19248
25,25645,1985-12-31,638,12993,13631
25,25645,1986-12-31,670,12548,13218
25,25645,1987-12-31,641,12149,12790
25,25645,1988-12-31,565,11766,12331
25,25645,1989-12-31,565,11413,11978
25,25645,1990-12-31,590,11068,11658
25,25645,1991-12-31,614,10740,11354
25,25645,1992-12-31,597,10428,11025
25,25645,1993-12-31,560,10155,10715
25,25645,1994-12-31,556,9939,10495
25,25645,1995-12-31,565,9718,10283
25,25645,1996-12-31,577,9539,10116
25,25645,1997-12-31,562,9398,9960
25,25645,1998-12-31,551,9363,9914
25,25645,1999-12-31,542,9242,9784
25,25645,2000-12-31,530,9145,9675
25,25645,2001-12-31,538,9053,9591
25,25645,2002-12-31,531,8994,9525
25,25645,2003-12-31,536,8948,9484
25,25645,2004-12-31,541,8920,9461
25,25645,2005-12-31,568,8895,9463
25,25645,2006-12-31,597,8892,9489
25,25645,2007-12-31,597,8933,9530
25,25645,2008-12-31,642,8974,9616
25,25645,2009-12-31,658,9060,9718
25,25645,2010-12-31,672,9162,9834
25,25645,2011-12-31,685,9291,9976
25,25645,2012-12-31,720,9436,10156
25,25645,2013-12-31,736,9619,10355
25,25645,2014-12-31,758,9815,10573
25,25645,2015-12-31,795,10033,10828
25,25645,2016-12-31,820,10289,11109
25,25645,2017-12-31,851,10577,11428
25,25645,2018-12-31,907,10963,11870
25,25645,2019-12-31,969,11371,12340
25,25645,2020-12-31,1031,11798,12829
25,25645,2021-12-31,1503,11836,13339
25,25645,2022-12-31,1896,11862,13758
25,25645,2023-12-31,2264,11885,14149
25,25645,2024-12-31,2393,11904,14297
25,25645,2025-12-31,2490,11940,14430
25,25645,2026-12-31,2551,11963,14514
25,25645,2027-12-31,2626,12001,14627
25,25645,2028-12-31,2683,12042,14725
25,25645,2029-12-31,2731,12076,14807
25,25645,2030-12-31,2796,12118,14914
25,25645,2031-12-31,2832,12170,15002
25,25645,2032-12-31,2869,12222,15091
25,25645,2033-12-31,2919,12260,15179
25,25645,2034-12-31,2972,12295,15267
25,25645,2035-12-31,3009,12340,15349
25,25649,1985-12-31,4591,13576,18167
25,25649,1986-12-31,4345,12888,17233
25,25649,1987-12-31,4125,12246,16371
25,25649,1988-12-31,3928,11646,15574
25,25649,1989-12-31,3739,11071,14810
25,25649,1990-12-31,3551,10551,14102
25,25649,1991-12-31,3446,10029,13475
25,25649,1992-12-31,3313,9575,12888
25,25649,1993-12-31,3192,9127,12319
25,25649,1994-12-31,3098,8757,11855
25,25649,1995-12-31,3024,8414,11438
25,25649,1996-12-31,2975,8087,11062
25,25649,1997-12-31,2889,7785,10674
25,25649,1998-12-31,2831,7595,10426
25,25649,1999-12-31,2796,7325,10121
25,25649,2000-12-31,2764,7091,9855
25,25649,2001-12-31,2745,6868,9613
25,25649,2002-12-31,2716,6664,9380
25,25649,2003-12-31,2701,6454,9155
25,25649,2004-12-31,2703,6272,8975
25,25649,2005-12-31,2695,6100,8795
25,25649,2006-12-31,2702,5936,8638
25,25649,2007-12-31,2718,5796,8514
25,25649,2008-12-31,2743,5681,8424
25,25649,2009-12-31,2794,5574,8368
25,25649,2010-12-31,2812,5474,8286
25,25649,2011-12-31,2878,5380,8258
25,25649,2012-12-31,2936,5316,8252
25,25649,2013-12-31,3000,5235,8235
25,25649,2014-12-31,3069,5157,8226
25,25649,2015-12-31,3162,5102,8264
25,25649,2016-12-31,3274,5036,8310
25,25649,2017-12-31,3335,5029,8364
25,25649,2018-12-31,3488,4999,8487
25,25649,2019-12-31,3664,5039,8703
25,25649,2020-12-31,3866,5118,8984
25,25649,2021-12-31,4206,5135,9341
25,25649,2022-12-31,4489,5146,9635
25,25649,2023-12-31,4753,5156,9909
25,25649,2024-12-31,4932,5168,10100
25,25649,2025-12-31,5082,5191,10273
25,25649,2026-12-31,5225,5192,10417
25,25649,2027-12-31,5364,5205,10569
25,25649,2028-12-31,5486,5232,10718
25,25649,2029-12-31,5600,5252,10852
25,25649,2030-12-31,5690,5264,10954
25,25649,2031-12-31,5800,5292,11092
25,25649,2032-12-31,5893,5309,11202
25,25649,2033-12-31,5975,5328,11303
25,25649,2034-12-31,6072,5343,11415
25,25649,2035-12-31,6154,5348,11502
25,25653,1985-12-31,361,9130,9491
25,25653,1986-12-31,318,8687,9005
25,25653,1987-12-31,319,8278,8597
25,25653,1988-12-31,276,7898,8174
25,25653,1989-12-31,289,7547,7836
25,25653,1990-12-31,340,7220,7560
25,25653,1991-12-31,351,6918,7269
25,25653,1992-12-31,345,6604,6949
25,25653,1993-12-31,362,6332,6694
25,25653,1994-12-31,362,6127,6489
25,25653,1995-12-31,338,5890,6228
25,25653,1996-12-31,343,5674,6017
25,25653,1997-12-31,343,5511,5854
25,25653,1998-12-31,347,5386,5733
25,25653,1999-12-31,355,5244,5599
25,25653,2000-12-31,347,5101,5448
25,25653,2001-12-31,341,4972,5313
25,25653,2002-12-31,357,4836,5193
25,25653,2003-12-31,369,4729,5098
25,25653,2004-12-31,375,4623,4998
25,25653,2005-12-31,368,4531,4899
25,25653,2006-12-31,383,4449,4832
25,25653,2007-12-31,386,4374,4760
25,25653,2008-12-31,389,4317,4706
25,25653,2009-12-31,389,4267,4656
25,25653,2010-12-31,384,4251,4635
25,25653,2011-12-31,386,4214,4600
25,25653,2012-12-31,445,4205,4650
25,25653,2013-12-31,461,4173,4634
25,25653,2014-12-31,497,4170,4667
25,25653,2015-12-31,528,4176,4704
25,25653,2016-12-31,548,4173,4721
25,25653,2017-12-31,570,4182,4752
25,25653,2018-12-31,601,4245,4846
25,25653,2019-12-31,643,4249,4892
25,25653,2020-12-31,687,4291,4978
25,25653,2021-12-31,883,4293,5176
25,25653,2022-12-31,1038,4301,5339
25,25653,2023-12-31,1181,4309,5490
25,25653,2024-12-31,1244,4307,5551
25,25653,2025-12-31,1279,4327,5606
25,25653,2026-12-31,1313,4342,5655
25,25653,2027-12-31,1357,4356,5713
25,25653,2028-12-31,1380,4358,5738
25,25653,2029-12-31,1411,4379,5790
25,25653,2030-12-31,1437,4404,5841
25,25653,2031-12-31,1452,4418,5870
25,25653,2032-12-31,1482,4437,5919
25,25653,2033-12-31,1502,4448,5950
25,25653,2034-12-31,1518,4455,5973
25,25653,2035-12-31,1540,4473,6013
25,25658,1985-12-31,2834,6532,9366
25,25658,1986-12-31,2748,6362,9110
25,25658,1987-12-31,2703,6173,8876
25,25658,1988-12-31,2586,6019,8605
25,25658,1989-12-31,2573,5820,8393
25,25658,1990-12-31,2498,5701,8199
25,25658,1991-12-31,2470,5550,8020
25,25658,1992-12-31,2440,5429,7869
25,25658,1993-12-31,2436,5286,7722
25,25658,1994-12-31,2402,5214,7616
25,25658,1995-12-31,2412,5128,7540
25,25658,1996-12-31,2418,5050,7468
25,25658,1997-12-31,2406,5002,7408
25,25658,1998-12-31,2392,4997,7389
25,25658,1999-12-31,2437,4950,7387
25,25658,2000-12-31,2470,4940,7410
25,25658,2001-12-31,2499,4912,7411
25,25658,2002-12-31,2546,4893,7439
25,25658,2003-12-31,2585,4897,7482
25,25658,2004-12-31,2637,4899,7536
25,25658,2005-12-31,2677,4902,7579
25,25658,2006-12-31,2716,4930,7646
25,25658,2007-12-31,2801,4955,7756
25,25658,2008-12-31,2877,5011,7888
25,25658,2009-12-31,2977,5087,8064
25,25658,2010-12-31,3091,5151,8242
25,25658,2011-12-31,3201,5261,8462
25,25658,2012-12-31,3332,5368,8700
25,25658,2013-12-31,3459,5473,8932
25,25658,2014-12-31,3604,5630,9234
25,25658,2015-12-31,3763,5751,9514
25,25658,2016-12-31,3925,5953,9878
25,25658,2017-12-31,4131,6129,10260
25,25658,2018-12-31,4384,6371,10755
25,25658,2019-12-31,4679,6637,11316
25,25658,2020-12-31,4969,6875,11844
25,25658,2021-12-31,5417,6897,12314
25,25658,2022-12-31,5790,6912,12702
25,25658,2023-12-31,6138,6925,13063
25,25658,2024-12-31,6370,6940,13310
25,25658,2025-12-31,6559,6945,13504
25,25658,2026-12-31,6761,6969,13730
25,25658,2027-12-31,6920,6995,13915
25,25658,2028-12-31,7083,7014,14097
25,25658,2029-12-31,7227,7036,14263
25,25658,2030-12-31,7343,7068,14411
25,25658,2031-12-31,7478,7088,14566
25,25658,2032-12-31,7593,7129,14722
25,25658,2033-12-31,7700,7145,14845
25,25658,2034-12-31,7810,7175,14985
25,25658,2035-12-31,7935,7204,15139
25,25662,1985-12-31,4606,11565,16171
25,25662,1986-12-31,4308,11023,15331
25,25662,1987-12-31,4103,10516,14619
25,25662,1988-12-31,3878,10033,13911
25,25662,1989-12-31,3649,9590,13239
25,25662,1990-12-31,3468,9160,12628
25,25662,1991-12-31,3350,8735,12085
25,25662,1992-12-31,3193,8362,11555
25,25662,1993-12-31,3078,8036,11114
25,25662,1994-12-31,2989,7708,10697
25,25662,1995-12-31,2893,7410,10303
25,25662,1996-12-31,2824,7166,9990
25,25662,1997-12-31,2746,6921,9667
25,25662,1998-12-31,2668,6772,9440
25,25662,1999-12-31,2637,6574,9211
25,25662,2000-12-31,2570,6385,8955
25,25662,2001-12-31,2561,6221,8782
25,25662,2002-12-31,2518,6062,8580
25,25662,2003-12-31,2468,5914,8382
25,25662,2004-12-31,2457,5785,8242
25,25662,2005-12-31,2469,5649,8118
25,25662,2006-12-31,2466,5553,8019
25,25662,2007-12-31,2464,5454,7918
25,25662,2008-12-31,2478,5370,7848
25,25662,2009-12-31,2508,5296,7804
25,25662,2010-12-31,2507,5245,7752
25,25662,2011-12-31,2542,5192,7734
25,25662,2012-12-31,2596,5177,7773
25,25662,2013-12-31,2624,5144,7768
25,25662,2014-12-31,2671,5134,7805
25,25662,2015-12-31,2732,5121,7853
25,25662,2016-12-31,2817,5125,7942
25,25662,2017-12-31,2836,5152,7988
25,25662,2018-12-31,2986,5195,8181
25,25662,2019-12-31,3069,5255,8324
25,25662,2020-12-31,3185,5352,8537
25,25662,2021-12-31,3507,5369,8876
25,25662,2022-12-31,3774,5381,9155
25,25662,2023-12-31,4025,5391,9416
25,25662,2024-12-31,4174,5403,9577
25,25662,2025-12-31,4295,5415,9710
25,25662,2026-12-31,4423,5432,9855
25,25662,2027-12-31,4528,5455,9983
25,25662,2028-12-31,4638,5472,10110
25,25662,2029-12-31,4731,5479,10210
25,25662,2030-12-31,4818,5499,10317
25,25662,2031-12-31,4887,5511,10398
25,25662,2032-12-31,4973,5532,10505
25,25662,2033-12-31,5043,5571,10614
25,25662,2034-12-31,5116,5578,10694
25,25662,2035-12-31,5207,5594,10801
25,25718,1985-12-31,2327,10700,13027
25,25718,1986-12-31,2208,10308,12516
25,25718,1987-12-31,2120,9950,12070
25,25718,1988-12-31,2049,9593,11642
25,25718,1989-12-31,1969,9281,11250
25,25718,1990-12-31,1914,8984,10898
25,25718,1991-12-31,1805,8691,10496
25,25718,1992-12-31,1803,8429,10232
25,25718,1993-12-31,1766,8160,9926
25,25718,1994-12-31,1746,7954,9700
25,25718,1995-12-31,1730,7785,9515
25,25718,1996-12-31,1693,7612,9305
25,25718,1997-12-31,1694,7468,9162
25,25718,1998-12-31,1680,7411,9091
25,25718,1999-12-31,1663,7307,8970
25,25718,2000-12-31,1633,7202,8835
25,25718,2001-12-31,1671,7129,8800
25,25718,2002-12-31,1684,7046,8730
25,25718,2003-12-31,1680,6988,8668
25,25718,2004-12-31,1682,6950,8632
25,25718,2005-12-31,1717,6896,8613
25,25718,2006-12-31,1758,6880,8638
25,25718,2007-12-31,1785,6880,8665
25,25718,2008-12-31,1805,6897,8702
25,25718,2009-12-31,1841,6954,8795
25,25718,2010-12-31,1888,6992,8880
25,25718,2011-12-31,1966,7078,9044
25,25718,2012-12-31,1992,7167,9159
25,25718,2013-12-31,2083,7275,9358
25,25718,2014-12-31,2155,7398,9553
25,25718,2015-12-31,2226,7546,9772
25,25718,2016-12-31,2327,7710,10037
25,25718,2017-12-31,2419,7907,10326
25,25718,2018-12-31,2555,8156,10711
25,25718,2019-12-31,2699,8405,11104
25,25718,2020-12-31,2854,8667,11521
25,25718,2021-12-31,3284,8695,11979
25,25718,2022-12-31,3641,8714,12355
25,25718,2023-12-31,3976,8731,12707
25,25718,2024-12-31,4148,8744,12892
25,25718,2025-12-31,4283,8769,13052
25,25718,2026-12-31,4397,8796,13193
25,25718,2027-12-31,4516,8825,13341
25,25718,2028-12-31,4616,8852,13468
25,25718,2029-12-31,4709,8879,13588
25,25718,2030-12-31,4795,8908,13703
25,25718,2031-12-31,4871,8941,13812
25,25718,2032-12-31,4947,8989,13936
25,25718,2033-12-31,5008,9009,14017
25,25718,2034-12-31,5092,9034,14126
25,25718,2035-12-31,5159,9066,14225
25,25736,1985-12-31,1582,7055,8637
25,25736,1986-12-31,1563,6893,8456
25,25736,1987-12-31,1566,6741,8307
25,25736,1988-12-31,1540,6584,8124
25,25736,1989-12-31,1536,6469,8005
25,25736,1990-12-31,1550,6318,7868
25,25736,1991-12-31,1560,6189,7749
25,25736,1992-12-31,1539,6084,7623
25,25736,1993-12-31,1582,5974,7556
25,25736,1994-12-31,1574,5918,7492
25,25736,1995-12-31,1593,5850,7443
25,25736,1996-12-31,1616,5784,7400
25,25736,1997-12-31,1637,5761,7398
25,25736,1998-12-31,1649,5792,7441
25,25736,1999-12-31,1663,5782,7445
25,25736,2000-12-31,1706,5801,7507
25,25736,2001-12-31,1763,5769,7532
25,25736,2002-12-31,1790,5767,7557
25,25736,2003-12-31,1830,5803,7633
25,25736,2004-12-31,1895,5831,7726
25,25736,2005-12-31,1944,5863,7807
25,25736,2006-12-31,1996,5918,7914
25,25736,2007-12-31,2066,5988,8054
25,25736,2008-12-31,2132,6067,8199
25,25736,2009-12-31,2220,6174,8394
25,25736,2010-12-31,2311,6306,8617
25,25736,2011-12-31,2407,6447,8854
25,25736,2012-12-31,2518,6602,9120
25,25736,2013-12-31,2641,6773,9414
25,25736,2014-12-31,2772,6954,9726
25,25736,2015-12-31,2904,7169,10073
25,25736,2016-12-31,3059,7411,10470
25,25736,2017-12-31,3223,7653,10876
25,25736,2018-12-31,3425,7998,11423
25,25736,2019-12-31,3713,8339,12052
25,25736,2020-12-31,3992,8653,12645
25,25736,2021-12-31,4466,8681,13147
25,25736,2022-12-31,4861,8700,13561
25,25736,2023-12-31,5229,8717,13946
25,25736,2024-12-31,5454,8725,14179
25,25736,2025-12-31,5633,8763,14396
25,25736,2026-12-31,5801,8779,14580
25,25736,2027-12-31,5955,8806,14761
25,25736,2028-12-31,6091,8843,14934
25,25736,2029-12-31,6212,8870,15082
25,25736,2030-12-31,6319,8898,15217
25,25736,2031-12-31,6434,8961,15395
25,25736,2032-12-31,6529,8979,15508
25,25736,2033-12-31,6629,9001,15630
25,25736,2034-12-31,6752,9044,15796
25,25736,2035-12-31,6821,9085,15906
25,25740,1985-12-31,17591,8384,25975
25,25740,1986-12-31,16951,8201,25152
25,25740,1987-12-31,16433,8036,24469
25,25740,1988-12-31,15976,7861,23837
25,25740,1989-12-31,15547,7709,23256
25,25740,1990-12-31,15145,7569,22714
25,25740,1991-12-31,14836,7436,22272
25,25740,1992-12-31,14572,7303,21875
25,25740,1993-12-31,14323,7186,21509
25,25740,1994-12-31,14181,7115,21296
25,25740,1995-12-31,14094,7049,21143
25,25740,1996-12-31,14033,7004,21037
25,25740,1997-12-31,14016,6956,20972
25,25740,1998-12-31,13938,6987,20925
25,25740,1999-12-31,13999,6980,20979
25,25740,2000-12-31,14075,6990,21065
25,25740,2001-12-31,14190,6999,21189
25,25740,2002-12-31,14344,7023,21367
25,25740,2003-12-31,14522,7055,21577
25,25740,2004-12-31,14729,7092,21821
25,25740,2005-12-31,14959,7142,22101
25,25740,2006-12-31,15249,7217,22466
25,25740,2007-12-31,15608,7301,22909
25,25740,2008-12-31,16013,7424,23437
25,25740,2009-12-31,16465,7535,24000
25,25740,2010-12-31,16993,7701,24694
25,25740,2011-12-31,17575,7880,25455
25,25740,2012-12-31,18211,8078,26289
25,25740,2013-12-31,18897,8301,27198
25,25740,2014-12-31,19656,8536,28192
25,25740,2015-12-31,20476,8800,29276
25,25740,2016-12-31,21397,9080,30477
25,25740,2017-12-31,22428,9410,31838
25,25740,2018-12-31,23644,9847,33491
25,25740,2019-12-31,25050,10052,35102
25,25740,2020-12-31,26509,10149,36658
25,25740,2021-12-31,27932,10182,38114
25,25740,2022-12-31,29109,10204,39313
25,25740,2023-12-31,30207,10223,40430
25,25740,2024-12-31,31230,10253,41483
25,25740,2025-12-31,32218,10279,42497
25,25740,2026-12-31,33119,10323,43442
25,25740,2027-12-31,33975,10346,44321
25,25740,2028-12-31,34766,10377,45143
25,25740,2029-12-31,35470,10423,45893
25,25740,2030-12-31,36124,10473,46597
25,25740,2031-12-31,36717,10512,47229
25,25740,2032-12-31,37302,10550,47852
25,25740,2033-12-31,37907,10605,48512
25,25740,2034-12-31,38473,10639,49112
25,25740,2035-12-31,39044,10657,49701
25,25743,1985-12-31,4663,18902,23565
25,25743,1986-12-31,4508,18216,22724
25,25743,1987-12-31,4398,17565,21963
25,25743,1988-12-31,4314,16990,21304
25,25743,1989-12-31,4200,16423,20623
25,25743,1990-12-31,4081,15885,19966
25,25743,1991-12-31,4046,15375,19421
25,25743,1992-12-31,4015,14923,18938
25,25743,1993-12-31,3914,14488,18402
25,25743,1994-12-31,3901,14139,18040
25,25743,1995-12-31,3888,13824,17712
25,25743,1996-12-31,3888,13559,17447
25,25743,1997-12-31,3881,13310,17191
25,25743,1998-12-31,3884,13199,17083
25,25743,1999-12-31,3914,13021,16935
25,25743,2000-12-31,3949,12869,16818
25,25743,2001-12-31,3989,12727,16716
25,25743,2002-12-31,4051,12608,16659
25,25743,2003-12-31,4109,12491,16600
25,25743,2004-12-31,4180,12424,16604
25,25743,2005-12-31,4242,12359,16601
25,25743,2006-12-31,4344,12343,16687
25,25743,2007-12-31,4464,12344,16808
25,25743,2008-12-31,4578,12386,16964
25,25743,2009-12-31,4733,12474,17207
25,25743,2010-12-31,4872,12598,17470
25,25743,2011-12-31,5068,12742,17810
25,25743,2012-12-31,5239,12911,18150
25,25743,2013-12-31,5450,13108,18558
25,25743,2014-12-31,5695,13342,19037
25,25743,2015-12-31,5920,13612,19532
25,25743,2016-12-31,6197,13913,20110
25,25743,2017-12-31,6498,14289,20787
25,25743,2018-12-31,6881,14744,21625
25,25743,2019-12-31,7369,15181,22550
25,25743,2020-12-31,7862,15627,23489
25,25743,2021-12-31,8744,15678,24422
25,25743,2022-12-31,9478,15712,25190
25,25743,2023-12-31,10164,15742,25906
25,25743,2024-12-31,10565,15783,26348
25,25743,2025-12-31,10907,15823,26730
25,25743,2026-12-31,11222,15866,27088
25,25743,2027-12-31,11498,15910,27408
25,25743,2028-12-31,11762,15963,27725
25,25743,2029-12-31,11992,16021,28013
25,25743,2030-12-31,12213,16069,28282
25,25743,2031-12-31,12411,16135,28546
25,25743,2032-12-31,12605,16198,28803
25,25743,2033-12-31,12803,16272,29075
25,25743,2034-12-31,12997,16317,29314
25,25743,2035-12-31,13170,16377,29547
25,25745,1985-12-31,4880,7198,12078
25,25745,1986-12-31,4740,6937,11677
25,25745,1987-12-31,4631,6699,11330
25,25745,1988-12-31,4509,6461,10970
25,25745,1989-12-31,4392,6236,10628
25,25745,1990-12-31,4288,6066,10354
25,25745,1991-12-31,4242,5811,10053
25,25745,1992-12-31,4199,5668,9867
25,25745,1993-12-31,4147,5469,9616
25,25745,1994-12-31,4123,5349,9472
25,25745,1995-12-31,4112,5211,9323
25,25745,1996-12-31,4114,5109,9223
25,25745,1997-12-31,4129,4995,9124
25,25745,1998-12-31,4119,4967,9086
25,25745,1999-12-31,4145,4903,9048
25,25745,2000-12-31,4183,4841,9024
25,25745,2001-12-31,4238,4779,9017
25,25745,2002-12-31,4312,4734,9046
25,25745,2003-12-31,4383,4688,9071
25,25745,2004-12-31,4450,4655,9105
25,25745,2005-12-31,4538,4626,9164
25,25745,2006-12-31,4645,4604,9249
25,25745,2007-12-31,4757,4616,9373
25,25745,2008-12-31,4903,4624,9527
25,25745,2009-12-31,5043,4645,9688
25,25745,2010-12-31,5218,4685,9903
25,25745,2011-12-31,5402,4739,10141
25,25745,2012-12-31,5625,4799,10424
25,25745,2013-12-31,5851,4887,10738
25,25745,2014-12-31,6106,4954,11060
25,25745,2015-12-31,6384,5050,11434
25,25745,2016-12-31,6663,5151,11814
25,25745,2017-12-31,6989,5271,12260
25,25745,2018-12-31,7407,5440,12847
25,25745,2019-12-31,8019,5446,13465
25,25745,2020-12-31,8611,5451,14062
25,25745,2021-12-31,9152,5468,14620
25,25745,2022-12-31,9600,5480,15080
25,25745,2023-12-31,10019,5490,15509
25,25745,2024-12-31,10403,5513,15916
25,25745,2025-12-31,10745,5514,16259
25,25745,2026-12-31,11059,5542,16601
25,25745,2027-12-31,11347,5548,16895
25,25745,2028-12-31,11619,5566,17185
25,25745,2029-12-31,11859,5591,17450
25,25745,2030-12-31,12069,5626,17695
25,25745,2031-12-31,12272,5632,17904
25,25745,2032-12-31,12477,5650,18127
25,25745,2033-12-31,12662,5676,18338
25,25745,2034-12-31,12852,5710,18562
25,25745,2035-12-31,13046,5717,18763
25,25754,1985-12-31,156942,14928,171870
25,25754,1986-12-31,167034,14418,181452
25,25754,1987-12-31,176348,13971,190319
25,25754,1988-12-31,184938,13521,198459
25,25754,1989-12-31,192772,13122,205894
25,25754,1990-12-31,200137,12736,212873
25,25754,1991-12-31,207256,12349,219605
25,25754,1992-12-31,214164,12039,226203
25,25754,1993-12-31,220709,11702,232411
25,25754,1994-12-31,228390,11466,239856
25,25754,1995-12-31,236275,11247,247522
25,25754,1996-12-31,244206,7729,251935
25,25754,1997-12-31,252664,7459,260123
25,25754,1998-12-31,259582,7289,266871
25,25754,1999-12-31,268822,7058,275880
25,25754,2000-12-31,278470,6850,285320
25,25754,2001-12-31,288630,6656,295286
25,25754,2002-12-31,299342,6467,305809
25,25754,2003-12-31,310567,6292,316859
25,25754,2004-12-31,322407,6129,328536
25,25754,2005-12-31,334706,5920,340626
25,25754,2006-12-31,348668,5804,354472
25,25754,2007-12-31,363893,5699,369592
25,25754,2008-12-31,380536,5595,386131
25,25754,2009-12-31,398796,5513,404309
25,25754,2010-12-31,418806,5446,424252
25,25754,2011-12-31,440370,5370,445740
25,25754,2012-12-31,463703,5326,469029
25,25754,2013-12-31,488889,5273,494162
25,25754,2014-12-31,516120,5225,521345
25,25754,2015-12-31,545453,5173,550626
25,25754,2016-12-31,577841,5166,583007
25,25754,2017-12-31,613674,5146,618820
25,25754,2018-12-31,655025,5154,660179
25,25754,2019-12-31,704660,4616,709276
25,25754,2020-12-31,749034,4514,753548
25,25754,2021-12-31,779104,4528,783632
25,25754,2022-12-31,803750,4538,808288
25,25754,2023-12-31,826713,4546,831259
25,25754,2024-12-31,853128,4555,857683
25,25754,2025-12-31,879181,4572,883753
25,25754,2026-12-31,904033,4585,908618
25,25754,2027-12-31,927255,4604,931859
25,25754,2028-12-31,948724,4613,953337
25,25754,2029-12-31,968290,4627,972917
25,25754,2030-12-31,985872,4654,990526
25,25754,2031-12-31,1002350,4670,1007020
25,25754,2032-12-31,1018646,4692,1023338
25,25754,2033-12-31,1034641,4698,1039339
25,25754,2034-12-31,1050420,4718,1055138
25,25754,2035-12-31,1065931,4740,1070671
25,25758,1985-12-31,3789,8910,12699
25,25758,1986-12-31,4064,8638,12702
25,25758,1987-12-31,4343,8389,12732
25,25758,1988-12-31,4616,8143,12759
25,25758,1989-12-31,4838,7915,12753
25,25758,1990-12-31,5040,7678,12718
25,25758,1991-12-31,5271,7486,12757
25,25758,1992-12-31,5458,7314,12772
25,25758,1993-12-31,5658,7143,12801
25,25758,1994-12-31,5871,7018,12889
25,25758,1995-12-31,6096,6893,12989
25,25758,1996-12-31,6319,6802,13121
25,25758,1997-12-31,6561,6705,13266
25,25758,1998-12-31,6754,6712,13466
25,25758,1999-12-31,7001,6650,13651
25,25758,2000-12-31,7271,6612,13883
25,25758,2001-12-31,7548,6580,14128
25,25758,2002-12-31,7852,6543,14395
25,25758,2003-12-31,8151,6536,14687
25,25758,2004-12-31,8472,6529,15001
25,25758,2005-12-31,8810,6519,15329
25,25758,2006-12-31,9202,6544,15746
25,25758,2007-12-31,9601,6582,16183
25,25758,2008-12-31,10040,6644,16684
25,25758,2009-12-31,10540,6734,17274
25,25758,2010-12-31,11087,6840,17927
25,25758,2011-12-31,11673,6944,18617
25,25758,2012-12-31,12294,7091,19385
25,25758,2013-12-31,12963,7235,20198
25,25758,2014-12-31,13693,7397,21090
25,25758,2015-12-31,14486,7581,22067
25,25758,2016-12-31,15345,7801,23146
25,25758,2017-12-31,16309,8051,24360
25,25758,2018-12-31,17435,8347,25782
25,25758,2019-12-31,19229,8227,27456
25,25758,2020-12-31,20942,8057,28999
25,25758,2021-12-31,22076,8081,30157
25,25758,2022-12-31,23007,8099,31106
25,25758,2023-12-31,23875,8115,31990
25,25758,2024-12-31,24701,8133,32834
25,25758,2025-12-31,25463,8155,33618
25,25758,2026-12-31,26181,8174,34355
25,25758,2027-12-31,26848,8204,35052
25,25758,2028-12-31,27475,8237,35712
25,25758,2029-12-31,28043,8265,36308
25,25758,2030-12-31,28548,8300,36848
25,25758,2031-12-31,29033,8344,37377
25,25758,2032-12-31,29511,8371,37882
25,25758,2033-12-31,29956,8414,38370
25,25758,2034-12-31,30426,8426,38852
25,25758,2035-12-31,30880,8468,39348
25,25769,1985-12-31,3612,18180,21792
25,25769,1986-12-31,3583,18774,22357
25,25769,1987-12-31,3539,19323,22862
25,25769,1988-12-31,3508,19823,23331
25,25769,1989-12-31,3463,20312,23775
25,25769,1990-12-31,3443,20751,24194
25,25769,1991-12-31,3440,21178,24618
25,25769,1992-12-31,3451,21552,25003
25,25769,1993-12-31,3430,21922,25352
25,25769,1994-12-31,3456,22406,25862
25,25769,1995-12-31,3488,22901,26389
25,25769,1996-12-31,3528,23394,26922
25,25769,1997-12-31,3584,23917,27501
25,25769,1998-12-31,3589,11587,15176
25,25769,1999-12-31,3649,11255,14904
25,25769,2000-12-31,3695,10952,14647
25,25769,2001-12-31,3799,10639,14438
25,25769,2002-12-31,3865,10344,14209
25,25769,2003-12-31,3962,10063,14025
25,25769,2004-12-31,4057,9820,13877
25,25769,2005-12-31,4165,9559,13724
25,25769,2006-12-31,4289,9342,13631
25,25769,2007-12-31,4415,9171,13586
25,25769,2008-12-31,4567,9023,13590
25,25769,2009-12-31,4748,8880,13628
25,25769,2010-12-31,4938,8772,13710
25,25769,2011-12-31,5154,8685,13839
25,25769,2012-12-31,5378,8593,13971
25,25769,2013-12-31,5614,8531,14145
25,25769,2014-12-31,5883,8468,14351
25,25769,2015-12-31,6164,8431,14595
25,25769,2016-12-31,6484,8405,14889
25,25769,2017-12-31,6829,8402,15231
25,25769,2018-12-31,7250,8440,15690
25,25769,2019-12-31,7877,8306,16183
25,25769,2020-12-31,8487,8256,16743
25,25769,2021-12-31,9127,8281,17408
25,25769,2022-12-31,9657,8299,17956
25,25769,2023-12-31,10151,8315,18466
25,25769,2024-12-31,10558,8332,18890
25,25769,2025-12-31,10923,8352,19275
25,25769,2026-12-31,11241,8374,19615
25,25769,2027-12-31,11544,8404,19948
25,25769,2028-12-31,11807,8426,20233
25,25769,2029-12-31,12043,8454,20497
25,25769,2030-12-31,12275,8499,20774
25,25769,2031-12-31,12466,8539,21005
25,25769,2032-12-31,12658,8558,21216
25,25769,2033-12-31,12871,8595,21466
25,25769,2034-12-31,13057,8619,21676
25,25769,2035-12-31,13264,8651,21915
25,25772,1985-12-31,2654,11307,13961
25,25772,1986-12-31,2660,10941,13601
25,25772,1987-12-31,2727,10576,13303
25,25772,1988-12-31,2742,10247,12989
25,25772,1989-12-31,2815,9924,12739
25,25772,1990-12-31,2861,9627,12488
25,25772,1991-12-31,2843,9316,12159
25,25772,1992-12-31,2929,9084,12013
25,25772,1993-12-31,2961,8834,11795
25,25772,1994-12-31,3040,8648,11688
25,25772,1995-12-31,3096,8474,11570
25,25772,1996-12-31,3161,8318,11479
25,25772,1997-12-31,3216,8191,11407
25,25772,1998-12-31,3288,8141,11429
25,25772,1999-12-31,3356,8064,11420
25,25772,2000-12-31,3449,7996,11445
25,25772,2001-12-31,3538,7925,11463
25,25772,2002-12-31,3648,7870,11518
25,25772,2003-12-31,3758,7819,11577
25,25772,2004-12-31,3877,7799,11676
25,25772,2005-12-31,4011,7779,11790
25,25772,2006-12-31,4144,7787,11931
25,25772,2007-12-31,4297,7808,12105
25,25772,2008-12-31,4477,7854,12331
25,25772,2009-12-31,4696,7923,12619
25,25772,2010-12-31,4902,8022,12924
25,25772,2011-12-31,5133,8146,13279
25,25772,2012-12-31,5381,8273,13654
25,25772,2013-12-31,5645,8431,14076
25,25772,2014-12-31,5933,8596,14529
25,25772,2015-12-31,6256,8783,15039
25,25772,2016-12-31,6590,9004,15594
25,25772,2017-12-31,6989,9261,16250
25,25772,2018-12-31,7443,9578,17021
25,25772,2019-12-31,8108,9794,17902
25,25772,2020-12-31,8761,9980,18741
25,25772,2021-12-31,9473,10012,19485
25,25772,2022-12-31,10064,10034,20098
25,25772,2023-12-31,10617,10053,20670
25,25772,2024-12-31,11077,10073,21150
25,25772,2025-12-31,11460,10096,21556
25,25772,2026-12-31,11806,10124,21930
25,25772,2027-12-31,12105,10158,22263
25,25772,2028-12-31,12395,10193,22588
25,25772,2029-12-31,12659,10237,22896
25,25772,2030-12-31,12883,10278,23161
25,25772,2031-12-31,13087,10310,23397
25,25772,2032-12-31,13311,10363,23674
25,25772,2033-12-31,13508,10395,23903
25,25772,2034-12-31,13734,10432,24166
25,25772,2035-12-31,13918,10481,24399
25,25777,1985-12-31,2010,5655,7665
25,25777,1986-12-31,1854,5401,7255
25,25777,1987-12-31,1799,5191,6990
25,25777,1988-12-31,1652,4979,6631
25,25777,1989-12-31,1599,4774,6373
25,25777,1990-12-31,1560,4594,6154
25,25777,1991-12-31,1477,4445,5922
25,25777,1992-12-31,1426,4308,5734
25,25777,1993-12-31,1387,4151,5538
25,25777,1994-12-31,1370,4022,5392
25,25777,1995-12-31,1331,3904,5235
25,25777,1996-12-31,1307,3770,5077
25,25777,1997-12-31,1283,3694,4977
25,25777,1998-12-31,1237,3662,4899
25,25777,1999-12-31,1222,3577,4799
25,25777,2000-12-31,1240,3521,4761
25,25777,2001-12-31,1231,3450,4681
25,25777,2002-12-31,1230,3406,4636
25,25777,2003-12-31,1230,3336,4566
25,25777,2004-12-31,1224,3295,4519
25,25777,2005-12-31,1225,3268,4493
25,25777,2006-12-31,1247,3229,4476
25,25777,2007-12-31,1248,3223,4471
25,25777,2008-12-31,1254,3205,4459
25,25777,2009-12-31,1290,3207,4497
25,25777,2010-12-31,1305,3205,4510
25,25777,2011-12-31,1327,3222,4549
25,25777,2012-12-31,1343,3261,4604
25,25777,2013-12-31,1417,3294,4711
25,25777,2014-12-31,1424,3307,4731
25,25777,2015-12-31,1454,3373,4827
25,25777,2016-12-31,1484,3415,4899
25,25777,2017-12-31,1601,3460,5061
25,25777,2018-12-31,1638,3565,5203
25,25777,2019-12-31,1704,3657,5361
25,25777,2020-12-31,1783,3760,5543
25,25777,2021-12-31,1991,3772,5763
25,25777,2022-12-31,2164,3780,5944
25,25777,2023-12-31,2325,3788,6113
25,25777,2024-12-31,2416,3797,6213
25,25777,2025-12-31,2484,3809,6293
25,25777,2026-12-31,2556,3825,6381
25,25777,2027-12-31,2631,3837,6468
25,25777,2028-12-31,2681,3840,6521
25,25777,2029-12-31,2745,3866,6611
25,25777,2030-12-31,2788,3868,6656
25,25777,2031-12-31,2831,3882,6713
25,25777,2032-12-31,2871,3890,6761
25,25777,2033-12-31,2923,3904,6827
25,25777,2034-12-31,2968,3932,6900
25,25777,2035-12-31,3016,3935,6951
25,25779,1985-12-31,1894,7050,8944
25,25779,1986-12-31,1801,6727,8528
25,25779,1987-12-31,1699,6460,8159
25,25779,1988-12-31,1641,6212,7853
25,25779,1989-12-31,1613,5992,7605
25,25779,1990-12-31,1572,5724,7296
25,25779,1991-12-31,1497,5514,7011
25,25779,1992-12-31,1452,5322,6774
25,25779,1993-12-31,1459,5121,6580
25,25779,1994-12-31,1439,4957,6396
25,25779,1995-12-31,1423,4808,6231
25,25779,1996-12-31,1400,4697,6097
25,25779,1997-12-31,1393,4545,5938
25,25779,1998-12-31,1363,4496,5859
25,25779,1999-12-31,1375,4400,5775
25,25779,2000-12-31,1380,4315,5695
25,25779,2001-12-31,1382,4248,5630
25,25779,2002-12-31,1414,4177,5591
25,25779,2003-12-31,1414,4105,5519
25,25779,2004-12-31,1453,4058,5511
25,25779,2005-12-31,1419,4010,5429
25,25779,2006-12-31,1476,3971,5447
25,25779,2007-12-31,1502,3935,5437
25,25779,2008-12-31,1513,3928,5441
25,25779,2009-12-31,1577,3904,5481
25,25779,2010-12-31,1606,3901,5507
25,25779,2011-12-31,1643,3933,5576
25,25779,2012-12-31,1724,3957,5681
25,25779,2013-12-31,1770,3976,5746
25,25779,2014-12-31,1836,4015,5851
25,25779,2015-12-31,1921,4060,5981
25,25779,2016-12-31,1969,4145,6114
25,25779,2017-12-31,2026,4174,6200
25,25779,2018-12-31,2175,4279,6454
25,25779,2019-12-31,2358,4411,6769
25,25779,2020-12-31,2535,4532,7067
25,25779,2021-12-31,2801,4547,7348
25,25779,2022-12-31,3022,4557,7579
25,25779,2023-12-31,3229,4565,7794
25,25779,2024-12-31,3361,4593,7954
25,25779,2025-12-31,3476,4582,8058
25,25779,2026-12-31,3574,4595,8169
25,25779,2027-12-31,3672,4612,8284
25,25779,2028-12-31,3755,4635,8390
25,25779,2029-12-31,3833,4636,8469
25,25779,2030-12-31,3897,4656,8553
25,25779,2031-12-31,3967,4681,8648
25,25779,2032-12-31,4030,4691,8721
25,25779,2033-12-31,4087,4717,8804
25,25779,2034-12-31,4147,4730,8877
25,25779,2035-12-31,4205,4748,8953
25,25781,1985-12-31,1007,4222,5229
25,25781,1986-12-31,951,4094,5045
25,25781,1987-12-31,932,3987,4919
25,25781,1988-12-31,927,3867,4794
25,25781,1989-12-31,896,3768,4664
25,25781,1990-12-31,932,3662,4594
25,25781,1991-12-31,892,3556,4448
25,25781,1992-12-31,898,3480,4378
25,25781,1993-12-31,907,3397,4304
25,25781,1994-12-31,904,3324,4228
25,25781,1995-12-31,914,3281,4195
25,25781,1996-12-31,924,3218,4142
25,25781,1997-12-31,940,3197,4137
25,25781,1998-12-31,955,3189,4144
25,25781,1999-12-31,967,3162,4129
25,25781,2000-12-31,989,3150,4139
25,25781,2001-12-31,998,3130,4128
25,25781,2002-12-31,1021,3118,4139
25,25781,2003-12-31,1043,3114,4157
25,25781,2004-12-31,1063,3106,4169
25,25781,2005-12-31,1079,3107,4186
25,25781,2006-12-31,1128,3132,4260
25,25781,2007-12-31,1169,3158,4327
25,25781,2008-12-31,1212,3202,4414
25,25781,2009-12-31,1251,3230,4481
25,25781,2010-12-31,1288,3272,4560
25,25781,2011-12-31,1348,3327,4675
25,25781,2012-12-31,1404,3388,4792
25,25781,2013-12-31,1463,3476,4939
25,25781,2014-12-31,1536,3530,5066
25,25781,2015-12-31,1603,3640,5243
25,25781,2016-12-31,1684,3738,5422
25,25781,2017-12-31,1775,3863,5638
25,25781,2018-12-31,1885,4002,5887
25,25781,2019-12-31,2037,4132,6169
25,25781,2020-12-31,2185,4256,6441
25,25781,2021-12-31,2427,4270,6697
25,25781,2022-12-31,2629,4279,6908
25,25781,2023-12-31,2817,4287,7104
25,25781,2024-12-31,2930,4291,7221
25,25781,2025-12-31,3023,4303,7326
25,25781,2026-12-31,3109,4317,7426
25,25781,2027-12-31,3196,4325,7521
25,25781,2028-12-31,3277,4345,7622
25,25781,2029-12-31,3335,4350,7685
25,25781,2030-12-31,3401,4384,7785
25,25781,2031-12-31,3455,4402,7857
25,25781,2032-12-31,3513,4416,7929
25,25781,2033-12-31,3565,4427,7992
25,25781,2034-12-31,3608,4442,8050
25,25781,2035-12-31,3674,4461,8135
25,25785,1985-12-31,4275,8617,12892
25,25785,1986-12-31,4144,8620,12764
25,25785,1987-12-31,4026,8619,12645
25,25785,1988-12-31,3918,8609,12527
25,25785,1989-12-31,3821,8601,12422
25,25785,1990-12-31,3738,8595,12333
25,25785,1991-12-31,3701,8540,12241
25,25785,1992-12-31,3641,8585,12226
25,25785,1993-12-31,3590,8577,12167
25,25785,1994-12-31,3570,8621,12191
25,25785,1995-12-31,3564,8673,12237
25,25785,1996-12-31,3564,8725,12289
25,25785,1997-12-31,3576,8803,12379
25,25785,1998-12-31,3569,8976,12545
25,25785,1999-12-31,3583,9092,12675
25,25785,2000-12-31,3615,9208,12823
25,25785,2001-12-31,3671,9339,13010
25,25785,2002-12-31,3711,9468,13179
25,25785,2003-12-31,3776,9617,13393
25,25785,2004-12-31,3833,9765,13598
25,25785,2005-12-31,3890,9937,13827
25,25785,2006-12-31,3971,10147,14118
25,25785,2007-12-31,4072,10380,14452
25,25785,2008-12-31,4205,10641,14846
25,25785,2009-12-31,4317,10932,15249
25,25785,2010-12-31,4488,11263,15751
25,25785,2011-12-31,4678,11627,16305
25,25785,2012-12-31,4822,12013,16835
25,25785,2013-12-31,4997,12445,17442
25,25785,2014-12-31,5212,12905,18117
25,25785,2015-12-31,5443,13424,18867
25,25785,2016-12-31,5689,13983,19672
25,25785,2017-12-31,5954,14587,20541
25,25785,2018-12-31,6317,15348,21665
25,25785,2019-12-31,6847,16136,22983
25,25785,2020-12-31,7362,16844,24206
25,25785,2021-12-31,8273,16899,25172
25,25785,2022-12-31,9028,16936,25964
25,25785,2023-12-31,9734,16968,26702
25,25785,2024-12-31,10165,16989,27154
25,25785,2025-12-31,10491,17038,27529
25,25785,2026-12-31,10803,17078,27881
25,25785,2027-12-31,11072,17139,28211
25,25785,2028-12-31,11339,17193,28532
25,25785,2029-12-31,11573,17267,28840
25,25785,2030-12-31,11775,17332,29107
25,25785,2031-12-31,11959,17404,29363
25,25785,2032-12-31,12157,17478,29635
25,25785,2033-12-31,12333,17544,29877
25,25785,2034-12-31,12547,17606,30153
25,25785,2035-12-31,12724,17671,30395
25,25793,1985-12-31,634,8417,9051
25,25793,1986-12-31,631,8112,8743
25,25793,1987-12-31,576,7868,8444
25,25793,1988-12-31,556,7588,8144
25,25793,1989-12-31,597,7335,7932
25,25793,1990-12-31,616,7084,7700
25,25793,1991-12-31,680,6881,7561
25,25793,1992-12-31,632,6676,7308
25,25793,1993-12-31,625,6476,7101
25,25793,1994-12-31,646,6325,6971
25,25793,1995-12-31,633,6192,6825
25,25793,1996-12-31,637,6089,6726
25,25793,1997-12-31,653,5965,6618
25,25793,1998-12-31,645,5927,6572
25,25793,1999-12-31,686,5859,6545
25,25793,2000-12-31,705,5786,6491
25,25793,2001-12-31,712,5733,6445
25,25793,2002-12-31,734,5689,6423
25,25793,2003-12-31,736,5640,6376
25,25793,2004-12-31,764,5605,6369
25,25793,2005-12-31,810,5574,6384
25,25793,2006-12-31,788,5561,6349
25,25793,2007-12-31,841,5575,6416
25,25793,2008-12-31,842,5610,6452
25,25793,2009-12-31,865,5643,6508
25,25793,2010-12-31,922,5716,6638
25,25793,2011-12-31,949,5772,6721
25,25793,2012-12-31,996,5852,6848
25,25793,2013-12-31,1047,5947,6994
25,25793,2014-12-31,1097,6054,7151
25,25793,2015-12-31,1167,6189,7356
25,25793,2016-12-31,1214,6315,7529
25,25793,2017-12-31,1284,6492,7776
25,25793,2018-12-31,1370,6697,8067
25,25793,2019-12-31,1485,6869,8354
25,25793,2020-12-31,1597,7057,8654
25,25793,2021-12-31,1918,7080,8998
25,25793,2022-12-31,2186,7095,9281
25,25793,2023-12-31,2436,7109,9545
25,25793,2024-12-31,2555,7127,9682
25,25793,2025-12-31,2638,7144,9782
25,25793,2026-12-31,2723,7164,9887
25,25793,2027-12-31,2784,7183,9967
25,25793,2028-12-31,2855,7203,10058
25,25793,2029-12-31,2913,7236,10149
25,25793,2030-12-31,2970,7264,10234
25,25793,2031-12-31,3019,7290,10309
25,25793,2032-12-31,3058,7323,10381
25,25793,2033-12-31,3120,7352,10472
25,25793,2034-12-31,3160,7375,10535
25,25793,2035-12-31,3210,7418,10628
25,25797,1985-12-31,715,8432,9147
25,25797,1986-12-31,609,8234,8843
25,25797,1987-12-31,608,8010,8618
25,25797,1988-12-31,572,7832,8404
25,25797,1989-12-31,566,7627,8193
25,25797,1990-12-31,581,7462,8043
25,25797,1991-12-31,572,7305,7877
25,25797,1992-12-31,520,7131,7651
25,25797,1993-12-31,547,7017,7564
25,25797,1994-12-31,504,6915,7419
25,25797,1995-12-31,493,6827,7320
25,25797,1996-12-31,473,6739,7212
25,25797,1997-12-31,452,6691,7143
25,25797,1998-12-31,408,6698,7106
25,25797,1999-12-31,445,6663,7108
25,25797,2000-12-31,426,6639,7065
25,25797,2001-12-31,404,6631,7035
25,25797,2002-12-31,422,6630,7052
25,25797,2003-12-31,421,6647,7068
25,25797,2004-12-31,428,6660,7088
25,25797,2005-12-31,454,6695,7149
25,25797,2006-12-31,425,6743,7168
25,25797,2007-12-31,417,6802,7219
25,25797,2008-12-31,433,6907,7340
25,25797,2009-12-31,457,7006,7463
25,25797,2010-12-31,460,7141,7601
25,25797,2011-12-31,499,7292,7791
25,25797,2012-12-31,496,7453,7949
25,25797,2013-12-31,513,7644,8157
25,25797,2014-12-31,520,7829,8349
25,25797,2015-12-31,530,8053,8583
25,25797,2016-12-31,543,8305,8848
25,25797,2017-12-31,565,8570,9135
25,25797,2018-12-31,596,8971,9567
25,25797,2019-12-31,645,9420,10065
25,25797,2020-12-31,693,9838,10531
25,25797,2021-12-31,1079,9870,10949
25,25797,2022-12-31,1402,9892,11294
25,25797,2023-12-31,1705,9910,11615
25,25797,2024-12-31,1808,9924,11732
25,25797,2025-12-31,1885,9950,11835
25,25797,2026-12-31,1934,9985,11919
25,25797,2027-12-31,1986,10008,11994
25,25797,2028-12-31,2038,10049,12087
25,25797,2029-12-31,2077,10082,12159
25,25797,2030-12-31,2110,10117,12227
25,25797,2031-12-31,2142,10159,12301
25,25797,2032-12-31,2185,10201,12386
25,25797,2033-12-31,2226,10230,12456
25,25797,2034-12-31,2252,10268,12520
25,25797,2035-12-31,2277,10301,12578
25,25799,1985-12-31,3230,10638,13868
25,25799,1986-12-31,3288,10439,13727
25,25799,1987-12-31,3277,10239,13516
25,25799,1988-12-31,3374,10059,13433
25,25799,1989-12-31,3346,9881,13227
25,25799,1990-12-31,3397,9729,13126
25,25799,1991-12-31,3454,9554,13008
25,25799,1992-12-31,3491,9445,12936
25,25799,1993-12-31,3523,9303,12826
25,25799,1994-12-31,3589,9228,12817
25,25799,1995-12-31,3647,9172,12819
25,25799,1996-12-31,3738,9116,12854
25,25799,1997-12-31,3801,9086,12887
25,25799,1998-12-31,3872,9160,13032
25,25799,1999-12-31,3949,9157,13106
25,25799,2000-12-31,4051,9180,13231
25,25799,2001-12-31,4168,9211,13379
25,25799,2002-12-31,4265,9267,13532
25,25799,2003-12-31,4423,9319,13742
25,25799,2004-12-31,4564,9377,13941
25,25799,2005-12-31,4697,9458,14155
25,25799,2006-12-31,4842,9563,14405
25,25799,2007-12-31,5034,9700,14734
25,25799,2008-12-31,5232,9870,15102
25,25799,2009-12-31,5455,10080,15535
25,25799,2010-12-31,5689,10305,15994
25,25799,2011-12-31,5964,10555,16519
25,25799,2012-12-31,6253,10844,17097
25,25799,2013-12-31,6555,11159,17714
25,25799,2014-12-31,6885,11490,18375
25,25799,2015-12-31,7261,11850,19111
25,25799,2016-12-31,7654,12277,19931
25,25799,2017-12-31,8090,12735,20825
25,25799,2018-12-31,8624,13311,21935
25,25799,2019-12-31,9481,13571,23052
25,25799,2020-12-31,10331,13765,24096
25,25799,2021-12-31,11243,13810,25053
25,25799,2022-12-31,12001,13840,25841
25,25799,2023-12-31,12710,13866,26576
25,25799,2024-12-31,13292,13887,27179
25,25799,2025-12-31,13803,13932,27735
25,25799,2026-12-31,14245,13966,28211
25,25799,2027-12-31,14642,14005,28647
25,25799,2028-12-31,14981,14051,29032
25,25799,2029-12-31,15283,14104,29387
25,25799,2030-12-31,15588,14164,29752
25,25799,2031-12-31,15850,14230,30080
25,25799,2032-12-31,16094,14286,30380
25,25799,2033-12-31,16344,14342,30686
25,25799,2034-12-31,16596,14404,31000
25,25799,2035-12-31,16840,14457,31297
25,25805,1985-12-31,932,5781,6713
25,25805,1986-12-31,798,5540,6338
25,25805,1987-12-31,762,5328,6090
25,25805,1988-12-31,661,5135,5796
25,25805,1989-12-31,706,4895,5601
25,25805,1990-12-31,656,4751,5407
25,25805,1991-12-31,641,4579,5220
25,25805,1992-12-31,595,4444,5039
25,25805,1993-12-31,591,4266,4857
25,25805,1994-12-31,557,4149,4706
25,25805,1995-12-31,546,4045,4591
25,25805,1996-12-31,500,3945,4445
25,25805,1997-12-31,504,3843,4347
25,25805,1998-12-31,537,3810,4347
25,25805,1999-12-31,474,3717,4191
25,25805,2000-12-31,547,3658,4205
25,25805,2001-12-31,495,3600,4095
25,25805,2002-12-31,435,3544,3979
25,25805,2003-12-31,439,3490,3929
25,25805,2004-12-31,459,3440,3899
25,25805,2005-12-31,472,3411,3883
25,25805,2006-12-31,459,3387,3846
25,25805,2007-12-31,449,3368,3817
25,25805,2008-12-31,441,3360,3801
25,25805,2009-12-31,439,3360,3799
25,25805,2010-12-31,447,3381,3828
25,25805,2011-12-31,436,3399,3835
25,25805,2012-12-31,507,3440,3947
25,25805,2013-12-31,514,3477,3991
25,25805,2014-12-31,502,3503,4005
25,25805,2015-12-31,566,3557,4123
25,25805,2016-12-31,514,3612,4126
25,25805,2017-12-31,531,3682,4213
25,25805,2018-12-31,549,3786,4335
25,25805,2019-12-31,564,3913,4477
25,25805,2020-12-31,585,4054,4639
25,25805,2021-12-31,756,4067,4823
25,25805,2022-12-31,899,4076,4975
25,25805,2023-12-31,1032,4084,5116
25,25805,2024-12-31,1077,4087,5164
25,25805,2025-12-31,1121,4100,5221
25,25805,2026-12-31,1144,4112,5256
25,25805,2027-12-31,1176,4133,5309
25,25805,2028-12-31,1205,4151,5356
25,25805,2029-12-31,1230,4150,5380
25,25805,2030-12-31,1254,4164,5418
25,25805,2031-12-31,1276,4191,5467
25,25805,2032-12-31,1296,4199,5495
25,25805,2033-12-31,1314,4213,5527
25,25805,2034-12-31,1332,4237,5569
25,25805,2035-12-31,1348,4235,5583
25,25807,1985-12-31,1000,4878,5878
25,25807,1986-12-31,879,4680,5559
25,25807,1987-12-31,821,4442,5263
25,25807,1988-12-31,748,4290,5038
25,25807,1989-12-31,727,4049,4776
25,25807,1990-12-31,720,3934,4654
25,25807,1991-12-31,711,3734,4445
25,25807,1992-12-31,649,3662,4311
25,25807,1993-12-31,594,3444,4038
25,25807,1994-12-31,575,3339,3914
25,25807,1995-12-31,542,3217,3759
25,25807,1996-12-31,567,3152,3719
25,25807,1997-12-31,554,3053,3607
25,25807,1998-12-31,524,2985,3509
25,25807,1999-12-31,482,2925,3407
25,25807,2000-12-31,548,2863,3411
25,25807,2001-12-31,467,2797,3264
25,25807,2002-12-31,457,2735,3192
25,25807,2003-12-31,504,2698,3202
25,25807,2004-12-31,432,2642,3074
25,25807,2005-12-31,437,2579,3016
25,25807,2006-12-31,411,2566,2977
25,25807,2007-12-31,411,2533,2944
25,25807,2008-12-31,493,2506,2999
25,25807,2009-12-31,481,2508,2989
25,25807,2010-12-31,405,2516,2921
25,25807,2011-12-31,418,2482,2900
25,25807,2012-12-31,469,2489,2958
25,25807,2013-12-31,478,2516,2994
25,25807,2014-12-31,569,2535,3104
25,25807,2015-12-31,551,2535,3086
25,25807,2016-12-31,492,2528,3020
25,25807,2017-12-31,488,2622,3110
25,25807,2018-12-31,520,2638,3158
25,25807,2019-12-31,529,2678,3207
25,25807,2020-12-31,545,2740,3285
25,25807,2021-12-31,666,2749,3415
25,25807,2022-12-31,768,2755,3523
25,25807,2023-12-31,863,2760,3623
25,25807,2024-12-31,893,2765,3658
25,25807,2025-12-31,926,2770,3696
25,25807,2026-12-31,952,2786,3738
25,25807,2027-12-31,977,2781,3758
25,25807,2028-12-31,1004,2789,3793
25,25807,2029-12-31,1026,2802,3828
25,25807,2030-12-31,1042,2810,3852
25,25807,2031-12-31,1062,2825,3887
25,25807,2032-12-31,1082,2834,3916
25,25807,2033-12-31,1094,2847,3941
25,25807,2034-12-31,1107,2850,3957
25,25807,2035-12-31,1126,2854,3980
25,25815,1985-12-31,12052,12723,24775
25,25815,1986-12-31,11405,12134,23539
25,25815,1987-12-31,10835,11591,22426
25,25815,1988-12-31,10342,11052,21394
25,25815,1989-12-31,9859,10588,20447
25,25815,1990-12-31,9420,10138,19558
25,25815,1991-12-31,9054,9671,18725
25,25815,1992-12-31,8735,9275,18010
25,25815,1993-12-31,8447,8899,17346
25,25815,1994-12-31,8210,8595,16805
25,25815,1995-12-31,8027,8261,16288
25,25815,1996-12-31,7861,8002,15863
25,25815,1997-12-31,7706,7753,15459
25,25815,1998-12-31,7545,7593,15138
25,25815,1999-12-31,7469,7375,14844
25,25815,2000-12-31,7375,7182,14557
25,25815,2001-12-31,7340,7007,14347
25,25815,2002-12-31,7298,6847,14145
25,25815,2003-12-31,7278,6690,13968
25,25815,2004-12-31,7259,6549,13808
25,25815,2005-12-31,7287,6426,13713
25,25815,2006-12-31,7316,6322,13638
25,25815,2007-12-31,7367,6225,13592
25,25815,2008-12-31,7448,6156,13604
25,25815,2009-12-31,7554,6095,13649
25,25815,2010-12-31,7663,6052,13715
25,25815,2011-12-31,7820,6010,13830
25,25815,2012-12-31,8011,6009,14020
25,25815,2013-12-31,8187,5980,14167
25,25815,2014-12-31,8397,5993,14390
25,25815,2015-12-31,8640,5999,14639
25,25815,2016-12-31,8911,6028,14939
25,25815,2017-12-31,9207,6084,15291
25,25815,2018-12-31,9589,6146,15735
25,25815,2019-12-31,10015,6121,16136
25,25815,2020-12-31,10510,6101,16611
25,25815,2021-12-31,11151,6120,17271
25,25815,2022-12-31,11681,6133,17814
25,25815,2023-12-31,12175,6145,18320
25,25815,2024-12-31,12583,6165,18748
25,25815,2025-12-31,12965,6178,19143
25,25815,2026-12-31,13341,6196,19537
25,25815,2027-12-31,13668,6204,19872
25,25815,2028-12-31,13991,6221,20212
25,25815,2029-12-31,14274,6246,20520
25,25815,2030-12-31,14527,6272,20799
25,25815,2031-12-31,14753,6283,21036
25,25815,2032-12-31,14990,6315,21305
25,25815,2033-12-31,15219,6344,21563
25,25815,2034-12-31,15450,6357,21807
25,25815,2035-12-31,15690,6381,22071
25,25817,1985-12-31,2624,7510,10134
25,25817,1986-12-31,2932,7884,10816
25,25817,1987-12-31,3232,8252,11484
25,25817,1988-12-31,3504,8605,12109
25,25817,1989-12-31,3717,8932,12649
25,25817,1990-12-31,3957,9219,13176
25,25817,1991-12-31,4186,9479,13665
25,25817,1992-12-31,4392,9794,14186
25,25817,1993-12-31,4602,10040,14642
25,25817,1994-12-31,4811,10328,15139
25,25817,1995-12-31,5036,10629,15665
25,25817,1996-12-31,5259,10922,16181
25,25817,1997-12-31,5487,11238,16725
25,25817,1998-12-31,5669,11677,17346
25,25817,1999-12-31,5913,12020,17933
25,25817,2000-12-31,6174,12372,18546
25,25817,2001-12-31,6434,12744,19178
25,25817,2002-12-31,6710,13111,19821
25,25817,2003-12-31,7002,13490,20492
25,25817,2004-12-31,7291,13894,21185
25,25817,2005-12-31,7590,14273,21863
25,25817,2006-12-31,7925,14737,22662
25,25817,2007-12-31,8299,15244,23543
25,25817,2008-12-31,8711,15796,24507
25,25817,2009-12-31,9162,16387,25549
25,25817,2010-12-31,9655,17035,26690
25,25817,2011-12-31,10184,17745,27929
25,25817,2012-12-31,10751,18499,29250
25,25817,2013-12-31,11354,19324,30678
25,25817,2014-12-31,12002,20177,32179
25,25817,2015-12-31,12716,21125,33841
25,25817,2016-12-31,13503,22163,35666
25,25817,2017-12-31,14347,23286,37633
25,25817,2018-12-31,15355,24641,39996
25,25817,2019-12-31,16970,26050,43020
25,25817,2020-12-31,18488,27226,45714
25,25817,2021-12-31,20225,27314,47539
25,25817,2022-12-31,21661,27374,49035
25,25817,2023-12-31,23002,27426,50428
25,25817,2024-12-31,24115,27490,51605
25,25817,2025-12-31,25072,27548,52620
25,25817,2026-12-31,25896,27637,53533
25,25817,2027-12-31,26633,27727,54360
25,25817,2028-12-31,27266,27827,55093
25,25817,2029-12-31,27864,27938,55802
25,25817,2030-12-31,28375,28054,56429
25,25817,2031-12-31,28853,28181,57034
25,25817,2032-12-31,29325,28291,57616
25,25817,2033-12-31,29785,28412,58197
25,25817,2034-12-31,30232,28513,58745
25,25817,2035-12-31,30675,28630,59305
25,25823,1985-12-31,551,8658,9209
25,25823,1986-12-31,479,8225,8704
25,25823,1987-12-31,454,7820,8274
25,25823,1988-12-31,460,7459,7919
25,25823,1989-12-31,481,7097,7578
25,25823,1990-12-31,475,6764,7239
25,25823,1991-12-31,448,6468,6916
25,25823,1992-12-31,436,6175,6611
25,25823,1993-12-31,423,5883,6306
25,25823,1994-12-31,430,5653,6083
25,25823,1995-12-31,427,5424,5851
25,25823,1996-12-31,404,5217,5621
25,25823,1997-12-31,407,5041,5448
25,25823,1998-12-31,426,4904,5330
25,25823,1999-12-31,447,4755,5202
25,25823,2000-12-31,423,4625,5048
25,25823,2001-12-31,411,4472,4883
25,25823,2002-12-31,425,4345,4770
25,25823,2003-12-31,443,4227,4670
25,25823,2004-12-31,454,4121,4575
25,25823,2005-12-31,466,4029,4495
25,25823,2006-12-31,437,3924,4361
25,25823,2007-12-31,440,3851,4291
25,25823,2008-12-31,465,3773,4238
25,25823,2009-12-31,474,3721,4195
25,25823,2010-12-31,491,3657,4148
25,25823,2011-12-31,489,3622,4111
25,25823,2012-12-31,544,3581,4125
25,25823,2013-12-31,564,3542,4106
25,25823,2014-12-31,569,3514,4083
25,25823,2015-12-31,590,3486,4076
25,25823,2016-12-31,620,3471,4091
25,25823,2017-12-31,645,3432,4077
25,25823,2018-12-31,674,3465,4139
25,25823,2019-12-31,715,3474,4189
25,25823,2020-12-31,759,3525,4284
25,25823,2021-12-31,918,3536,4454
25,25823,2022-12-31,1050,3544,4594
25,25823,2023-12-31,1174,3551,4725
25,25823,2024-12-31,1228,3553,4781
25,25823,2025-12-31,1272,3564,4836
25,25823,2026-12-31,1300,3575,4875
25,25823,2027-12-31,1335,3590,4925
25,25823,2028-12-31,1371,3586,4957
25,25823,2029-12-31,1394,3598,4992
25,25823,2030-12-31,1420,3616,5036
25,25823,2031-12-31,1450,3622,5072
25,25823,2032-12-31,1477,3642,5119
25,25823,2033-12-31,1496,3649,5145
25,25823,2034-12-31,1516,3675,5191
25,25823,2035-12-31,1533,3684,5217
25,25839,1985-12-31,2094,17573,19667
25,25839,1986-12-31,1978,16667,18645
25,25839,1987-12-31,1850,15830,17680
25,25839,1988-12-31,1737,15042,16779
25,25839,1989-12-31,1647,14309,15956
25,25839,1990-12-31,1590,13615,15205
25,25839,1991-12-31,1577,12975,14552
25,25839,1992-12-31,1472,12345,13817
25,25839,1993-12-31,1407,11773,13180
25,25839,1994-12-31,1382,11268,12650
25,25839,1995-12-31,1347,10817,12164
25,25839,1996-12-31,1311,10386,11697
25,25839,1997-12-31,1309,10000,11309
25,25839,1998-12-31,1236,9728,10964
25,25839,1999-12-31,1223,9407,10630
25,25839,2000-12-31,1177,9082,10259
25,25839,2001-12-31,1178,8793,9971
25,25839,2002-12-31,1185,8527,9712
25,25839,2003-12-31,1183,8279,9462
25,25839,2004-12-31,1151,8027,9178
25,25839,2005-12-31,1141,7806,8947
25,25839,2006-12-31,1139,7595,8734
25,25839,2007-12-31,1149,7403,8552
25,25839,2008-12-31,1153,7253,8406
25,25839,2009-12-31,1171,7087,8258
25,25839,2010-12-31,1187,6966,8153
25,25839,2011-12-31,1205,6843,8048
25,25839,2012-12-31,1262,6735,7997
25,25839,2013-12-31,1278,6646,7924
25,25839,2014-12-31,1273,6536,7809
25,25839,2015-12-31,1280,6444,7724
25,25839,2016-12-31,1338,6379,7717
25,25839,2017-12-31,1388,6334,7722
25,25839,2018-12-31,1432,6285,7717
25,25839,2019-12-31,1457,6239,7696
25,25839,2020-12-31,1480,6309,7789
25,25839,2021-12-31,1795,6303,8098
25,25839,2022-12-31,2037,6316,8353
25,25839,2023-12-31,2264,6327,8591
25,25839,2024-12-31,2359,6334,8693
25,25839,2025-12-31,2432,6362,8794
25,25839,2026-12-31,2501,6372,8873
25,25839,2027-12-31,2561,6392,8953
25,25839,2028-12-31,2628,6422,9050
25,25839,2029-12-31,2680,6428,9108
25,25839,2030-12-31,2728,6461,9189
25,25839,2031-12-31,2779,6481,9260
25,25839,2032-12-31,2819,6512,9331
25,25839,2033-12-31,2864,6550,9414
25,25839,2034-12-31,2909,6549,9458
25,25839,2035-12-31,2954,6587,9541
25,25841,1985-12-31,1090,10464,11554
25,25841,1986-12-31,1037,10007,11044
25,25841,1987-12-31,946,9567,10513
25,25841,1988-12-31,899,9162,10061
25,25841,1989-12-31,903,8772,9675
25,25841,1990-12-31,918,8397,9315
25,25841,1991-12-31,821,8051,8872
25,25841,1992-12-31,833,7758,8591
25,25841,1993-12-31,844,7456,8300
25,25841,1994-12-31,840,7194,8034
25,25841,1995-12-31,807,6959,7766
25,25841,1996-12-31,764,6771,7535
25,25841,1997-12-31,737,6561,7298
25,25841,1998-12-31,783,6434,7217
25,25841,1999-12-31,748,6291,7039
25,25841,2000-12-31,785,6148,6933
25,25841,2001-12-31,776,6004,6780
25,25841,2002-12-31,790,5902,6692
25,25841,2003-12-31,732,5781,6513
25,25841,2004-12-31,754,5675,6429
25,25841,2005-12-31,740,5593,6333
25,25841,2006-12-31,784,5512,6296
25,25841,2007-12-31,762,5447,6209
25,25841,2008-12-31,777,5407,6184
25,25841,2009-12-31,798,5372,6170
25,25841,2010-12-31,809,5367,6176
25,25841,2011-12-31,876,5336,6212
25,25841,2012-12-31,880,5363,6243
25,25841,2013-12-31,887,5361,6248
25,25841,2014-12-31,927,5381,6308
25,25841,2015-12-31,943,5422,6365
25,25841,2016-12-31,1019,5471,6490
25,25841,2017-12-31,1062,5532,6594
25,25841,2018-12-31,1094,5633,6727
25,25841,2019-12-31,1152,5723,6875
25,25841,2020-12-31,1213,5854,7067
25,25841,2021-12-31,1475,5873,7348
25,25841,2022-12-31,1693,5886,7579
25,25841,2023-12-31,1897,5897,7794
25,25841,2024-12-31,1994,5912,7906
25,25841,2025-12-31,2045,5916,7961
25,25841,2026-12-31,2114,5935,8049
25,25841,2027-12-31,2162,5955,8117
25,25841,2028-12-31,2206,5966,8172
25,25841,2029-12-31,2257,6001,8258
25,25841,2030-12-31,2293,6024,8317
25,25841,2031-12-31,2334,6042,8376
25,25841,2032-12-31,2363,6060,8423
25,25841,2033-12-31,2408,6091,8499
25,25841,2034-12-31,2440,6106,8546
25,25841,2035-12-31,2481,6129,8610
25,25843,1985-12-31,17714,13028,30742
25,25843,1986-12-31,17342,12612,29954
25,25843,1987-12-31,17056,12218,29274
25,25843,1988-12-31,16777,11860,28637
25,25843,1989-12-31,16539,11517,28056
25,25843,1990-12-31,16322,11182,27504
25,25843,1991-12-31,16169,10850,27019
25,25843,1992-12-31,16057,10550,26607
25,25843,1993-12-31,15943,10301,26244
25,25843,1994-12-31,15948,10102,26050
25,25843,1995-12-31,16001,9903,25904
25,25843,1996-12-31,16073,9730,25803
25,25843,1997-12-31,16204,9598,25802
25,25843,1998-12-31,16245,9585,25830
25,25843,1999-12-31,16445,9481,25926
25,25843,2000-12-31,16669,9419,26088
25,25843,2001-12-31,16937,9338,26275
25,25843,2002-12-31,17246,9280,26526
25,25843,2003-12-31,17579,9245,26824
25,25843,2004-12-31,17948,9215,27163
25,25843,2005-12-31,18353,9200,27553
25,25843,2006-12-31,18829,9219,28048
25,25843,2007-12-31,19381,9259,28640
25,25843,2008-12-31,19989,9341,29330
25,25843,2009-12-31,20690,9435,30125
25,25843,2010-12-31,21458,9560,31018
25,25843,2011-12-31,22320,9706,32026
25,25843,2012-12-31,23241,9868,33109
25,25843,2013-12-31,24242,10058,34300
25,25843,2014-12-31,25345,10289,35634
25,25843,2015-12-31,26536,10515,37051
25,25843,2016-12-31,27839,10799,38638
25,25843,2017-12-31,29312,11119,40431
25,25843,2018-12-31,31042,11516,42558
25,25843,2019-12-31,33675,11127,44802
25,25843,2020-12-31,36231,10680,46911
25,25843,2021-12-31,38062,10712,48774
25,25843,2022-12-31,39573,10736,50309
25,25843,2023-12-31,40982,10756,51738
25,25843,2024-12-31,42357,10784,53141
25,25843,2025-12-31,43680,10805,54485
25,25843,2026-12-31,44916,10850,55766
25,25843,2027-12-31,46071,10876,56947
25,25843,2028-12-31,47131,10911,58042
25,25843,2029-12-31,48104,10967,59071
25,25843,2030-12-31,48971,10991,59962
25,25843,2031-12-31,49789,11045,60834
25,25843,2032-12-31,50595,11105,61700
25,25843,2033-12-31,51402,11136,62538
25,25843,2034-12-31,52175,11191,63366
25,25843,2035-12-31,52946,11221,64167
25,25845,1985-12-31,3746,6792,10538
25,25845,1986-12-31,3591,6471,10062
25,25845,1987-12-31,3410,6179,9589
25,25845,1988-12-31,3273,5908,9181
25,25845,1989-12-31,3121,5636,8757
25,25845,1990-12-31,2999,5419,8418
25,25845,1991-12-31,2917,5167,8084
25,25845,1992-12-31,2833,4968,7801
25,25845,1993-12-31,2747,4748,7495
25,25845,1994-12-31,2700,4587,7287
25,25845,1995-12-31,2649,4427,7076
25,25845,1996-12-31,2624,4276,6900
25,25845,1997-12-31,2593,4153,6746
25,25845,1998-12-31,2548,4057,6605
25,25845,1999-12-31,2516,3964,6480
25,25845,2000-12-31,2505,3866,6371
25,25845,2001-12-31,2518,3761,6279
25,25845,2002-12-31,2519,3691,6210
25,25845,2003-12-31,2528,3599,6127
25,25845,2004-12-31,2536,3524,6060
25,25845,2005-12-31,2549,3447,5996
25,25845,2006-12-31,2572,3405,5977
25,25845,2007-12-31,2614,3356,5970
25,25845,2008-12-31,2657,3330,5987
25,25845,2009-12-31,2712,3282,5994
25,25845,2010-12-31,2775,3267,6042
25,25845,2011-12-31,2853,3250,6103
25,25845,2012-12-31,2913,3236,6149
25,25845,2013-12-31,2995,3228,6223
25,25845,2014-12-31,3094,3251,6345
25,25845,2015-12-31,3222,3236,6458
25,25845,2016-12-31,3315,3264,6579
25,25845,2017-12-31,3446,3254,6700
25,25845,2018-12-31,3618,3327,6945
25,25845,2019-12-31,3823,3321,7144
25,25845,2020-12-31,4042,3329,7371
25,25845,2021-12-31,4325,3339,7664
25,25845,2022-12-31,4559,3346,7905
25,25845,2023-12-31,4777,3353,8130
25,25845,2024-12-31,4949,3357,8306
25,25845,2025-12-31,5102,3365,8467
25,25845,2026-12-31,5249,3379,8628
25,25845,2027-12-31,5366,3387,8753
25,25845,2028-12-31,5501,3400,8901
25,25845,2029-12-31,5613,3414,9027
25,25845,2030-12-31,5706,3432,9138
25,25845,2031-12-31,5814,3430,9244
25,25845,2032-12-31,5893,3450,9343
25,25845,2033-12-31,5992,3472,9464
25,25845,2034-12-31,6086,3464,9550
25,25845,2035-12-31,6174,3485,9659
25,25851,1985-12-31,3864,3948,7812
25,25851,1986-12-31,3664,3773,7437
25,25851,1987-12-31,3409,3589,6998
25,25851,1988-12-31,3240,3432,6672
25,25851,1989-12-31,3065,3231,6296
25,25851,1990-12-31,2905,3115,6020
25,25851,1991-12-31,2798,2987,5785
25,25851,1992-12-31,2675,2868,5543
25,25851,1993-12-31,2552,2752,5304
25,25851,1994-12-31,2470,2642,5112
25,25851,1995-12-31,2394,2560,4954
25,25851,1996-12-31,2321,2467,4788
25,25851,1997-12-31,2292,2378,4670
25,25851,1998-12-31,2216,2325,4541
25,25851,1999-12-31,2167,2271,4438
25,25851,2000-12-31,2131,2215,4346
25,25851,2001-12-31,2123,2143,4266
25,25851,2002-12-31,2105,2088,4193
25,25851,2003-12-31,2066,2033,4099
25,25851,2004-12-31,2021,1986,4007
25,25851,2005-12-31,2035,1951,3986
25,25851,2006-12-31,2028,1918,3946
25,25851,2007-12-31,2002,1894,3896
25,25851,2008-12-31,2009,1879,3888
25,25851,2009-12-31,2054,1837,3891
25,25851,2010-12-31,2046,1839,3885
25,25851,2011-12-31,2081,1829,3910
25,25851,2012-12-31,2101,1823,3924
25,25851,2013-12-31,2136,1826,3962
25,25851,2014-12-31,2178,1809,3987
25,25851,2015-12-31,2217,1772,3989
25,25851,2016-12-31,2311,1790,4101
25,25851,2017-12-31,2295,1860,4155
25,25851,2018-12-31,2406,1840,4246
25,25851,2019-12-31,2470,1854,4324
25,25851,2020-12-31,2561,1873,4434
25,25851,2021-12-31,2731,1879,4610
25,25851,2022-12-31,2872,1883,4755
25,25851,2023-12-31,3003,1887,4890
25,25851,2024-12-31,3108,1887,4995
25,25851,2025-12-31,3193,1891,5084
25,25851,2026-12-31,3289,1893,5182
25,25851,2027-12-31,3370,1893,5263
25,25851,2028-12-31,3442,1905,5347
25,25851,2029-12-31,3515,1902,5417
25,25851,2030-12-31,3583,1906,5489
25,25851,2031-12-31,3635,1908,5543
25,25851,2032-12-31,3696,1921,5617
25,25851,2033-12-31,3747,1931,5678
25,25851,2034-12-31,3807,1933,5740
25,25851,2035-12-31,3869,1935,5804
25,25862,1985-12-31,1913,12599,14512
25,25862,1986-12-31,1743,11998,13741
25,25862,1987-12-31,1662,11443,13105
25,25862,1988-12-31,1557,10920,12477
25,25862,1989-12-31,1484,10418,11902
25,25862,1990-12-31,1430,9949,11379
25,25862,1991-12-31,1341,9499,10840
25,25862,1992-12-31,1280,9090,10370
25,25862,1993-12-31,1242,8702,9944
25,25862,1994-12-31,1237,8380,9617
25,25862,1995-12-31,1161,8075,9236
25,25862,1996-12-31,1156,7804,8960
25,25862,1997-12-31,1120,7527,8647
25,25862,1998-12-31,1092,7363,8455
25,25862,1999-12-31,1063,7152,8215
25,25862,2000-12-31,1043,6926,7969
25,25862,2001-12-31,1076,6754,7830
25,25862,2002-12-31,1011,6580,7591
25,25862,2003-12-31,1015,6421,7436
25,25862,2004-12-31,1001,6285,7286
25,25862,2005-12-31,1005,6144,7149
25,25862,2006-12-31,992,6027,7019
25,25862,2007-12-31,1007,5920,6927
25,25862,2008-12-31,1011,5824,6835
25,25862,2009-12-31,1000,5757,6757
25,25862,2010-12-31,1002,5715,6717
25,25862,2011-12-31,1047,5659,6706
25,25862,2012-12-31,1053,5611,6664
25,25862,2013-12-31,1116,5582,6698
25,25862,2014-12-31,1106,5560,6666
25,25862,2015-12-31,1071,5572,6643
25,25862,2016-12-31,1116,5554,6670
25,25862,2017-12-31,1158,5579,6737
25,25862,2018-12-31,1213,5634,6847
25,25862,2019-12-31,1250,5725,6975
25,25862,2020-12-31,1299,5868,7167
25,25862,2021-12-31,1565,5887,7452
25,25862,2022-12-31,1786,5900,7686
25,25862,2023-12-31,1994,5911,7905
25,25862,2024-12-31,2082,5923,8005
25,25862,2025-12-31,2150,5935,8085
25,25862,2026-12-31,2213,5950,8163
25,25862,2027-12-31,2274,5962,8236
25,25862,2028-12-31,2314,5988,8302
25,25862,2029-12-31,2363,6004,8367
25,25862,2030-12-31,2410,6030,8440
25,25862,2031-12-31,2449,6055,8504
25,25862,2032-12-31,2483,6065,8548
25,25862,2033-12-31,2521,6084,8605
25,25862,2034-12-31,2568,6114,8682
25,25862,2035-12-31,2586,6136,8722
25,25867,1985-12-31,1381,4080,5461
25,25867,1986-12-31,1295,3932,5227
25,25867,1987-12-31,1268,3759,5027
25,25867,1988-12-31,1229,3625,4854
25,25867,1989-12-31,1116,3495,4611
25,25867,1990-12-31,1146,3391,4537
25,25867,1991-12-31,1060,3268,4328
25,25867,1992-12-31,1051,3178,4229
25,25867,1993-12-31,1021,3067,4088
25,25867,1994-12-31,1010,2977,3987
25,25867,1995-12-31,974,2888,3862
25,25867,1996-12-31,971,2852,3823
25,25867,1997-12-31,952,2761,3713
25,25867,1998-12-31,952,2749,3701
25,25867,1999-12-31,951,2705,3656
25,25867,2000-12-31,951,2652,3603
25,25867,2001-12-31,949,2612,3561
25,25867,2002-12-31,948,2592,3540
25,25867,2003-12-31,957,2554,3511
25,25867,2004-12-31,968,2530,3498
25,25867,2005-12-31,989,2507,3496
25,25867,2006-12-31,1002,2513,3515
25,25867,2007-12-31,994,2510,3504
25,25867,2008-12-31,1015,2519,3534
25,25867,2009-12-31,1046,2515,3561
25,25867,2010-12-31,1063,2538,3601
25,25867,2011-12-31,1119,2549,3668
25,25867,2012-12-31,1133,2584,3717
25,25867,2013-12-31,1202,2599,3801
25,25867,2014-12-31,1229,2653,3882
25,25867,2015-12-31,1250,2689,3939
25,25867,2016-12-31,1308,2746,4054
25,25867,2017-12-31,1391,2807,4198
25,25867,2018-12-31,1449,2890,4339
25,25867,2019-12-31,1527,2970,4497
25,25867,2020-12-31,1613,3054,4667
25,25867,2021-12-31,1788,3064,4852
25,25867,2022-12-31,1934,3071,5005
25,25867,2023-12-31,2071,3076,5147
25,25867,2024-12-31,2158,3078,5236
25,25867,2025-12-31,2211,3089,5300
25,25867,2026-12-31,2277,3103,5380
25,25867,2027-12-31,2341,3105,5446
25,25867,2028-12-31,2387,3120,5507
25,25867,2029-12-31,2443,3122,5565
25,25867,2030-12-31,2492,3139,5631
25,25867,2031-12-31,2534,3148,5682
25,25867,2032-12-31,2568,3169,5737
25,25867,2033-12-31,2609,3155,5764
25,25867,2034-12-31,2640,3178,5818
25,25867,2035-12-31,2681,3178,5859
25,25871,1985-12-31,905,2890,3795
25,25871,1986-12-31,834,2753,3587
25,25871,1987-12-31,806,2572,3378
25,25871,1988-12-31,759,2482,3241
25,25871,1989-12-31,740,2393,3133
25,25871,1990-12-31,700,2194,2894
25,25871,1991-12-31,666,2107,2773
25,25871,1992-12-31,622,2072,2694
25,25871,1993-12-31,607,1962,2569
25,25871,1994-12-31,616,1845,2461
25,25871,1995-12-31,599,1807,2406
25,25871,1996-12-31,559,1747,2306
25,25871,1997-12-31,546,1679,2225
25,25871,1998-12-31,537,1627,2164
25,25871,1999-12-31,526,1587,2113
25,25871,2000-12-31,512,1523,2035
25,25871,2001-12-31,480,1479,1959
25,25871,2002-12-31,480,1441,1921
25,25871,2003-12-31,468,1404,1872
25,25871,2004-12-31,471,1348,1819
25,25871,2005-12-31,509,1348,1857
25,25871,2006-12-31,506,1307,1813
25,25871,2007-12-31,500,1257,1757
25,25871,2008-12-31,494,1227,1721
25,25871,2009-12-31,496,1211,1707
25,25871,2010-12-31,495,1193,1688
25,25871,2011-12-31,503,1191,1694
25,25871,2012-12-31,526,1155,1681
25,25871,2013-12-31,514,1159,1673
25,25871,2014-12-31,598,1149,1747
25,25871,2015-12-31,571,1150,1721
25,25871,2016-12-31,562,1166,1728
25,25871,2017-12-31,586,1135,1721
25,25871,2018-12-31,610,1148,1758
25,25871,2019-12-31,629,1154,1783
25,25871,2020-12-31,655,1171,1826
25,25871,2021-12-31,724,1175,1899
25,25871,2022-12-31,781,1177,1958
25,25871,2023-12-31,834,1180,2014
25,25871,2024-12-31,872,1174,2046
25,25871,2025-12-31,899,1192,2091
25,25871,2026-12-31,919,1195,2114
25,25871,2027-12-31,941,1189,2130
25,25871,2028-12-31,952,1190,2142
25,25871,2029-12-31,976,1191,2167
25,25871,2030-12-31,996,1191,2187
25,25871,2031-12-31,1015,1194,2209
25,25871,2032-12-31,1036,1202,2238
25,25871,2033-12-31,1048,1201,2249
25,25871,2034-12-31,1071,1216,2287
25,25871,2035-12-31,1077,1222,2299
25,25873,1985-12-31,4974,16787,21761
25,25873,1986-12-31,4796,16105,20901
25,25873,1987-12-31,4644,15466,20110
25,25873,1988-12-31,4487,14855,19342
25,25873,1989-12-31,4353,14283,18636
25,25873,1990-12-31,4203,13751,17954
25,25873,1991-12-31,4116,13240,17356
25,25873,1992-12-31,4052,12791,16843
25,25873,1993-12-31,3983,12348,16331
25,25873,1994-12-31,3944,11991,15935
25,25873,1995-12-31,3915,11667,15582
25,25873,1996-12-31,3890,11356,15246
25,25873,1997-12-31,3885,11092,14977
25,25873,1998-12-31,3855,10943,14798
25,25873,1999-12-31,3857,10746,14603
25,25873,2000-12-31,3869,10558,14427
25,25873,2001-12-31,3901,10378,14279
25,25873,2002-12-31,3926,10225,14151
25,25873,2003-12-31,3976,10085,14061
25,25873,2004-12-31,4033,9976,14009
25,25873,2005-12-31,4090,9844,13934
25,25873,2006-12-31,4169,9761,13930
25,25873,2007-12-31,4257,9720,13977
25,25873,2008-12-31,4359,9699,14058
25,25873,2009-12-31,4472,9717,14189
25,25873,2010-12-31,4627,9745,14372
25,25873,2011-12-31,4768,9795,14563
25,25873,2012-12-31,4946,9870,14816
25,25873,2013-12-31,5124,9962,15086
25,25873,2014-12-31,5316,10060,15376
25,25873,2015-12-31,5534,10191,15725
25,25873,2016-12-31,5767,10348,16115
25,25873,2017-12-31,6042,10547,16589
25,25873,2018-12-31,6373,10814,17187
25,25873,2019-12-31,6763,11033,17796
25,25873,2020-12-31,7171,11262,18433
25,25873,2021-12-31,7867,11298,19165
25,25873,2022-12-31,8445,11323,19768
25,25873,2023-12-31,8985,11345,20330
25,25873,2024-12-31,9328,11380,20708
25,25873,2025-12-31,9618,11411,21029
25,25873,2026-12-31,9889,11439,21328
25,25873,2027-12-31,10149,11480,21629
25,25873,2028-12-31,10389,11509,21898
25,25873,2029-12-31,10591,11558,22149
25,25873,2030-12-31,10789,11614,22403
25,25873,2031-12-31,10971,11653,22624
25,25873,2032-12-31,11159,11698,22857
25,25873,2033-12-31,11337,11750,23087
25,25873,2034-12-31,11486,11781,23267
25,25873,2035-12-31,11663,11832,23495
25,25875,1985-12-31,15213,14801,30014
25,25875,1986-12-31,14573,14175,28748
25,25875,1987-12-31,14028,13593,27621
25,25875,1988-12-31,13573,13044,26617
25,25875,1989-12-31,13142,12544,25686
25,25875,1990-12-31,12738,12043,24781
25,25875,1991-12-31,12400,11581,23981
25,25875,1992-12-31,12122,11158,23280
25,25875,1993-12-31,11865,10751,22616
25,25875,1994-12-31,11703,10418,22121
25,25875,1995-12-31,11579,10140,21719
25,25875,1996-12-31,11476,9827,21303
25,25875,1997-12-31,11404,9571,20975
25,25875,1998-12-31,11283,9439,20722
25,25875,1999-12-31,11297,9232,20529
25,25875,2000-12-31,11332,9041,20373
25,25875,2001-12-31,11371,8867,20238
25,25875,2002-12-31,11455,8714,20169
25,25875,2003-12-31,11556,8581,20137
25,25875,2004-12-31,11687,8463,20150
25,25875,2005-12-31,11823,8354,20177
25,25875,2006-12-31,12018,8264,20282
25,25875,2007-12-31,12236,8213,20449
25,25875,2008-12-31,12520,8165,20685
25,25875,2009-12-31,12844,8141,20985
25,25875,2010-12-31,13221,8145,21366
25,25875,2011-12-31,13611,8179,21790
25,25875,2012-12-31,14082,8218,22300
25,25875,2013-12-31,14567,8253,22820
25,25875,2014-12-31,15098,8334,23432
25,25875,2015-12-31,15691,8441,24132
25,25875,2016-12-31,16352,8551,24903
25,25875,2017-12-31,17098,8672,25770
25,25875,2018-12-31,17985,8888,26873
25,25875,2019-12-31,19062,8924,27986
25,25875,2020-12-31,20199,8929,29128
25,25875,2021-12-31,21329,8956,30285
25,25875,2022-12-31,22262,8976,31238
25,25875,2023-12-31,23132,8993,32125
25,25875,2024-12-31,23914,9020,32934
25,25875,2025-12-31,24650,9029,33679
25,25875,2026-12-31,25350,9055,34405
25,25875,2027-12-31,25987,9098,35085
25,25875,2028-12-31,26592,9108,35700
25,25875,2029-12-31,27131,9146,36277
25,25875,2030-12-31,27626,9166,36792
25,25875,2031-12-31,28081,9218,37299
25,25875,2032-12-31,28528,9246,37774
25,25875,2033-12-31,28979,9284,38263
25,25875,2034-12-31,29409,9323,38732
25,25875,2035-12-31,29848,9355,39203
25,25878,1985-12-31,5554,18394,23948
25,25878,1986-12-31,5243,17546,22789
25,25878,1987-12-31,4997,16727,21724
25,25878,1988-12-31,4758,15995,20753
25,25878,1989-12-31,4521,15299,19820
25,25878,1990-12-31,4273,14658,18931
25,25878,1991-12-31,4147,14030,18177
25,25878,1992-12-31,3975,13408,17383
25,25878,1993-12-31,3849,12861,16710
25,25878,1994-12-31,3746,12395,16141
25,25878,1995-12-31,3672,11961,15633
25,25878,1996-12-31,3589,11565,15154
25,25878,1997-12-31,3509,11216,14725
25,25878,1998-12-31,3428,10983,14411
25,25878,1999-12-31,3383,10685,14068
25,25878,2000-12-31,3351,10395,13746
25,25878,2001-12-31,3339,10137,13476
25,25878,2002-12-31,3305,9908,13213
25,25878,2003-12-31,3289,9686,12975
25,25878,2004-12-31,3280,9486,12766
25,25878,2005-12-31,3283,9320,12603
25,25878,2006-12-31,3288,9164,12452
25,25878,2007-12-31,3313,9034,12347
25,25878,2008-12-31,3359,8916,12275
25,25878,2009-12-31,3404,8850,12254
25,25878,2010-12-31,3457,8792,12249
25,25878,2011-12-31,3522,8733,12255
25,25878,2012-12-31,3601,8722,12323
25,25878,2013-12-31,3667,8696,12363
25,25878,2014-12-31,3756,8711,12467
25,25878,2015-12-31,3858,8725,12583
25,25878,2016-12-31,3985,8761,12746
25,25878,2017-12-31,4106,8829,12935
25,25878,2018-12-31,4286,8948,13234
25,25878,2019-12-31,4461,9047,13508
25,25878,2020-12-31,4673,9205,13878
25,25878,2021-12-31,5194,9235,14429
25,25878,2022-12-31,5628,9255,14883
25,25878,2023-12-31,6033,9273,15306
25,25878,2024-12-31,6267,9295,15562
25,25878,2025-12-31,6482,9323,15805
25,25878,2026-12-31,6650,9339,15989
25,25878,2027-12-31,6817,9370,16187
25,25878,2028-12-31,6975,9415,16390
25,25878,2029-12-31,7120,9425,16545
25,25878,2030-12-31,7242,9459,16701
25,25878,2031-12-31,7367,9497,16864
25,25878,2032-12-31,7469,9538,17007
25,25878,2033-12-31,7607,9569,17176
25,25878,2034-12-31,7717,9582,17299
25,25878,2035-12-31,7829,9617,17446
25,25885,1985-12-31,3448,25533,28981
25,25885,1986-12-31,3255,24260,27515
25,25885,1987-12-31,3091,23048,26139
25,25885,1988-12-31,2932,21916,24848
25,25885,1989-12-31,2797,20890,23687
25,25885,1990-12-31,2673,19847,22520
25,25885,1991-12-31,2590,18927,21517
25,25885,1992-12-31,2499,18021,20520
25,25885,1993-12-31,2410,17187,19597
25,25885,1994-12-31,2349,16482,18831
25,25885,1995-12-31,2328,15830,18158
25,25885,1996-12-31,2267,15218,17485
25,25885,1997-12-31,2230,14650,16880
25,25885,1998-12-31,2189,14273,16462
25,25885,1999-12-31,2154,13784,15938
25,25885,2000-12-31,2142,13347,15489
25,25885,2001-12-31,2145,12927,15072
25,25885,2002-12-31,2116,12544,14660
25,25885,2003-12-31,2114,12175,14289
25,25885,2004-12-31,2110,11831,13941
25,25885,2005-12-31,2129,11513,13642
25,25885,2006-12-31,2136,11211,13347
25,25885,2007-12-31,2155,10950,13105
25,25885,2008-12-31,2196,10727,12923
25,25885,2009-12-31,2224,10524,12748
25,25885,2010-12-31,2251,10337,12588
25,25885,2011-12-31,2299,10166,12465
25,25885,2012-12-31,2371,10025,12396
25,25885,2013-12-31,2410,9883,12293
25,25885,2014-12-31,2471,9767,12238
25,25885,2015-12-31,2559,9658,12217
25,25885,2016-12-31,2631,9572,12203
25,25885,2017-12-31,2720,9499,12219
25,25885,2018-12-31,2848,9474,12322
25,25885,2019-12-31,2989,9378,12367
25,25885,2020-12-31,3147,9417,12564
25,25885,2021-12-31,3617,9446,13063
25,25885,2022-12-31,4008,9466,13474
25,25885,2023-12-31,4373,9484,13857
25,25885,2024-12-31,4560,9510,14070
25,25885,2025-12-31,4706,9532,14238
25,25885,2026-12-31,4840,9531,14371
25,25885,2027-12-31,4958,9549,14507
25,25885,2028-12-31,5062,9589,14651
25,25885,2029-12-31,5181,9649,14830
25,25885,2030-12-31,5257,9671,14928
25,25885,2031-12-31,5350,9715,15065
25,25885,2032-12-31,5429,9731,15160
25,25885,2033-12-31,5521,9773,15294
25,25885,2034-12-31,5590,9808,15398
25,25885,2035-12-31,5688,9836,15524
25,25898,1985-12-31,1828,3895,5723
25,25898,1986-12-31,1688,3776,5464
25,25898,1987-12-31,1613,3628,5241
25,25898,1988-12-31,1484,3530,5014
25,25898,1989-12-31,1440,3425,4865
25,25898,1990-12-31,1364,3329,4693
25,25898,1991-12-31,1322,3252,4574
25,25898,1992-12-31,1265,3167,4432
25,25898,1993-12-31,1214,3094,4308
25,25898,1994-12-31,1185,3019,4204
25,25898,1995-12-31,1133,2943,4076
25,25898,1996-12-31,1133,2897,4030
25,25898,1997-12-31,1094,2850,3944
25,25898,1998-12-31,1071,2852,3923
25,25898,1999-12-31,1037,2836,3873
25,25898,2000-12-31,1036,2798,3834
25,25898,2001-12-31,1036,2779,3815
25,25898,2002-12-31,1018,2757,3775
25,25898,2003-12-31,1004,2735,3739
25,25898,2004-12-31,1019,2734,3753
25,25898,2005-12-31,1010,2740,3750
25,25898,2006-12-31,985,2753,3738
25,25898,2007-12-31,1006,2756,3762
25,25898,2008-12-31,983,2775,3758
25,25898,2009-12-31,1014,2807,3821
25,25898,2010-12-31,1052,2826,3878
25,25898,2011-12-31,1054,2884,3938
25,25898,2012-12-31,1057,2947,4004
25,25898,2013-12-31,1081,2996,4077
25,25898,2014-12-31,1088,3057,4145
25,25898,2015-12-31,1127,3121,4248
25,25898,2016-12-31,1140,3224,4364
25,25898,2017-12-31,1186,3315,4501
25,25898,2018-12-31,1228,3431,4659
25,25898,2019-12-31,1308,3528,4836
25,25898,2020-12-31,1387,3635,5022
25,25898,2021-12-31,1574,3647,5221
25,25898,2022-12-31,1731,3655,5386
25,25898,2023-12-31,1877,3662,5539
25,25898,2024-12-31,1956,3677,5633
25,25898,2025-12-31,2023,3684,5707
25,25898,2026-12-31,2063,3694,5757
25,25898,2027-12-31,2132,3701,5833
25,25898,2028-12-31,2174,3697,5871
25,25898,2029-12-31,2215,3715,5930
25,25898,2030-12-31,2268,3746,6014
25,25898,2031-12-31,2301,3750,6051
25,25898,2032-12-31,2332,3774,6106
25,25898,2033-12-31,2370,3784,6154
25,25898,2034-12-31,2416,3799,6215
25,25898,2035-12-31,2434,3810,6244
25,25899,1985-12-31,71201,15078,86279
25,25899,1986-12-31,69061,14967,84028
25,25899,1987-12-31,67239,14883,82122
25,25899,1988-12-31,65658,14783,80441
25,25899,1989-12-31,64225,14701,78926
25,25899,1990-12-31,62955,14600,77555
25,25899,1991-12-31,61918,14496,76414
25,25899,1992-12-31,61029,14436,75465
25,25899,1993-12-31,60242,14360,74602
25,25899,1994-12-31,59908,14358,74266
25,25899,1995-12-31,59754,14392,74146
25,25899,1996-12-31,59698,14426,74124
25,25899,1997-12-31,59829,14502,74331
25,25899,1998-12-31,59672,14724,74396
25,25899,1999-12-31,60115,14869,74984
25,25899,2000-12-31,60685,15014,75699
25,25899,2001-12-31,61391,15184,76575
25,25899,2002-12-31,62216,15363,77579
25,25899,2003-12-31,63176,15560,78736
25,25899,2004-12-31,64247,15798,80045
25,25899,2005-12-31,65452,16019,81471
25,25899,2006-12-31,66914,16297,83211
25,25899,2007-12-31,68610,16632,85242
25,25899,2008-12-31,70559,17004,87563
25,25899,2009-12-31,72771,17432,90203
25,25899,2010-12-31,75256,17935,93191
25,25899,2011-12-31,78002,18487,96489
25,25899,2012-12-31,80987,19067,100054
25,25899,2013-12-31,84262,19706,103968
25,25899,2014-12-31,87832,20411,108243
25,25899,2015-12-31,91697,21165,112862
25,25899,2016-12-31,96012,22011,118023
25,25899,2017-12-31,100814,22928,123742
25,25899,2018-12-31,106461,24076,130537
25,25899,2019-12-31,114204,24450,138654
25,25899,2020-12-31,121962,24390,146352
25,25899,2021-12-31,127731,24464,152195
25,25899,2022-12-31,132465,24518,156983
25,25899,2023-12-31,136881,24564,161445
25,25899,2024-12-31,141280,24632,165912
25,25899,2025-12-31,145563,24699,170262
25,25899,2026-12-31,149636,24779,174415
25,25899,2027-12-31,153440,24875,178315
25,25899,2028-12-31,156966,24966,181932
25,25899,2029-12-31,160185,25050,185235
25,25899,2030-12-31,163081,25135,188216
25,25899,2031-12-31,165783,25257,191040
25,25899,2032-12-31,168454,25355,193809
25,25899,2033-12-31,171083,25456,196539
25,25899,2034-12-31,173669,25563,199232
25,25899,2035-12-31,176209,25660,201869
27,27001,1985-12-31,29977,31714,61691
27,27001,1986-12-31,31104,32075,63179
27,27001,1987-12-31,32566,32440,65006
27,27001,1988-12-31,34212,32789,67001
27,27001,1989-12-31,36103,33136,69239
27,27001,1990-12-31,38222,33484,71706
27,27001,1991-12-31,40380,33792,74172
27,27001,1992-12-31,42750,34150,76900
27,27001,1993-12-31,44867,35392,80259
27,27001,1994-12-31,49093,35195,84288
27,27001,1995-12-31,51400,35609,87009
27,27001,1996-12-31,53609,36042,89651
27,27001,1997-12-31,54362,30855,85217
27,27001,1998-12-31,61201,27006,88207
27,27001,1999-12-31,62984,26767,89751
27,27001,2000-12-31,68912,24999,93911
27,27001,2001-12-31,74928,23272,98200
27,27001,2002-12-31,79566,22431,101997
27,27001,2003-12-31,81818,22191,104009
27,27001,2004-12-31,84249,21943,106192
27,27001,2005-12-31,86670,21673,108343
27,27001,2006-12-31,89092,21398,110490
27,27001,2007-12-31,91457,21116,112573
27,27001,2008-12-31,93765,20775,114540
27,27001,2009-12-31,96052,20419,116471
27,27001,2010-12-31,98290,20049,118339
27,27001,2011-12-31,100356,19633,119989
27,27001,2012-12-31,102451,19206,121657
27,27001,2013-12-31,104429,18748,123177
27,27001,2014-12-31,106330,18238,124568
27,27001,2015-12-31,108178,17731,125909
27,27001,2016-12-31,109942,17177,127119
27,27001,2017-12-31,111541,16673,128214
27,27001,2018-12-31,113124,16113,129237
27,27001,2019-12-31,112765,17277,130042
27,27001,2020-12-31,112380,18445,130825
27,27001,2021-12-31,113144,18742,131886
27,27001,2022-12-31,113886,19032,132918
27,27001,2023-12-31,114586,19320,133906
27,27001,2024-12-31,114653,19592,134245
27,27001,2025-12-31,114552,19865,134417
27,27001,2026-12-31,114508,20174,134682
27,27001,2027-12-31,114508,20469,134977
27,27001,2028-12-31,114618,20742,135360
27,27001,2029-12-31,114835,21029,135864
27,27001,2030-12-31,115133,21328,136461
27,27001,2031-12-31,115493,21624,137117
27,27001,2032-12-31,115808,21916,137724
27,27001,2033-12-31,116019,22207,138226
27,27001,2034-12-31,116185,22500,138685
27,27001,2035-12-31,116295,22788,139083
27,27006,1985-12-31,2159,5395,7554
27,27006,1986-12-31,2221,5429,7650
27,27006,1987-12-31,2283,5432,7715
27,27006,1988-12-31,2391,5473,7864
27,27006,1989-12-31,2494,5500,7994
27,27006,1990-12-31,2618,5524,8142
27,27006,1991-12-31,2746,5549,8295
27,27006,1992-12-31,2884,5583,8467
27,27006,1993-12-31,3005,5761,8766
27,27006,1994-12-31,3261,5718,8979
27,27006,1995-12-31,3400,5760,9160
27,27006,1996-12-31,3509,5806,9315
27,27006,1997-12-31,3548,5966,9514
27,27006,1998-12-31,3968,5711,9679
27,27006,1999-12-31,4068,5625,9693
27,27006,2000-12-31,4419,5418,9837
27,27006,2001-12-31,4802,5233,10035
27,27006,2002-12-31,5081,5223,10304
27,27006,2003-12-31,5207,5348,10555
27,27006,2004-12-31,5348,5439,10787
27,27006,2005-12-31,5473,5622,11095
27,27006,2006-12-31,5613,5760,11373
27,27006,2007-12-31,5738,5890,11628
27,27006,2008-12-31,5864,6015,11879
27,27006,2009-12-31,5988,6147,12135
27,27006,2010-12-31,6123,6277,12400
27,27006,2011-12-31,6212,6374,12586
27,27006,2012-12-31,6326,6522,12848
27,27006,2013-12-31,6447,6597,13044
27,27006,2014-12-31,6547,6714,13261
27,27006,2015-12-31,6640,6802,13442
27,27006,2016-12-31,6727,6936,13663
27,27006,2017-12-31,6836,7004,13840
27,27006,2018-12-31,6895,7104,13999
27,27006,2019-12-31,6719,7366,14085
27,27006,2020-12-31,6518,7641,14159
27,27006,2021-12-31,6510,7764,14274
27,27006,2022-12-31,6501,7884,14385
27,27006,2023-12-31,6490,8003,14493
27,27006,2024-12-31,6478,8123,14601
27,27006,2025-12-31,6465,8249,14714
27,27006,2026-12-31,6454,8369,14823
27,27006,2027-12-31,6468,8477,14945
27,27006,2028-12-31,6465,8609,15074
27,27006,2029-12-31,6491,8732,15223
27,27006,2030-12-31,6513,8852,15365
27,27006,2031-12-31,6528,8975,15503
27,27006,2032-12-31,6536,9104,15640
27,27006,2033-12-31,6548,9234,15782
27,27006,2034-12-31,6555,9361,15916
27,27006,2035-12-31,6562,9474,16036
27,27025,1985-12-31,554,8420,8974
27,27025,1986-12-31,618,8894,9512
27,27025,1987-12-31,657,9368,10025
27,27025,1988-12-31,713,9838,10551
27,27025,1989-12-31,785,10298,11083
27,27025,1990-12-31,863,10721,11584
27,27025,1991-12-31,938,11185,12123
27,27025,1992-12-31,1024,11634,12658
27,27025,1993-12-31,1089,12377,13466
27,27025,1994-12-31,1204,12640,13844
27,27025,1995-12-31,1292,13082,14374
27,27025,1996-12-31,1370,13534,14904
27,27025,1997-12-31,1402,14308,15710
27,27025,1998-12-31,1619,13983,15602
27,27025,1999-12-31,1673,14128,15801
27,27025,2000-12-31,1816,13940,15756
27,27025,2001-12-31,2000,13711,15711
27,27025,2002-12-31,2143,13966,16109
27,27025,2003-12-31,2231,14560,16791
27,27025,2004-12-31,2305,15207,17512
27,27025,2005-12-31,2393,15907,18300
27,27025,2006-12-31,2476,16585,19061
27,27025,2007-12-31,2572,17264,19836
27,27025,2008-12-31,2647,17931,20578
27,27025,2009-12-31,2739,18613,21352
27,27025,2010-12-31,2802,19267,22069
27,27025,2011-12-31,2877,19929,22806
27,27025,2012-12-31,2953,20566,23519
27,27025,2013-12-31,3031,21179,24210
27,27025,2014-12-31,3110,21811,24921
27,27025,2015-12-31,3191,22422,25613
27,27025,2016-12-31,3255,23022,26277
27,27025,2017-12-31,3310,23632,26942
27,27025,2018-12-31,3356,24228,27584
27,27025,2019-12-31,3465,24517,27982
27,27025,2020-12-31,3585,24708,28293
27,27025,2021-12-31,3427,25101,28528
27,27025,2022-12-31,3261,25490,28751
27,27025,2023-12-31,3092,25874,28966
27,27025,2024-12-31,3074,26271,29345
27,27025,2025-12-31,3056,26652,29708
27,27025,2026-12-31,3056,27031,30087
27,27025,2027-12-31,3057,27425,30482
27,27025,2028-12-31,3047,27794,30841
27,27025,2029-12-31,3059,28179,31238
27,27025,2030-12-31,3062,28553,31615
27,27025,2031-12-31,3073,28943,32016
27,27025,2032-12-31,3083,29325,32408
27,27025,2033-12-31,3089,29679,32768
27,27025,2034-12-31,3106,30025,33131
27,27025,2035-12-31,3100,30360,33460
27,27050,1985-12-31,0,0,0
27,27050,1986-12-31,0,0,0
27,27050,1987-12-31,0,0,0
27,27050,1988-12-31,0,0,0
27,27050,1989-12-31,0,0,0
27,27050,1990-12-31,0,0,0
27,27050,1991-12-31,0,0,0
27,27050,1992-12-31,0,0,0
27,27050,1993-12-31,0,0,0
27,27050,1994-12-31,0,0,0
27,27050,1995-12-31,0,0,0
27,27050,1996-12-31,0,0,0
27,27050,1997-12-31,1052,3143,4195
27,27050,1998-12-31,1220,2973,4193
27,27050,1999-12-31,1258,2906,4164
27,27050,2000-12-31,1393,2795,4188
27,27050,2001-12-31,1574,2652,4226
27,27050,2002-12-31,1697,2641,4338
27,27050,2003-12-31,1771,2691,4462
27,27050,2004-12-31,1852,2713,4565
27,27050,2005-12-31,1924,2783,4707
27,27050,2006-12-31,2001,2824,4825
27,27050,2007-12-31,2084,2866,4950
27,27050,2008-12-31,2143,2905,5048
27,27050,2009-12-31,2232,2932,5164
27,27050,2010-12-31,2283,2975,5258
27,27050,2011-12-31,2392,3027,5419
27,27050,2012-12-31,2488,3074,5562
27,27050,2013-12-31,2572,3122,5694
27,27050,2014-12-31,2652,3146,5798
27,27050,2015-12-31,2700,3211,5911
27,27050,2016-12-31,2743,3210,5953
27,27050,2017-12-31,2800,3208,6008
27,27050,2018-12-31,2858,3205,6063
27,27050,2019-12-31,2893,3252,6145
27,27050,2020-12-31,2931,3277,6208
27,27050,2021-12-31,2930,3329,6259
27,27050,2022-12-31,2927,3381,6308
27,27050,2023-12-31,2924,3432,6356
27,27050,2024-12-31,2918,3480,6398
27,27050,2025-12-31,2905,3525,6430
27,27050,2026-12-31,2916,3577,6493
27,27050,2027-12-31,2921,3626,6547
27,27050,2028-12-31,2914,3684,6598
27,27050,2029-12-31,2922,3740,6662
27,27050,2030-12-31,2933,3790,6723
27,27050,2031-12-31,2936,3846,6782
27,27050,2032-12-31,2941,3888,6829
27,27050,2033-12-31,2951,3929,6880
27,27050,2034-12-31,2948,3962,6910
27,27050,2035-12-31,2956,4022,6978
27,27073,1985-12-31,1141,3709,4850
27,27073,1986-12-31,1150,4323,5473
27,27073,1987-12-31,1182,4936,6118
27,27073,1988-12-31,1177,5559,6736
27,27073,1989-12-31,1235,6157,7392
27,27073,1990-12-31,1260,6740,8000
27,27073,1991-12-31,1278,7341,8619
27,27073,1992-12-31,1343,7917,9260
27,27073,1993-12-31,1398,8705,10103
27,27073,1994-12-31,1484,9158,10642
27,27073,1995-12-31,1514,9723,11237
27,27073,1996-12-31,1566,10330,11896
27,27073,1997-12-31,1558,11147,12705
27,27073,1998-12-31,1717,11098,12815
27,27073,1999-12-31,1735,11422,13157
27,27073,2000-12-31,1878,6216,8094
27,27073,2001-12-31,2007,5999,8006
27,27073,2002-12-31,2108,5988,8096
27,27073,2003-12-31,2129,6153,8282
27,27073,2004-12-31,2152,6311,8463
27,27073,2005-12-31,2194,6480,8674
27,27073,2006-12-31,2247,6648,8895
27,27073,2007-12-31,2283,6820,9103
27,27073,2008-12-31,2312,6992,9304
27,27073,2009-12-31,2343,7166,9509
27,27073,2010-12-31,2378,7309,9687
27,27073,2011-12-31,2410,7490,9900
27,27073,2012-12-31,2433,7634,10067
27,27073,2013-12-31,2438,7756,10194
27,27073,2014-12-31,2466,7891,10357
27,27073,2015-12-31,2488,8053,10541
27,27073,2016-12-31,2513,8180,10693
27,27073,2017-12-31,2553,8297,10850
27,27073,2018-12-31,2589,8422,11011
27,27073,2019-12-31,2527,8622,11149
27,27073,2020-12-31,2488,8774,11262
27,27073,2021-12-31,2440,8915,11355
27,27073,2022-12-31,2391,9053,11444
27,27073,2023-12-31,2340,9190,11530
27,27073,2024-12-31,2294,9322,11616
27,27073,2025-12-31,2256,9456,11712
27,27073,2026-12-31,2199,9598,11797
27,27073,2027-12-31,2162,9737,11899
27,27073,2028-12-31,2119,9867,11986
27,27073,2029-12-31,2074,9998,12072
27,27073,2030-12-31,2030,10143,12173
27,27073,2031-12-31,2005,10267,12272
27,27073,2032-12-31,1968,10413,12381
27,27073,2033-12-31,1930,10551,12481
27,27073,2034-12-31,1891,10686,12577
27,27073,2035-12-31,1859,10831,12690
27,27075,1985-12-31,1017,4269,5286
27,27075,1986-12-31,1121,4231,5352
27,27075,1987-12-31,1229,4203,5432
27,27075,1988-12-31,1324,4170,5494
27,27075,1989-12-31,1493,4140,5633
27,27075,1990-12-31,1603,4108,5711
27,27075,1991-12-31,1731,4074,5805
27,27075,1992-12-31,1832,4048,5880
27,27075,1993-12-31,1985,4143,6128
27,27075,1994-12-31,2212,4031,6243
27,27075,1995-12-31,2363,4016,6379
27,27075,1996-12-31,2492,3992,6484
27,27075,1997-12-31,2541,4099,6640
27,27075,1998-12-31,2906,3875,6781
27,27075,1999-12-31,3033,3806,6839
27,27075,2000-12-31,3356,3619,6975
27,27075,2001-12-31,3693,3428,7121
27,27075,2002-12-31,3963,3386,7349
27,27075,2003-12-31,4119,3443,7562
27,27075,2004-12-31,4274,3493,7767
27,27075,2005-12-31,4423,3544,7967
27,27075,2006-12-31,4574,3589,8163
27,27075,2007-12-31,4714,3621,8335
27,27075,2008-12-31,4855,3672,8527
27,27075,2009-12-31,5015,3743,8758
27,27075,2010-12-31,5174,3789,8963
27,27075,2011-12-31,5283,3784,9067
27,27075,2012-12-31,5461,3837,9298
27,27075,2013-12-31,5636,3865,9501
27,27075,2014-12-31,5733,3909,9642
27,27075,2015-12-31,5856,3940,9796
27,27075,2016-12-31,5987,3975,9962
27,27075,2017-12-31,6118,3959,10077
27,27075,2018-12-31,6172,3951,10123
27,27075,2019-12-31,6199,4008,10207
27,27075,2020-12-31,6211,4068,10279
27,27075,2021-12-31,6229,4133,10362
27,27075,2022-12-31,6246,4197,10443
27,27075,2023-12-31,6261,4260,10521
27,27075,2024-12-31,6283,4315,10598
27,27075,2025-12-31,6319,4393,10712
27,27075,2026-12-31,6360,4455,10815
27,27075,2027-12-31,6427,4517,10944
27,27075,2028-12-31,6478,4576,11054
27,27075,2029-12-31,6552,4646,11198
27,27075,2030-12-31,6648,4697,11345
27,27075,2031-12-31,6752,4777,11529
27,27075,2032-12-31,6875,4830,11705
27,27075,2033-12-31,6991,4899,11890
27,27075,2034-12-31,7138,4961,12099
27,27075,2035-12-31,7295,5022,12317
27,27077,1985-12-31,24,19238,19262
27,27077,1986-12-31,231,19862,20093
27,27077,1987-12-31,372,20517,20889
27,27077,1988-12-31,512,21148,21660
27,27077,1989-12-31,675,21781,22456
27,27077,1990-12-31,852,22389,23241
27,27077,1991-12-31,1026,22994,24020
27,27077,1992-12-31,1221,23611,24832
27,27077,1993-12-31,1394,24839,26233
27,27077,1994-12-31,1631,25058,26689
27,27077,1995-12-31,1822,25703,27525
27,27077,1996-12-31,2003,26358,28361
27,27077,1997-12-31,2145,27611,29756
27,27077,1998-12-31,2511,26738,29249
27,27077,1999-12-31,2691,13909,16600
27,27077,2000-12-31,3074,13696,16770
27,27077,2001-12-31,3455,13411,16866
27,27077,2002-12-31,3789,13614,17403
27,27077,2003-12-31,4024,14181,18205
27,27077,2004-12-31,4206,14760,18966
27,27077,2005-12-31,4452,15362,19814
27,27077,2006-12-31,4676,15985,20661
27,27077,2007-12-31,4887,16578,21465
27,27077,2008-12-31,5120,17216,22336
27,27077,2009-12-31,5319,17840,23159
27,27077,2010-12-31,5542,18444,23986
27,27077,2011-12-31,5727,19042,24769
27,27077,2012-12-31,5946,19619,25565
27,27077,2013-12-31,6134,20205,26339
27,27077,2014-12-31,6325,20771,27096
27,27077,2015-12-31,6564,21298,27862
27,27077,2016-12-31,6767,21836,28603
27,27077,2017-12-31,6923,22374,29297
27,27077,2018-12-31,7041,22916,29957
27,27077,2019-12-31,6997,23266,30263
27,27077,2020-12-31,6938,23534,30472
27,27077,2021-12-31,6811,23908,30719
27,27077,2022-12-31,6680,24279,30959
27,27077,2023-12-31,6545,24645,31190
27,27077,2024-12-31,6460,25003,31463
27,27077,2025-12-31,6411,25365,31776
27,27077,2026-12-31,6384,25745,32129
27,27077,2027-12-31,6360,26122,32482
27,27077,2028-12-31,6364,26472,32836
27,27077,2029-12-31,6382,26844,33226
27,27077,2030-12-31,6400,27219,33619
27,27077,2031-12-31,6412,27588,34000
27,27077,2032-12-31,6425,27953,34378
27,27077,2033-12-31,6442,28325,34767
27,27077,2034-12-31,6452,28705,35157
27,27077,2035-12-31,6460,29075,35535
27,27099,1985-12-31,407,5704,6111
27,27099,1986-12-31,442,5849,6291
27,27099,1987-12-31,447,5991,6438
27,27099,1988-12-31,479,6131,6610
27,27099,1989-12-31,516,6269,6785
27,27099,1990-12-31,505,6400,6905
27,27099,1991-12-31,531,6532,7063
27,27099,1992-12-31,564,6675,7239
27,27099,1993-12-31,574,6982,7556
27,27099,1994-12-31,623,6998,7621
27,27099,1995-12-31,618,7138,7756
27,27099,1996-12-31,638,7285,7923
27,27099,1997-12-31,631,7622,8253
27,27099,1998-12-31,715,7351,8066
27,27099,1999-12-31,736,7337,8073
27,27099,2000-12-31,802,7172,7974
27,27099,2001-12-31,846,6961,7807
27,27099,2002-12-31,874,7018,7892
27,27099,2003-12-31,894,7258,8152
27,27099,2004-12-31,911,7514,8425
27,27099,2005-12-31,936,7787,8723
27,27099,2006-12-31,961,8059,9020
27,27099,2007-12-31,979,8320,9299
27,27099,2008-12-31,984,8597,9581
27,27099,2009-12-31,1008,8837,9845
27,27099,2010-12-31,1016,9105,10121
27,27099,2011-12-31,1056,9351,10407
27,27099,2012-12-31,1061,9580,10641
27,27099,2013-12-31,1083,9816,10899
27,27099,2014-12-31,1092,10038,11130
27,27099,2015-12-31,1117,10249,11366
27,27099,2016-12-31,1134,10516,11650
27,27099,2017-12-31,1147,10702,11849
27,27099,2018-12-31,1158,10915,12073
27,27099,2019-12-31,1163,11049,12212
27,27099,2020-12-31,1165,11161,12326
27,27099,2021-12-31,1090,11338,12428
27,27099,2022-12-31,1011,11514,12525
27,27099,2023-12-31,931,11688,12619
27,27099,2024-12-31,897,11874,12771
27,27099,2025-12-31,880,12042,12922
27,27099,2026-12-31,878,12221,13099
27,27099,2027-12-31,889,12371,13260
27,27099,2028-12-31,901,12562,13463
27,27099,2029-12-31,899,12737,13636
27,27099,2030-12-31,896,12919,13815
27,27099,2031-12-31,893,13088,13981
27,27099,2032-12-31,896,13278,14174
27,27099,2033-12-31,901,13436,14337
27,27099,2034-12-31,912,13613,14525
27,27099,2035-12-31,902,13774,14676
27,27135,1985-12-31,0,0,0
27,27135,1986-12-31,0,0,0
27,27135,1987-12-31,0,0,0
27,27135,1988-12-31,0,0,0
27,27135,1989-12-31,0,0,0
27,27135,1990-12-31,0,0,0
27,27135,1991-12-31,0,0,0
27,27135,1992-12-31,0,0,0
27,27135,1993-12-31,0,0,0
27,27135,1994-12-31,0,0,0
27,27135,1995-12-31,0,0,0
27,27135,1996-12-31,0,0,0
27,27135,1997-12-31,1512,4001,5513
27,27135,1998-12-31,1703,3773,5476
27,27135,1999-12-31,1727,3643,5370
27,27135,2000-12-31,1858,3452,5310
27,27135,2001-12-31,2020,3244,5264
27,27135,2002-12-31,2128,3216,5344
27,27135,2003-12-31,2166,3223,5389
27,27135,2004-12-31,2216,3232,5448
27,27135,2005-12-31,2263,3247,5510
27,27135,2006-12-31,2321,3276,5597
27,27135,2007-12-31,2363,3287,5650
27,27135,2008-12-31,2408,3306,5714
27,27135,2009-12-31,2446,3322,5768
27,27135,2010-12-31,2498,3315,5813
27,27135,2011-12-31,2566,3317,5883
27,27135,2012-12-31,2600,3338,5938
27,27135,2013-12-31,2654,3331,5985
27,27135,2014-12-31,2711,3320,6031
27,27135,2015-12-31,2720,3355,6075
27,27135,2016-12-31,2742,3304,6046
27,27135,2017-12-31,2785,3304,6089
27,27135,2018-12-31,2844,3272,6116
27,27135,2019-12-31,2876,3334,6210
27,27135,2020-12-31,2911,3375,6286
27,27135,2021-12-31,2909,3429,6338
27,27135,2022-12-31,2906,3482,6388
27,27135,2023-12-31,2901,3534,6435
27,27135,2024-12-31,2892,3588,6480
27,27135,2025-12-31,2890,3655,6545
27,27135,2026-12-31,2887,3694,6581
27,27135,2027-12-31,2888,3744,6632
27,27135,2028-12-31,2893,3797,6690
27,27135,2029-12-31,2899,3849,6748
27,27135,2030-12-31,2912,3903,6815
27,27135,2031-12-31,2914,3963,6877
27,27135,2032-12-31,2921,4006,6927
27,27135,2033-12-31,2922,4050,6972
27,27135,2034-12-31,2932,4104,7036
27,27135,2035-12-31,2938,4154,7092
27,27150,1985-12-31,0,0,0
27,27150,1986-12-31,0,0,0
27,27150,1987-12-31,0,0,0
27,27150,1988-12-31,0,0,0
27,27150,1989-12-31,0,0,0
27,27150,1990-12-31,0,0,0
27,27150,1991-12-31,0,0,0
27,27150,1992-12-31,0,0,0
27,27150,1993-12-31,0,0,0
27,27150,1994-12-31,0,0,0
27,27150,1995-12-31,0,0,0
27,27150,1996-12-31,0,0,0
27,27150,1997-12-31,0,0,0
27,27150,1998-12-31,0,0,0
27,27150,1999-12-31,0,0,0
27,27150,2000-12-31,0,0,0
27,27150,2001-12-31,578,2235,2813
27,27150,2002-12-31,685,2890,3575
27,27150,2003-12-31,777,3627,4404
27,27150,2004-12-31,875,4384,5259
27,27150,2005-12-31,996,5157,6153
27,27150,2006-12-31,1118,5955,7073
27,27150,2007-12-31,1219,6780,7999
27,27150,2008-12-31,1320,7606,8926
27,27150,2009-12-31,1415,8436,9851
27,27150,2010-12-31,1515,9276,10791
27,27150,2011-12-31,1598,10128,11726
27,27150,2012-12-31,1708,11006,12714
27,27150,2013-12-31,1796,11865,13661
27,27150,2014-12-31,1918,12728,14646
27,27150,2015-12-31,2003,13582,15585
27,27150,2016-12-31,2079,14430,16509
27,27150,2017-12-31,2207,15317,17524
27,27150,2018-12-31,2276,16157,18433
27,27150,2019-12-31,2311,16619,18930
27,27150,2020-12-31,2354,17155,19509
27,27150,2021-12-31,2240,17431,19671
27,27150,2022-12-31,2124,17701,19825
27,27150,2023-12-31,2005,17968,19973
27,27150,2024-12-31,1958,18234,20192
27,27150,2025-12-31,1948,18510,20458
27,27150,2026-12-31,1951,18779,20730
27,27150,2027-12-31,1949,19059,21008
27,27150,2028-12-31,1960,19321,21281
27,27150,2029-12-31,1953,19593,21546
27,27150,2030-12-31,1959,19860,21819
27,27150,2031-12-31,1971,20149,22120
27,27150,2032-12-31,1971,20436,22407
27,27150,2033-12-31,1978,20716,22694
27,27150,2034-12-31,1969,20991,22960
27,27150,2035-12-31,1976,21267,23243
27,27160,1985-12-31,0,0,0
27,27160,1986-12-31,0,0,0
27,27160,1987-12-31,0,0,0
27,27160,1988-12-31,0,0,0
27,27160,1989-12-31,0,0,0
27,27160,1990-12-31,0,0,0
27,27160,1991-12-31,0,0,0
27,27160,1992-12-31,0,0,0
27,27160,1993-12-31,0,0,0
27,27160,1994-12-31,0,0,0
27,27160,1995-12-31,0,0,0
27,27160,1996-12-31,0,0,0
27,27160,1997-12-31,0,0,0
27,27160,1998-12-31,0,0,0
27,27160,1999-12-31,0,0,0
27,27160,2000-12-31,3381,4190,7571
27,27160,2001-12-31,3567,3891,7458
27,27160,2002-12-31,3666,3734,7400
27,27160,2003-12-31,3639,3654,7293
27,27160,2004-12-31,3631,3605,7236
27,27160,2005-12-31,3611,3536,7147
27,27160,2006-12-31,3609,3490,7099
27,27160,2007-12-31,3588,3401,6989
27,27160,2008-12-31,3567,3315,6882
27,27160,2009-12-31,3550,3249,6799
27,27160,2010-12-31,3538,3166,6704
27,27160,2011-12-31,3515,3080,6595
27,27160,2012-12-31,3496,2986,6482
27,27160,2013-12-31,3486,2890,6376
27,27160,2014-12-31,3470,2811,6281
27,27160,2015-12-31,3423,2698,6121
27,27160,2016-12-31,3396,2570,5966
27,27160,2017-12-31,3296,2433,5729
27,27160,2018-12-31,3321,2314,5635
27,27160,2019-12-31,3331,2374,5705
27,27160,2020-12-31,3334,2426,5760
27,27160,2021-12-31,3343,2465,5808
27,27160,2022-12-31,3350,2503,5853
27,27160,2023-12-31,3356,2541,5897
27,27160,2024-12-31,3355,2578,5933
27,27160,2025-12-31,3365,2615,5980
27,27160,2026-12-31,3366,2649,6015
27,27160,2027-12-31,3371,2690,6061
27,27160,2028-12-31,3385,2721,6106
27,27160,2029-12-31,3388,2762,6150
27,27160,2030-12-31,3397,2794,6191
27,27160,2031-12-31,3414,2834,6248
27,27160,2032-12-31,3424,2871,6295
27,27160,2033-12-31,3421,2914,6335
27,27160,2034-12-31,3444,2938,6382
27,27160,2035-12-31,3446,2979,6425
27,27205,1985-12-31,2590,10338,12928
27,27205,1986-12-31,2692,10497,13189
27,27205,1987-12-31,2812,10685,13497
27,27205,1988-12-31,2974,10858,13832
27,27205,1989-12-31,3126,11017,14143
27,27205,1990-12-31,3312,11188,14500
27,27205,1991-12-31,3505,11361,14866
27,27205,1992-12-31,3689,11546,15235
27,27205,1993-12-31,3883,12012,15895
27,27205,1994-12-31,4227,11995,16222
27,27205,1995-12-31,4418,12187,16605
27,27205,1996-12-31,4615,12384,16999
27,27205,1997-12-31,4672,12862,17534
27,27205,1998-12-31,5262,12339,17601
27,27205,1999-12-31,5423,12266,17689
27,27205,2000-12-31,5909,11939,17848
27,27205,2001-12-31,6453,2920,9373
27,27205,2002-12-31,6869,2870,9739
27,27205,2003-12-31,7048,2871,9919
27,27205,2004-12-31,7261,2924,10185
27,27205,2005-12-31,7466,2916,10382
27,27205,2006-12-31,7666,2942,10608
27,27205,2007-12-31,7873,2960,10833
27,27205,2008-12-31,8068,2988,11056
27,27205,2009-12-31,8269,2988,11257
27,27205,2010-12-31,8462,3008,11470
27,27205,2011-12-31,8647,2996,11643
27,27205,2012-12-31,8820,3010,11830
27,27205,2013-12-31,8976,3066,12042
27,27205,2014-12-31,9130,3052,12182
27,27205,2015-12-31,9329,3019,12348
27,27205,2016-12-31,9453,2994,12447
27,27205,2017-12-31,9594,2988,12582
27,27205,2018-12-31,9696,2967,12663
27,27205,2019-12-31,9656,2808,12464
27,27205,2020-12-31,9627,2740,12367
27,27205,2021-12-31,9683,2784,12467
27,27205,2022-12-31,9738,2827,12565
27,27205,2023-12-31,9789,2869,12658
27,27205,2024-12-31,9793,2916,12709
27,27205,2025-12-31,9778,2955,12733
27,27205,2026-12-31,9771,3002,12773
27,27205,2027-12-31,9771,3038,12809
27,27205,2028-12-31,9791,3085,12876
27,27205,2029-12-31,9810,3118,12928
27,27205,2030-12-31,9833,3168,13001
27,27205,2031-12-31,9852,3206,13058
27,27205,2032-12-31,9888,3241,13129
27,27205,2033-12-31,9914,3288,13202
27,27205,2034-12-31,9918,3333,13251
27,27205,2035-12-31,9938,3371,13309
27,27245,1985-12-31,1174,3831,5005
27,27245,1986-12-31,1180,3871,5051
27,27245,1987-12-31,1199,3908,5107
27,27245,1988-12-31,1227,3957,5184
27,27245,1989-12-31,1225,3991,5216
27,27245,1990-12-31,1264,4027,5291
27,27245,1991-12-31,1298,4068,5366
27,27245,1992-12-31,1363,4111,5474
27,27245,1993-12-31,1398,4246,5644
27,27245,1994-12-31,1472,4219,5691
27,27245,1995-12-31,1533,4256,5789
27,27245,1996-12-31,1554,4324,5878
27,27245,1997-12-31,1545,4475,6020
27,27245,1998-12-31,1721,4310,6031
27,27245,1999-12-31,1737,4266,6003
27,27245,2000-12-31,1840,4134,5974
27,27245,2001-12-31,1993,3996,5989
27,27245,2002-12-31,2095,4004,6099
27,27245,2003-12-31,2129,4113,6242
27,27245,2004-12-31,2163,4214,6377
27,27245,2005-12-31,2211,4334,6545
27,27245,2006-12-31,2237,4454,6691
27,27245,2007-12-31,2275,4569,6844
27,27245,2008-12-31,2293,4680,6973
27,27245,2009-12-31,2335,4784,7119
27,27245,2010-12-31,2353,4923,7276
27,27245,2011-12-31,2399,5020,7419
27,27245,2012-12-31,2433,5096,7529
27,27245,2013-12-31,2405,5214,7619
27,27245,2014-12-31,2435,5324,7759
27,27245,2015-12-31,2415,5418,7833
27,27245,2016-12-31,2453,5519,7972
27,27245,2017-12-31,2520,5586,8106
27,27245,2018-12-31,2510,5683,8193
27,27245,2019-12-31,2513,5684,8197
27,27245,2020-12-31,2512,5700,8212
27,27245,2021-12-31,2487,5791,8278
27,27245,2022-12-31,2463,5880,8343
27,27245,2023-12-31,2437,5969,8406
27,27245,2024-12-31,2426,6065,8491
27,27245,2025-12-31,2423,6142,8565
27,27245,2026-12-31,2423,6230,8653
27,27245,2027-12-31,2415,6321,8736
27,27245,2028-12-31,2417,6410,8827
27,27245,2029-12-31,2433,6488,8921
27,27245,2030-12-31,2435,6585,9020
27,27245,2031-12-31,2445,6678,9123
27,27245,2032-12-31,2446,6763,9209
27,27245,2033-12-31,2448,6853,9301
27,27245,2034-12-31,2451,6951,9402
27,27245,2035-12-31,2453,7034,9487
27,27250,1985-12-31,0,0,0
27,27250,1986-12-31,0,0,0
27,27250,1987-12-31,0,0,0
27,27250,1988-12-31,0,0,0
27,27250,1989-12-31,0,0,0
27,27250,1990-12-31,0,0,0
27,27250,1991-12-31,0,0,0
27,27250,1992-12-31,0,0,0
27,27250,1993-12-31,144,3493,3637
27,27250,1994-12-31,248,4037,4285
27,27250,1995-12-31,293,4707,5000
27,27250,1996-12-31,364,5374,5738
27,27250,1997-12-31,401,6178,6579
27,27250,1998-12-31,511,6467,6978
27,27250,1999-12-31,553,6914,7467
27,27250,2000-12-31,682,7234,7916
27,27250,2001-12-31,747,7476,8223
27,27250,2002-12-31,820,7936,8756
27,27250,2003-12-31,873,8623,9496
27,27250,2004-12-31,935,9316,10251
27,27250,2005-12-31,999,10047,11046
27,27250,2006-12-31,1074,10783,11857
27,27250,2007-12-31,1177,11536,12713
27,27250,2008-12-31,1233,12296,13529
27,27250,2009-12-31,1292,13046,14338
27,27250,2010-12-31,1361,13819,15180
27,27250,2011-12-31,1431,14600,16031
27,27250,2012-12-31,1486,15365,16851
27,27250,2013-12-31,1537,16114,17651
27,27250,2014-12-31,1600,16884,18484
27,27250,2015-12-31,1655,17615,19270
27,27250,2016-12-31,1739,18341,20080
27,27250,2017-12-31,1795,19104,20899
27,27250,2018-12-31,1843,19826,21669
27,27250,2019-12-31,1868,20374,22242
27,27250,2020-12-31,1896,20994,22890
27,27250,2021-12-31,1748,21332,23080
27,27250,2022-12-31,1597,21663,23260
27,27250,2023-12-31,1445,21989,23434
27,27250,2024-12-31,1395,22300,23695
27,27250,2025-12-31,1382,22630,24012
27,27250,2026-12-31,1378,22968,24346
27,27250,2027-12-31,1373,23301,24674
27,27250,2028-12-31,1377,23632,25009
27,27250,2029-12-31,1379,23965,25344
27,27250,2030-12-31,1375,24300,25675
27,27250,2031-12-31,1381,24641,26022
27,27250,2032-12-31,1388,24973,26361
27,27250,2033-12-31,1394,25307,26701
27,27250,2034-12-31,1400,25651,27051
27,27250,2035-12-31,1393,25970,27363
27,27361,1985-12-31,1622,23394,25016
27,27361,1986-12-31,2071,23748,25819
27,27361,1987-12-31,2510,24072,26582
27,27361,1988-12-31,2982,24392,27374
27,27361,1989-12-31,3457,24707,28164
27,27361,1990-12-31,3959,25022,28981
27,27361,1991-12-31,4495,25333,29828
27,27361,1992-12-31,5041,25617,30658
27,27361,1993-12-31,5564,17469,23033
27,27361,1994-12-31,6369,17090,23459
27,27361,1995-12-31,6942,16983,23925
27,27361,1996-12-31,7495,16932,24427
27,27361,1997-12-31,7833,12155,19988
27,27361,1998-12-31,9081,17534,26615
27,27361,1999-12-31,9582,23059,32641
27,27361,2000-12-31,10722,22742,33464
27,27361,2001-12-31,11952,21081,33033
27,27361,2002-12-31,12969,20013,32982
27,27361,2003-12-31,13597,19479,33076
27,27361,2004-12-31,14224,18918,33142
27,27361,2005-12-31,14879,18332,33211
27,27361,2006-12-31,15518,17756,33274
27,27361,2007-12-31,16164,17133,33297
27,27361,2008-12-31,16779,16477,33256
27,27361,2009-12-31,17400,15800,33200
27,27361,2010-12-31,18002,15091,33093
27,27361,2011-12-31,18592,14335,32927
27,27361,2012-12-31,19159,13564,32723
27,27361,2013-12-31,19742,12767,32509
27,27361,2014-12-31,20282,11953,32235
27,27361,2015-12-31,20814,11087,31901
27,27361,2016-12-31,21321,10256,31577
27,27361,2017-12-31,21819,9396,31215
27,27361,2018-12-31,22258,8484,30742
27,27361,2019-12-31,22361,8378,30739
27,27361,2020-12-31,22414,8392,30806
27,27361,2021-12-31,22530,8525,31055
27,27361,2022-12-31,22641,8657,31298
27,27361,2023-12-31,22744,8788,31532
27,27361,2024-12-31,22848,8927,31775
27,27361,2025-12-31,22942,9047,31989
27,27361,2026-12-31,23004,9172,32176
27,27361,2027-12-31,23079,9314,32393
27,27361,2028-12-31,23158,9444,32602
27,27361,2029-12-31,23205,9596,32801
27,27361,2030-12-31,23312,9708,33020
27,27361,2031-12-31,23401,9840,33241
27,27361,2032-12-31,23466,9972,33438
27,27361,2033-12-31,23528,10099,33627
27,27361,2034-12-31,23565,10221,33786
27,27361,2035-12-31,23579,10370,33949
27,27372,1985-12-31,677,1058,1735
27,27372,1986-12-31,706,1151,1857
27,27372,1987-12-31,733,1255,1988
27,27372,1988-12-31,775,1359,2134
27,27372,1989-12-31,818,1453,2271
27,27372,1990-12-31,862,1541,2403
27,27372,1991-12-31,920,1628,2548
27,27372,1992-12-31,960,1711,2671
27,27372,1993-12-31,1020,1830,2850
27,27372,1994-12-31,1102,1898,3000
27,27372,1995-12-31,1144,1996,3140
27,27372,1996-12-31,1243,2074,3317
27,27372,1997-12-31,1223,2197,3420
27,27372,1998-12-31,1391,2212,3603
27,27372,1999-12-31,1418,2239,3657
27,27372,2000-12-31,1554,2240,3794
27,27372,2001-12-31,1670,2230,3900
27,27372,2002-12-31,1763,2283,4046
27,27372,2003-12-31,1815,2384,4199
27,27372,2004-12-31,1845,2500,4345
27,27372,2005-12-31,1938,2613,4551
27,27372,2006-12-31,2006,2759,4765
27,27372,2007-12-31,2041,2855,4896
27,27372,2008-12-31,2084,3001,5085
27,27372,2009-12-31,2135,3111,5246
27,27372,2010-12-31,2178,3227,5405
27,27372,2011-12-31,2230,3365,5595
27,27372,2012-12-31,2267,3486,5753
27,27372,2013-12-31,2316,3622,5938
27,27372,2014-12-31,2338,3725,6063
27,27372,2015-12-31,2376,3843,6219
27,27372,2016-12-31,2400,3982,6382
27,27372,2017-12-31,2452,4084,6536
27,27372,2018-12-31,2511,4174,6685
27,27372,2019-12-31,2495,4279,6774
27,27372,2020-12-31,2473,4368,6841
27,27372,2021-12-31,2460,4438,6898
27,27372,2022-12-31,2445,4507,6952
27,27372,2023-12-31,2429,4575,7004
27,27372,2024-12-31,2406,4640,7046
27,27372,2025-12-31,2398,4701,7099
27,27372,2026-12-31,2389,4773,7162
27,27372,2027-12-31,2399,4830,7229
27,27372,2028-12-31,2392,4912,7304
27,27372,2029-12-31,2396,4968,7364
27,27372,2030-12-31,2399,5063,7462
27,27372,2031-12-31,2410,5117,7527
27,27372,2032-12-31,2409,5187,7596
27,27372,2033-12-31,2411,5272,7683
27,27372,2034-12-31,2400,5336,7736
27,27372,2035-12-31,2407,5401,7808
27,27413,1985-12-31,715,5190,5905
27,27413,1986-12-31,759,5519,6278
27,27413,1987-12-31,813,5848,6661
27,27413,1988-12-31,856,6165,7021
27,27413,1989-12-31,912,6453,7365
27,27413,1990-12-31,987,6764,7751
27,27413,1991-12-31,1056,7064,8120
27,27413,1992-12-31,1122,7358,8480
27,27413,1993-12-31,1201,7876,9077
27,27413,1994-12-31,1345,8057,9402
27,27413,1995-12-31,1411,8373,9784
27,27413,1996-12-31,1483,8695,10178
27,27413,1997-12-31,1503,9201,10704
27,27413,1998-12-31,1719,9011,10730
27,27413,1999-12-31,1758,9112,10870
27,27413,2000-12-31,1959,7246,9205
27,27413,2001-12-31,2124,6817,8941
27,27413,2002-12-31,2270,6687,8957
27,27413,2003-12-31,2326,6676,9002
27,27413,2004-12-31,2417,6705,9122
27,27413,2005-12-31,2500,6705,9205
27,27413,2006-12-31,2573,6728,9301
27,27413,2007-12-31,2647,6756,9403
27,27413,2008-12-31,2739,6735,9474
27,27413,2009-12-31,2800,6744,9544
27,27413,2010-12-31,2869,6721,9590
27,27413,2011-12-31,2939,6730,9669
27,27413,2012-12-31,3007,6700,9707
27,27413,2013-12-31,3076,6651,9727
27,27413,2014-12-31,3156,6614,9770
27,27413,2015-12-31,3227,6596,9823
27,27413,2016-12-31,3294,6541,9835
27,27413,2017-12-31,3311,6471,9782
27,27413,2018-12-31,3376,6410,9786
27,27413,2019-12-31,3390,6460,9850
27,27413,2020-12-31,3397,6516,9913
27,27413,2021-12-31,3373,6620,9993
27,27413,2022-12-31,3349,6722,10071
27,27413,2023-12-31,3323,6824,10147
27,27413,2024-12-31,3311,6927,10238
27,27413,2025-12-31,3317,7026,10343
27,27413,2026-12-31,3308,7120,10428
27,27413,2027-12-31,3313,7220,10533
27,27413,2028-12-31,3313,7320,10633
27,27413,2029-12-31,3317,7424,10741
27,27413,2030-12-31,3324,7516,10840
27,27413,2031-12-31,3342,7606,10948
27,27413,2032-12-31,3358,7708,11066
27,27413,2033-12-31,3359,7789,11148
27,27413,2034-12-31,3361,7875,11236
27,27413,2035-12-31,3372,7976,11348
27,27425,1985-12-31,0,0,0
27,27425,1986-12-31,0,0,0
27,27425,1987-12-31,0,0,0
27,27425,1988-12-31,0,0,0
27,27425,1989-12-31,0,0,0
27,27425,1990-12-31,0,0,0
27,27425,1991-12-31,0,0,0
27,27425,1992-12-31,0,0,0
27,27425,1993-12-31,0,0,0
27,27425,1994-12-31,0,0,0
27,27425,1995-12-31,0,0,0
27,27425,1996-12-31,0,0,0
27,27425,1997-12-31,0,0,0
27,27425,1998-12-31,0,0,0
27,27425,1999-12-31,23,1343,1366
27,27425,2000-12-31,80,1673,1753
27,27425,2001-12-31,125,1977,2102
27,27425,2002-12-31,177,2348,2525
27,27425,2003-12-31,188,2749,2937
27,27425,2004-12-31,248,3171,3419
27,27425,2005-12-31,290,3604,3894
27,27425,2006-12-31,381,4056,4437
27,27425,2007-12-31,425,4490,4915
27,27425,2008-12-31,466,4975,5441
27,27425,2009-12-31,515,5420,5935
27,27425,2010-12-31,570,5893,6463
27,27425,2011-12-31,608,6380,6988
27,27425,2012-12-31,651,6879,7530
27,27425,2013-12-31,715,7358,8073
27,27425,2014-12-31,770,7837,8607
27,27425,2015-12-31,803,8285,9088
27,27425,2016-12-31,867,8784,9651
27,27425,2017-12-31,921,9293,10214
27,27425,2018-12-31,944,9728,10672
27,27425,2019-12-31,960,9857,10817
27,27425,2020-12-31,980,9950,10930
27,27425,2021-12-31,913,10108,11021
27,27425,2022-12-31,842,10265,11107
27,27425,2023-12-31,770,10420,11190
27,27425,2024-12-31,744,10570,11314
27,27425,2025-12-31,743,10729,11472
27,27425,2026-12-31,735,10878,11613
27,27425,2027-12-31,739,11036,11775
27,27425,2028-12-31,741,11207,11948
27,27425,2029-12-31,744,11357,12101
27,27425,2030-12-31,744,11507,12251
27,27425,2031-12-31,742,11677,12419
27,27425,2032-12-31,742,11834,12576
27,27425,2033-12-31,742,11985,12727
27,27425,2034-12-31,745,12139,12884
27,27425,2035-12-31,743,12289,13032
27,27430,1985-12-31,0,0,0
27,27430,1986-12-31,0,0,0
27,27430,1987-12-31,0,0,0
27,27430,1988-12-31,0,0,0
27,27430,1989-12-31,0,0,0
27,27430,1990-12-31,0,0,0
27,27430,1991-12-31,0,0,0
27,27430,1992-12-31,0,0,0
27,27430,1993-12-31,0,0,0
27,27430,1994-12-31,0,0,0
27,27430,1995-12-31,0,0,0
27,27430,1996-12-31,0,0,0
27,27430,1997-12-31,0,0,0
27,27430,1998-12-31,0,0,0
27,27430,1999-12-31,375,10780,11155
27,27430,2000-12-31,492,10364,10856
27,27430,2001-12-31,616,9954,10570
27,27430,2002-12-31,706,9890,10596
27,27430,2003-12-31,820,10085,10905
27,27430,2004-12-31,878,10295,11173
27,27430,2005-12-31,1008,10522,11530
27,27430,2006-12-31,1139,10742,11881
27,27430,2007-12-31,1229,10960,12189
27,27430,2008-12-31,1334,11162,12496
27,27430,2009-12-31,1425,11364,12789
27,27430,2010-12-31,1528,11576,13104
27,27430,2011-12-31,1680,11743,13423
27,27430,2012-12-31,1755,11931,13686
27,27430,2013-12-31,1852,12101,13953
27,27430,2014-12-31,1948,12260,14208
27,27430,2015-12-31,2024,12363,14387
27,27430,2016-12-31,2117,12499,14616
27,27430,2017-12-31,2237,12679,14916
27,27430,2018-12-31,2307,12802,15109
27,27430,2019-12-31,2326,13079,15405
27,27430,2020-12-31,2349,13334,15683
27,27430,2021-12-31,2264,13549,15813
27,27430,2022-12-31,2178,13759,15937
27,27430,2023-12-31,2090,13966,16056
27,27430,2024-12-31,2056,14178,16234
27,27430,2025-12-31,2051,14384,16435
27,27430,2026-12-31,2059,14590,16649
27,27430,2027-12-31,2047,14786,16833
27,27430,2028-12-31,2049,14994,17043
27,27430,2029-12-31,2048,15200,17248
27,27430,2030-12-31,2062,15417,17479
27,27430,2031-12-31,2062,15633,17695
27,27430,2032-12-31,2069,15820,17889
27,27430,2033-12-31,2076,16039,18115
27,27430,2034-12-31,2083,16246,18329
27,27430,2035-12-31,2076,16421,18497
27,27450,1985-12-31,0,0,0
27,27450,1986-12-31,0,0,0
27,27450,1987-12-31,0,0,0
27,27450,1988-12-31,0,0,0
27,27450,1989-12-31,0,0,0
27,27450,1990-12-31,0,0,0
27,27450,1991-12-31,0,0,0
27,27450,1992-12-31,0,0,0
27,27450,1993-12-31,0,0,0
27,27450,1994-12-31,0,0,0
27,27450,1995-12-31,0,0,0
27,27450,1996-12-31,0,0,0
27,27450,1997-12-31,0,0,0
27,27450,1998-12-31,0,0,0
27,27450,1999-12-31,0,0,0
27,27450,2000-12-31,0,0,0
27,27450,2001-12-31,2587,5945,8532
27,27450,2002-12-31,2679,5947,8626
27,27450,2003-12-31,2712,6070,8782
27,27450,2004-12-31,2727,6207,8934
27,27450,2005-12-31,2735,6345,9080
27,27450,2006-12-31,2727,6485,9212
27,27450,2007-12-31,2732,6633,9365
27,27450,2008-12-31,2731,6769,9500
27,27450,2009-12-31,2776,6922,9698
27,27450,2010-12-31,2744,7051,9795
27,27450,2011-12-31,2715,7204,9919
27,27450,2012-12-31,2703,7298,10001
27,27450,2013-12-31,2670,7452,10122
27,27450,2014-12-31,2638,7554,10192
27,27450,2015-12-31,2593,7679,10272
27,27450,2016-12-31,2598,7792,10390
27,27450,2017-12-31,2614,7886,10500
27,27450,2018-12-31,2622,7957,10579
27,27450,2019-12-31,2658,8060,10718
27,27450,2020-12-31,2705,8121,10826
27,27450,2021-12-31,2666,8250,10916
27,27450,2022-12-31,2623,8378,11001
27,27450,2023-12-31,2579,8504,11083
27,27450,2024-12-31,2571,8645,11216
27,27450,2025-12-31,2576,8771,11347
27,27450,2026-12-31,2573,8889,11462
27,27450,2027-12-31,2577,9021,11598
27,27450,2028-12-31,2572,9151,11723
27,27450,2029-12-31,2580,9267,11847
27,27450,2030-12-31,2586,9386,11972
27,27450,2031-12-31,2599,9494,12093
27,27450,2032-12-31,2595,9646,12241
27,27450,2033-12-31,2614,9749,12363
27,27450,2034-12-31,2604,9856,12460
27,27450,2035-12-31,2614,9979,12593
27,27491,1985-12-31,686,7267,7953
27,27491,1986-12-31,717,7171,7888
27,27491,1987-12-31,791,7059,7850
27,27491,1988-12-31,864,6960,7824
27,27491,1989-12-31,924,6865,7789
27,27491,1990-12-31,998,6770,7768
27,27491,1991-12-31,1058,6664,7722
27,27491,1992-12-31,1144,6578,7722
27,27491,1993-12-31,1230,6672,7902
27,27491,1994-12-31,1338,6474,7812
27,27491,1995-12-31,1415,6406,7821
27,27491,1996-12-31,1485,6331,7816
27,27491,1997-12-31,1537,6426,7963
27,27491,1998-12-31,1734,6000,7734
27,27491,1999-12-31,1794,5826,7620
27,27491,2000-12-31,1970,5517,7487
27,27491,2001-12-31,2178,4811,6989
27,27491,2002-12-31,2277,4785,7062
27,27491,2003-12-31,2407,4816,7223
27,27491,2004-12-31,2492,4889,7381
27,27491,2005-12-31,2550,4968,7518
27,27491,2006-12-31,2640,5033,7673
27,27491,2007-12-31,2719,5132,7851
27,27491,2008-12-31,2812,5194,8006
27,27491,2009-12-31,2873,5245,8118
27,27491,2010-12-31,2944,5306,8250
27,27491,2011-12-31,3054,5379,8433
27,27491,2012-12-31,3096,5411,8507
27,27491,2013-12-31,3184,5460,8644
27,27491,2014-12-31,3234,5482,8716
27,27491,2015-12-31,3326,5568,8894
27,27491,2016-12-31,3393,5627,9020
27,27491,2017-12-31,3421,5632,9053
27,27491,2018-12-31,3498,5655,9153
27,27491,2019-12-31,3513,5603,9116
27,27491,2020-12-31,3520,5585,9105
27,27491,2021-12-31,3505,5674,9179
27,27491,2022-12-31,3488,5762,9250
27,27491,2023-12-31,3471,5849,9320
27,27491,2024-12-31,3473,5935,9408
27,27491,2025-12-31,3464,6013,9477
27,27491,2026-12-31,3456,6110,9566
27,27491,2027-12-31,3456,6199,9655
27,27491,2028-12-31,3463,6285,9748
27,27491,2029-12-31,3463,6387,9850
27,27491,2030-12-31,3476,6457,9933
27,27491,2031-12-31,3491,6557,10048
27,27491,2032-12-31,3503,6635,10138
27,27491,2033-12-31,3496,6746,10242
27,27491,2034-12-31,3502,6820,10322
27,27491,2035-12-31,3508,6907,10415
27,27495,1985-12-31,1015,2641,3656
27,27495,1986-12-31,978,2988,3966
27,27495,1987-12-31,1000,3359,4359
27,27495,1988-12-31,1023,3723,4746
27,27495,1989-12-31,1029,4078,5107
27,27495,1990-12-31,1059,4436,5495
27,27495,1991-12-31,1049,4789,5838
27,27495,1992-12-31,1084,5157,6241
27,27495,1993-12-31,1127,5656,6783
27,27495,1994-12-31,1197,5885,7082
27,27495,1995-12-31,1189,6242,7431
27,27495,1996-12-31,1198,6604,7802
27,27495,1997-12-31,1187,7098,8285
27,27495,1998-12-31,1282,7060,8342
27,27495,1999-12-31,1304,7208,8512
27,27495,2000-12-31,1393,7256,8649
27,27495,2001-12-31,1494,7223,8717
27,27495,2002-12-31,1539,7444,8983
27,27495,2003-12-31,1556,7863,9419
27,27495,2004-12-31,1572,8291,9863
27,27495,2005-12-31,1567,8729,10296
27,27495,2006-12-31,1590,9192,10782
27,27495,2007-12-31,1618,9642,11260
27,27495,2008-12-31,1627,10097,11724
27,27495,2009-12-31,1625,10553,12178
27,27495,2010-12-31,1628,11025,12653
27,27495,2011-12-31,1624,11479,13103
27,27495,2012-12-31,1616,11932,13548
27,27495,2013-12-31,1622,12395,14017
27,27495,2014-12-31,1623,12838,14461
27,27495,2015-12-31,1637,13234,14871
27,27495,2016-12-31,1645,13649,15294
27,27495,2017-12-31,1665,14151,15816
27,27495,2018-12-31,1685,14538,16223
27,27495,2019-12-31,1630,14829,16459
27,27495,2020-12-31,1596,15046,16642
27,27495,2021-12-31,1484,15296,16780
27,27495,2022-12-31,1367,15544,16911
27,27495,2023-12-31,1253,15785,17038
27,27495,2024-12-31,1161,16036,17197
27,27495,2025-12-31,1117,16304,17421
27,27495,2026-12-31,1088,16570,17658
27,27495,2027-12-31,1081,16829,17910
27,27495,2028-12-31,1069,17102,18171
27,27495,2029-12-31,1083,17361,18444
27,27495,2030-12-31,1086,17664,18750
27,27495,2031-12-31,1084,17929,19013
27,27495,2032-12-31,1090,18213,19303
27,27495,2033-12-31,1090,18477,19567
27,27495,2034-12-31,1092,18766,19858
27,27495,2035-12-31,1088,19022,20110
27,27580,1985-12-31,0,0,0
27,27580,1986-12-31,0,0,0
27,27580,1987-12-31,0,0,0
27,27580,1988-12-31,0,0,0
27,27580,1989-12-31,0,0,0
27,27580,1990-12-31,0,0,0
27,27580,1991-12-31,0,0,0
27,27580,1992-12-31,0,0,0
27,27580,1993-12-31,0,0,0
27,27580,1994-12-31,0,0,0
27,27580,1995-12-31,0,0,0
27,27580,1996-12-31,0,0,0
27,27580,1997-12-31,0,0,0
27,27580,1998-12-31,0,0,0
27,27580,1999-12-31,0,0,0
27,27580,2000-12-31,0,0,0
27,27580,2001-12-31,1452,7644,9096
27,27580,2002-12-31,1465,7309,8774
27,27580,2003-12-31,1489,7168,8657
27,27580,2004-12-31,1491,6992,8483
27,27580,2005-12-31,1487,6818,8305
27,27580,2006-12-31,1502,6655,8157
27,27580,2007-12-31,1510,6480,7990
27,27580,2008-12-31,1529,6293,7822
27,27580,2009-12-31,1521,6093,7614
27,27580,2010-12-31,1520,5892,7412
27,27580,2011-12-31,1544,5676,7220
27,27580,2012-12-31,1527,5427,6954
27,27580,2013-12-31,1506,5183,6689
27,27580,2014-12-31,1498,5013,6511
27,27580,2015-12-31,1502,4753,6255
27,27580,2016-12-31,1516,4490,6006
27,27580,2017-12-31,1511,4197,5708
27,27580,2018-12-31,1539,3928,5467
27,27580,2019-12-31,1557,3980,5537
27,27580,2020-12-31,1577,4015,5592
27,27580,2021-12-31,1559,4079,5638
27,27580,2022-12-31,1540,4142,5682
27,27580,2023-12-31,1521,4204,5725
27,27580,2024-12-31,1519,4254,5773
27,27580,2025-12-31,1511,4323,5834
27,27580,2026-12-31,1510,4380,5890
27,27580,2027-12-31,1509,4450,5959
27,27580,2028-12-31,1513,4508,6021
27,27580,2029-12-31,1513,4577,6090
27,27580,2030-12-31,1525,4638,6163
27,27580,2031-12-31,1531,4691,6222
27,27580,2032-12-31,1525,4747,6272
27,27580,2033-12-31,1525,4814,6339
27,27580,2034-12-31,1527,4862,6389
27,27580,2035-12-31,1534,4920,6454
27,27600,1985-12-31,0,0,0
27,27600,1986-12-31,0,0,0
27,27600,1987-12-31,0,0,0
27,27600,1988-12-31,0,0,0
27,27600,1989-12-31,0,0,0
27,27600,1990-12-31,0,0,0
27,27600,1991-12-31,0,0,0
27,27600,1992-12-31,0,0,0
27,27600,1993-12-31,0,0,0
27,27600,1994-12-31,0,0,0
27,27600,1995-12-31,0,0,0
27,27600,1996-12-31,0,0,0
27,27600,1997-12-31,0,0,0
27,27600,1998-12-31,0,0,0
27,27600,1999-12-31,220,724,944
27,27600,2000-12-31,355,922,1277
27,27600,2001-12-31,456,1135,1591
27,27600,2002-12-31,536,1313,1849
27,27600,2003-12-31,662,1572,2234
27,27600,2004-12-31,794,1833,2627
27,27600,2005-12-31,910,2145,3055
27,27600,2006-12-31,1021,2384,3405
27,27600,2007-12-31,1145,2680,3825
27,27600,2008-12-31,1256,2959,4215
27,27600,2009-12-31,1358,3244,4602
27,27600,2010-12-31,1473,3521,4994
27,27600,2011-12-31,1613,3856,5469
27,27600,2012-12-31,1694,4149,5843
27,27600,2013-12-31,1802,4455,6257
27,27600,2014-12-31,1900,4753,6653
27,27600,2015-12-31,2003,5045,7048
27,27600,2016-12-31,2106,5337,7443
27,27600,2017-12-31,2228,5641,7869
27,27600,2018-12-31,2335,5901,8236
27,27600,2019-12-31,2337,6018,8355
27,27600,2020-12-31,2336,6112,8448
27,27600,2021-12-31,2303,6215,8518
27,27600,2022-12-31,2272,6313,8585
27,27600,2023-12-31,2241,6408,8649
27,27600,2024-12-31,2229,6511,8740
27,27600,2025-12-31,2224,6599,8823
27,27600,2026-12-31,2234,6687,8921
27,27600,2027-12-31,2224,6795,9019
27,27600,2028-12-31,2227,6886,9113
27,27600,2029-12-31,2239,6989,9228
27,27600,2030-12-31,2231,7085,9316
27,27600,2031-12-31,2235,7177,9412
27,27600,2032-12-31,2245,7273,9518
27,27600,2033-12-31,2248,7364,9612
27,27600,2034-12-31,2243,7482,9725
27,27600,2035-12-31,2254,7583,9837
27,27615,1985-12-31,2089,19177,21266
27,27615,1986-12-31,2338,19078,21416
27,27615,1987-12-31,2582,18982,21564
27,27615,1988-12-31,2847,18882,21729
27,27615,1989-12-31,3128,18779,21907
27,27615,1990-12-31,3419,18688,22107
27,27615,1991-12-31,3734,18578,22312
27,27615,1992-12-31,4059,18493,22552
27,27615,1993-12-31,4381,18900,23281
27,27615,1994-12-31,4901,18519,23420
27,27615,1995-12-31,5228,18475,23703
27,27615,1996-12-31,5547,18460,24007
27,27615,1997-12-31,5733,18823,24556
27,27615,1998-12-31,6541,17765,24306
27,27615,1999-12-31,6825,17399,24224
27,27615,2000-12-31,7585,16630,24215
27,27615,2001-12-31,8395,12232,20627
27,27615,2002-12-31,9004,13341,22345
27,27615,2003-12-31,9370,14787,24157
27,27615,2004-12-31,9739,16277,26016
27,27615,2005-12-31,10102,17864,27966
27,27615,2006-12-31,10479,19460,29939
27,27615,2007-12-31,10840,21079,31919
27,27615,2008-12-31,11207,22717,33924
27,27615,2009-12-31,11575,24362,35937
27,27615,2010-12-31,11920,26012,37932
27,27615,2011-12-31,12244,27673,39917
27,27615,2012-12-31,12567,29334,41901
27,27615,2013-12-31,12882,30984,43866
27,27615,2014-12-31,13206,32640,45846
27,27615,2015-12-31,13499,34287,47786
27,27615,2016-12-31,13801,35909,49710
27,27615,2017-12-31,14064,37500,51564
27,27615,2018-12-31,14299,39150,53449
27,27615,2019-12-31,14806,39652,54458
27,27615,2020-12-31,15173,40059,55232
27,27615,2021-12-31,14994,40696,55690
27,27615,2022-12-31,14800,41326,56126
27,27615,2023-12-31,14595,41950,56545
27,27615,2024-12-31,14574,42564,57138
27,27615,2025-12-31,14558,43210,57768
27,27615,2026-12-31,14553,43826,58379
27,27615,2027-12-31,14547,44466,59013
27,27615,2028-12-31,14550,45109,59659
27,27615,2029-12-31,14574,45756,60330
27,27615,2030-12-31,14630,46410,61040
27,27615,2031-12-31,14669,47091,61760
27,27615,2032-12-31,14690,47739,62429
27,27615,2033-12-31,14742,48412,63154
27,27615,2034-12-31,14767,49071,63838
27,27615,2035-12-31,14787,49726,64513
27,27660,1985-12-31,689,5291,5980
27,27660,1986-12-31,670,5214,5884
27,27660,1987-12-31,684,5149,5833
27,27660,1988-12-31,688,5071,5759
27,27660,1989-12-31,705,4975,5680
27,27660,1990-12-31,718,4916,5634
27,27660,1991-12-31,764,4859,5623
27,27660,1992-12-31,769,4793,5562
27,27660,1993-12-31,799,4860,5659
27,27660,1994-12-31,850,4703,5553
27,27660,1995-12-31,859,4645,5504
27,27660,1996-12-31,882,4596,5478
27,27660,1997-12-31,871,4646,5517
27,27660,1998-12-31,943,4355,5298
27,27660,1999-12-31,965,4225,5190
27,27660,2000-12-31,1021,3994,5015
27,27660,2001-12-31,1098,3793,4891
27,27660,2002-12-31,1144,3721,4865
27,27660,2003-12-31,1152,3741,4893
27,27660,2004-12-31,1162,3760,4922
27,27660,2005-12-31,1191,3767,4958
27,27660,2006-12-31,1198,3784,4982
27,27660,2007-12-31,1195,3809,5004
27,27660,2008-12-31,1225,3816,5041
27,27660,2009-12-31,1230,3837,5067
27,27660,2010-12-31,1243,3859,5102
27,27660,2011-12-31,1243,3821,5064
27,27660,2012-12-31,1268,3839,5107
27,27660,2013-12-31,1273,3841,5114
27,27660,2014-12-31,1276,3825,5101
27,27660,2015-12-31,1274,3841,5115
27,27660,2016-12-31,1302,3837,5139
27,27660,2017-12-31,1338,3771,5109
27,27660,2018-12-31,1355,3759,5114
27,27660,2019-12-31,1273,3742,5015
27,27660,2020-12-31,1221,3740,4961
27,27660,2021-12-31,1202,3799,5001
27,27660,2022-12-31,1182,3858,5040
27,27660,2023-12-31,1161,3917,5078
27,27660,2024-12-31,1139,3971,5110
27,27660,2025-12-31,1130,4037,5167
27,27660,2026-12-31,1134,4083,5217
27,27660,2027-12-31,1125,4142,5267
27,27660,2028-12-31,1131,4217,5348
27,27660,2029-12-31,1126,4277,5403
27,27660,2030-12-31,1130,4332,5462
27,27660,2031-12-31,1131,4387,5518
27,27660,2032-12-31,1133,4447,5580
27,27660,2033-12-31,1140,4506,5646
27,27660,2034-12-31,1150,4558,5708
27,27660,2035-12-31,1160,4624,5784
27,27745,1985-12-31,110,1978,2088
27,27745,1986-12-31,124,1987,2111
27,27745,1987-12-31,116,1997,2113
27,27745,1988-12-31,109,1999,2108
27,27745,1989-12-31,118,2012,2130
27,27745,1990-12-31,143,2012,2155
27,27745,1991-12-31,258,2018,2276
27,27745,1992-12-31,257,2026,2283
27,27745,1993-12-31,268,2089,2357
27,27745,1994-12-31,294,2045,2339
27,27745,1995-12-31,322,2049,2371
27,27745,1996-12-31,333,2075,2408
27,27745,1997-12-31,341,2117,2458
27,27745,1998-12-31,379,2047,2426
27,27745,1999-12-31,397,2003,2400
27,27745,2000-12-31,417,1934,2351
27,27745,2001-12-31,367,1878,2245
27,27745,2002-12-31,388,1852,2240
27,27745,2003-12-31,475,1873,2348
27,27745,2004-12-31,485,1943,2428
27,27745,2005-12-31,499,1975,2474
27,27745,2006-12-31,480,2017,2497
27,27745,2007-12-31,510,2083,2593
27,27745,2008-12-31,551,2105,2656
27,27745,2009-12-31,572,2144,2716
27,27745,2010-12-31,558,2180,2738
27,27745,2011-12-31,576,2244,2820
27,27745,2012-12-31,612,2269,2881
27,27745,2013-12-31,629,2315,2944
27,27745,2014-12-31,653,2356,3009
27,27745,2015-12-31,678,2387,3065
27,27745,2016-12-31,696,2398,3094
27,27745,2017-12-31,714,2444,3158
27,27745,2018-12-31,742,2432,3174
27,27745,2019-12-31,745,2457,3202
27,27745,2020-12-31,747,2473,3220
27,27745,2021-12-31,734,2512,3246
27,27745,2022-12-31,720,2551,3271
27,27745,2023-12-31,706,2590,3296
27,27745,2024-12-31,685,2626,3311
27,27745,2025-12-31,682,2658,3340
27,27745,2026-12-31,682,2695,3377
27,27745,2027-12-31,682,2736,3418
27,27745,2028-12-31,685,2783,3468
27,27745,2029-12-31,689,2824,3513
27,27745,2030-12-31,688,2860,3548
27,27745,2031-12-31,690,2911,3601
27,27745,2032-12-31,690,2949,3639
27,27745,2033-12-31,694,2981,3675
27,27745,2034-12-31,696,3015,3711
27,27745,2035-12-31,689,3052,3741
27,27787,1985-12-31,2773,11969,14742
27,27787,1986-12-31,2887,12104,14991
27,27787,1987-12-31,3045,12251,15296
27,27787,1988-12-31,3214,12385,15599
27,27787,1989-12-31,3398,12521,15919
27,27787,1990-12-31,3583,12651,16234
27,27787,1991-12-31,3792,12777,16569
27,27787,1992-12-31,4014,12899,16913
27,27787,1993-12-31,4226,13390,17616
27,27787,1994-12-31,4625,13332,17957
27,27787,1995-12-31,4843,13469,18312
27,27787,1996-12-31,5046,13644,18690
27,27787,1997-12-31,5124,14101,19225
27,27787,1998-12-31,5750,13512,19262
27,27787,1999-12-31,5946,13386,19332
27,27787,2000-12-31,6500,7896,14396
27,27787,2001-12-31,7103,5491,12594
27,27787,2002-12-31,7552,5461,13013
27,27787,2003-12-31,7771,5590,13361
27,27787,2004-12-31,8006,5717,13723
27,27787,2005-12-31,8241,5840,14081
27,27787,2006-12-31,8464,5983,14447
27,27787,2007-12-31,8690,6108,14798
27,27787,2008-12-31,8920,6261,15181
27,27787,2009-12-31,9141,6378,15519
27,27787,2010-12-31,9356,6462,15818
27,27787,2011-12-31,9550,6570,16120
27,27787,2012-12-31,9759,6692,16451
27,27787,2013-12-31,9954,6780,16734
27,27787,2014-12-31,10111,6864,16975
27,27787,2015-12-31,10320,6990,17310
27,27787,2016-12-31,10452,7084,17536
27,27787,2017-12-31,10657,7179,17836
27,27787,2018-12-31,10753,7258,18011
27,27787,2019-12-31,10740,7185,17925
27,27787,2020-12-31,10724,7189,17913
27,27787,2021-12-31,10755,7303,18058
27,27787,2022-12-31,10783,7416,18199
27,27787,2023-12-31,10807,7528,18335
27,27787,2024-12-31,10803,7644,18447
27,27787,2025-12-31,10789,7757,18546
27,27787,2026-12-31,10786,7884,18670
27,27787,2027-12-31,10783,7964,18747
27,27787,2028-12-31,10808,8073,18881
27,27787,2029-12-31,10827,8182,19009
27,27787,2030-12-31,10859,8317,19176
27,27787,2031-12-31,10885,8432,19317
27,27787,2032-12-31,10913,8541,19454
27,27787,2033-12-31,10928,8658,19586
27,27787,2034-12-31,10949,8758,19707
27,27787,2035-12-31,10954,8880,19834
27,27800,1985-12-31,1644,7459,9103
27,27800,1986-12-31,1665,7456,9121
27,27800,1987-12-31,1696,7460,9156
27,27800,1988-12-31,1782,7450,9232
27,27800,1989-12-31,1833,7460,9293
27,27800,1990-12-31,1896,7464,9360
27,27800,1991-12-31,1982,7453,9435
27,27800,1992-12-31,1999,7443,9442
27,27800,1993-12-31,2079,7674,9753
27,27800,1994-12-31,2252,7552,9804
27,27800,1995-12-31,2336,7559,9895
27,27800,1996-12-31,2383,7570,9953
27,27800,1997-12-31,2430,7778,10208
27,27800,1998-12-31,2683,7367,10050
27,27800,1999-12-31,2728,7247,9975
27,27800,2000-12-31,2951,6962,9913
27,27800,2001-12-31,3206,6678,9884
27,27800,2002-12-31,3374,6635,10009
27,27800,2003-12-31,3438,6773,10211
27,27800,2004-12-31,3523,6907,10430
27,27800,2005-12-31,3595,7064,10659
27,27800,2006-12-31,3653,7196,10849
27,27800,2007-12-31,3744,7350,11094
27,27800,2008-12-31,3819,7477,11296
27,27800,2009-12-31,3853,7614,11467
27,27800,2010-12-31,3934,7727,11661
27,27800,2011-12-31,3997,7839,11836
27,27800,2012-12-31,4051,7966,12017
27,27800,2013-12-31,4099,8047,12146
27,27800,2014-12-31,4172,8104,12276
27,27800,2015-12-31,4216,8199,12415
27,27800,2016-12-31,4262,8343,12605
27,27800,2017-12-31,4292,8445,12737
27,27800,2018-12-31,4343,8511,12854
27,27800,2019-12-31,4177,8644,12821
27,27800,2020-12-31,4041,8781,12822
27,27800,2021-12-31,4005,8921,12926
27,27800,2022-12-31,3968,9059,13027
27,27800,2023-12-31,3929,9195,13124
27,27800,2024-12-31,3902,9331,13233
27,27800,2025-12-31,3894,9460,13354
27,27800,2026-12-31,3880,9600,13480
27,27800,2027-12-31,3888,9750,13638
27,27800,2028-12-31,3885,9888,13773
27,27800,2029-12-31,3886,10018,13904
27,27800,2030-12-31,3892,10142,14034
27,27800,2031-12-31,3911,10265,14176
27,27800,2032-12-31,3922,10398,14320
27,27800,2033-12-31,3934,10545,14479
27,27800,2034-12-31,3940,10686,14626
27,27800,2035-12-31,3955,10825,14780
27,27810,1985-12-31,0,0,0
27,27810,1986-12-31,0,0,0
27,27810,1987-12-31,0,0,0
27,27810,1988-12-31,0,0,0
27,27810,1989-12-31,0,0,0
27,27810,1990-12-31,0,0,0
27,27810,1991-12-31,0,0,0
27,27810,1992-12-31,0,0,0
27,27810,1993-12-31,0,0,0
27,27810,1994-12-31,0,0,0
27,27810,1995-12-31,0,0,0
27,27810,1996-12-31,0,0,0
27,27810,1997-12-31,0,0,0
27,27810,1998-12-31,0,0,0
27,27810,1999-12-31,0,0,0
27,27810,2000-12-31,2544,5227,7771
27,27810,2001-12-31,2682,4887,7569
27,27810,2002-12-31,2779,4766,7545
27,27810,2003-12-31,2777,4709,7486
27,27810,2004-12-31,2814,4677,7491
27,27810,2005-12-31,2856,4664,7520
27,27810,2006-12-31,2847,4622,7469
27,27810,2007-12-31,2874,4587,7461
27,27810,2008-12-31,2899,4545,7444
27,27810,2009-12-31,2901,4498,7399
27,27810,2010-12-31,2924,4462,7386
27,27810,2011-12-31,2931,4413,7344
27,27810,2012-12-31,2933,4348,7281
27,27810,2013-12-31,2946,4267,7213
27,27810,2014-12-31,2958,4209,7167
27,27810,2015-12-31,2958,4161,7119
27,27810,2016-12-31,2937,4059,6996
27,27810,2017-12-31,2900,3969,6869
27,27810,2018-12-31,2944,3872,6816
27,27810,2019-12-31,2972,3937,6909
27,27810,2020-12-31,2999,3983,6982
27,27810,2021-12-31,2994,4046,7040
27,27810,2022-12-31,2986,4109,7095
27,27810,2023-12-31,2977,4171,7148
27,27810,2024-12-31,2968,4239,7207
27,27810,2025-12-31,2961,4298,7259
27,27810,2026-12-31,2964,4356,7320
27,27810,2027-12-31,2964,4424,7388
27,27810,2028-12-31,2968,4478,7446
27,27810,2029-12-31,2970,4548,7518
27,27810,2030-12-31,2980,4614,7594
27,27810,2031-12-31,2984,4675,7659
27,27810,2032-12-31,2992,4759,7751
27,27810,2033-12-31,3004,4807,7811
27,27810,2034-12-31,3013,4880,7893
27,27810,2035-12-31,3008,4938,7946
41,41001,1985-12-31,183524,17786,201310
41,41001,1986-12-31,193114,17368,210482
41,41001,1987-12-31,201564,17033,218597
41,41001,1988-12-31,209089,16845,225934
41,41001,1989-12-31,215930,16742,232672
41,41001,1990-12-31,222123,16714,238837
41,41001,1991-12-31,227908,16754,244662
41,41001,1992-12-31,233367,16826,250193
41,41001,1993-12-31,238450,16926,255376
41,41001,1994-12-31,243493,17074,260567
41,41001,1995-12-31,248203,17238,265441
41,41001,1996-12-31,252799,17400,270199
41,41001,1997-12-31,257312,17579,274891
41,41001,1998-12-31,261592,17767,279359
41,41001,1999-12-31,265728,17955,283683
41,41001,2000-12-31,269764,18148,287912
41,41001,2001-12-31,273728,18322,292050
41,41001,2002-12-31,277529,18507,296036
41,41001,2003-12-31,281185,18680,299865
41,41001,2004-12-31,284782,18851,303633
41,41001,2005-12-31,288335,19030,307365
41,41001,2006-12-31,291926,19203,311129
41,41001,2007-12-31,295540,19370,314910
41,41001,2008-12-31,299106,19555,318661
41,41001,2009-12-31,302690,19749,322439
41,41001,2010-12-31,306325,19894,326219
41,41001,2011-12-31,309933,20089,330022
41,41001,2012-12-31,313450,20267,333717
41,41001,2013-12-31,317011,20441,337452
41,41001,2014-12-31,320632,20600,341232
41,41001,2015-12-31,324266,20800,345066
41,41001,2016-12-31,328055,20993,349048
41,41001,2017-12-31,331864,21135,352999
41,41001,2018-12-31,335994,21398,357392
41,41001,2019-12-31,338346,22703,361049
41,41001,2020-12-31,340512,23896,364408
41,41001,2021-12-31,343194,24206,367400
41,41001,2022-12-31,345817,24501,370318
41,41001,2023-12-31,348346,24783,373129
41,41001,2024-12-31,350197,25056,375253
41,41001,2025-12-31,351881,25331,377212
41,41001,2026-12-31,353506,25600,379106
41,41001,2027-12-31,355081,25845,380926
41,41001,2028-12-31,356690,26107,382797
41,41001,2029-12-31,358201,26362,384563
41,41001,2030-12-31,359755,26598,386353
41,41001,2031-12-31,361208,26838,388046
41,41001,2032-12-31,362522,27070,389592
41,41001,2033-12-31,363697,27312,391009
41,41001,2034-12-31,364700,27538,392238
41,41001,2035-12-31,365621,27756,393377
41,41006,1985-12-31,2263,13369,15632
41,41006,1986-12-31,2357,13188,15545
41,41006,1987-12-31,2490,13064,15554
41,41006,1988-12-31,2589,13037,15626
41,41006,1989-12-31,2701,13070,15771
41,41006,1990-12-31,2796,13165,15961
41,41006,1991-12-31,2886,13297,16183
41,41006,1992-12-31,2972,13469,16441
41,41006,1993-12-31,3057,13667,16724
41,41006,1994-12-31,3134,13879,17013
41,41006,1995-12-31,3223,14121,17344
41,41006,1996-12-31,3277,14370,17647
41,41006,1997-12-31,3368,14624,17992
41,41006,1998-12-31,3434,14876,18310
41,41006,1999-12-31,3505,15154,18659
41,41006,2000-12-31,3562,15410,18972
41,41006,2001-12-31,3599,15678,19277
41,41006,2002-12-31,3680,15943,19623
41,41006,2003-12-31,3729,16180,19909
41,41006,2004-12-31,3789,16440,20229
41,41006,2005-12-31,3853,16695,20548
41,41006,2006-12-31,3911,16945,20856
41,41006,2007-12-31,3970,17207,21177
41,41006,2008-12-31,4034,17463,21497
41,41006,2009-12-31,4099,17736,21835
41,41006,2010-12-31,4151,17979,22130
41,41006,2011-12-31,4212,18246,22458
41,41006,2012-12-31,4273,18516,22789
41,41006,2013-12-31,4341,18751,23092
41,41006,2014-12-31,4381,19012,23393
41,41006,2015-12-31,4436,19297,23733
41,41006,2016-12-31,4505,19571,24076
41,41006,2017-12-31,4592,19838,24430
41,41006,2018-12-31,4640,20134,24774
41,41006,2019-12-31,4699,20347,25046
41,41006,2020-12-31,4756,20542,25298
41,41006,2021-12-31,4707,20803,25510
41,41006,2022-12-31,4656,21057,25713
41,41006,2023-12-31,4606,21303,25909
41,41006,2024-12-31,4626,21540,26166
41,41006,2025-12-31,4646,21774,26420
41,41006,2026-12-31,4669,22008,26677
41,41006,2027-12-31,4689,22231,26920
41,41006,2028-12-31,4709,22458,27167
41,41006,2029-12-31,4731,22659,27390
41,41006,2030-12-31,4744,22872,27616
41,41006,2031-12-31,4774,23077,27851
41,41006,2032-12-31,4786,23279,28065
41,41006,2033-12-31,4800,23466,28266
41,41006,2034-12-31,4817,23657,28474
41,41006,2035-12-31,4827,23842,28669
41,41013,1985-12-31,3428,2803,6231
41,41013,1986-12-31,3569,2720,6289
41,41013,1987-12-31,3714,2698,6412
41,41013,1988-12-31,3825,2652,6477
41,41013,1989-12-31,3921,2631,6552
41,41013,1990-12-31,4032,2611,6643
41,41013,1991-12-31,4120,2618,6738
41,41013,1992-12-31,4201,2633,6834
41,41013,1993-12-31,4272,2633,6905
41,41013,1994-12-31,4355,2653,7008
41,41013,1995-12-31,4421,2671,7092
41,41013,1996-12-31,4494,2702,7196
41,41013,1997-12-31,4548,2709,7257
41,41013,1998-12-31,4613,2721,7334
41,41013,1999-12-31,4665,2743,7408
41,41013,2000-12-31,4732,2756,7488
41,41013,2001-12-31,4805,2788,7593
41,41013,2002-12-31,4851,2797,7648
41,41013,2003-12-31,4891,2818,7709
41,41013,2004-12-31,4949,2854,7803
41,41013,2005-12-31,5008,2860,7868
41,41013,2006-12-31,5039,2868,7907
41,41013,2007-12-31,5088,2890,7978
41,41013,2008-12-31,5151,2915,8066
41,41013,2009-12-31,5214,2961,8175
41,41013,2010-12-31,5239,2995,8234
41,41013,2011-12-31,5290,3002,8292
41,41013,2012-12-31,5354,3055,8409
41,41013,2013-12-31,5368,3091,8459
41,41013,2014-12-31,5404,3082,8486
41,41013,2015-12-31,5464,3092,8556
41,41013,2016-12-31,5511,3110,8621
41,41013,2017-12-31,5586,3115,8701
41,41013,2018-12-31,5664,3136,8800
41,41013,2019-12-31,5709,3157,8866
41,41013,2020-12-31,5750,3187,8937
41,41013,2021-12-31,5783,3227,9010
41,41013,2022-12-31,5815,3267,9082
41,41013,2023-12-31,5846,3305,9151
41,41013,2024-12-31,5880,3341,9221
41,41013,2025-12-31,5912,3375,9287
41,41013,2026-12-31,5939,3420,9359
41,41013,2027-12-31,5959,3443,9402
41,41013,2028-12-31,5986,3483,9469
41,41013,2029-12-31,6013,3519,9532
41,41013,2030-12-31,6047,3543,9590
41,41013,2031-12-31,6062,3575,9637
41,41013,2032-12-31,6090,3612,9702
41,41013,2033-12-31,6100,3644,9744
41,41013,2034-12-31,6114,3670,9784
41,41013,2035-12-31,6135,3697,9832
41,41016,1985-12-31,4898,4611,9509
41,41016,1986-12-31,5200,4497,9697
41,41016,1987-12-31,5471,4426,9897
41,41016,1988-12-31,5725,4378,10103
41,41016,1989-12-31,5948,4345,10293
41,41016,1990-12-31,6181,4334,10515
41,41016,1991-12-31,6391,4345,10736
41,41016,1992-12-31,6580,4369,10949
41,41016,1993-12-31,6778,4376,11154
41,41016,1994-12-31,6952,4454,11406
41,41016,1995-12-31,7138,4480,11618
41,41016,1996-12-31,7303,4538,11841
41,41016,1997-12-31,7479,4571,12050
41,41016,1998-12-31,7625,4623,12248
41,41016,1999-12-31,7808,4674,12482
41,41016,2000-12-31,7970,4725,12695
41,41016,2001-12-31,8122,4791,12913
41,41016,2002-12-31,8270,4818,13088
41,41016,2003-12-31,8419,4878,13297
41,41016,2004-12-31,8566,4927,13493
41,41016,2005-12-31,8713,4957,13670
41,41016,2006-12-31,8850,5012,13862
41,41016,2007-12-31,8985,5057,14042
41,41016,2008-12-31,9114,5116,14230
41,41016,2009-12-31,9285,5141,14426
41,41016,2010-12-31,9409,5182,14591
41,41016,2011-12-31,9537,5238,14775
41,41016,2012-12-31,9687,5295,14982
41,41016,2013-12-31,9818,5380,15198
41,41016,2014-12-31,9981,5417,15398
41,41016,2015-12-31,10149,5478,15627
41,41016,2016-12-31,10290,5582,15872
41,41016,2017-12-31,10370,5583,15953
41,41016,2018-12-31,10553,5610,16163
41,41016,2019-12-31,10696,5665,16361
41,41016,2020-12-31,10834,5712,16546
41,41016,2021-12-31,10900,5785,16685
41,41016,2022-12-31,10963,5855,16818
41,41016,2023-12-31,11021,5924,16945
41,41016,2024-12-31,11072,5992,17064
41,41016,2025-12-31,11129,6057,17186
41,41016,2026-12-31,11182,6122,17304
41,41016,2027-12-31,11230,6178,17408
41,41016,2028-12-31,11280,6243,17523
41,41016,2029-12-31,11319,6303,17622
41,41016,2030-12-31,11376,6369,17745
41,41016,2031-12-31,11426,6413,17839
41,41016,2032-12-31,11458,6473,17931
41,41016,2033-12-31,11502,6520,18022
41,41016,2034-12-31,11540,6585,18125
41,41016,2035-12-31,11560,6639,18199
41,41020,1985-12-31,7043,12258,19301
41,41020,1986-12-31,7324,11875,19199
41,41020,1987-12-31,7573,11564,19137
41,41020,1988-12-31,7788,11340,19128
41,41020,1989-12-31,7978,11182,19160
41,41020,1990-12-31,8154,11070,19224
41,41020,1991-12-31,8304,11025,19329
41,41020,1992-12-31,8451,10969,19420
41,41020,1993-12-31,8566,10974,19540
41,41020,1994-12-31,8681,10997,19678
41,41020,1995-12-31,8808,11007,19815
41,41020,1996-12-31,8911,11029,19940
41,41020,1997-12-31,9034,11054,20088
41,41020,1998-12-31,9137,11104,20241
41,41020,1999-12-31,9227,11135,20362
41,41020,2000-12-31,9316,11164,20480
41,41020,2001-12-31,9397,11190,20587
41,41020,2002-12-31,9480,11217,20697
41,41020,2003-12-31,9579,11252,20831
41,41020,2004-12-31,9647,11278,20925
41,41020,2005-12-31,9731,11297,21028
41,41020,2006-12-31,9785,11347,21132
41,41020,2007-12-31,9881,11390,21271
41,41020,2008-12-31,9977,11388,21365
41,41020,2009-12-31,10036,11415,21451
41,41020,2010-12-31,10135,11444,21579
41,41020,2011-12-31,10201,11476,21677
41,41020,2012-12-31,10286,11502,21788
41,41020,2013-12-31,10390,11539,21929
41,41020,2014-12-31,10465,11537,22002
41,41020,2015-12-31,10572,11559,22131
41,41020,2016-12-31,10633,11572,22205
41,41020,2017-12-31,10701,11652,22353
41,41020,2018-12-31,10806,11675,22481
41,41020,2019-12-31,10891,11607,22498
41,41020,2020-12-31,10969,11606,22575
41,41020,2021-12-31,11007,11753,22760
41,41020,2022-12-31,11044,11897,22941
41,41020,2023-12-31,11079,12036,23115
41,41020,2024-12-31,11130,12175,23305
41,41020,2025-12-31,11184,12299,23483
41,41020,2026-12-31,11235,12434,23669
41,41020,2027-12-31,11291,12557,23848
41,41020,2028-12-31,11338,12687,24025
41,41020,2029-12-31,11391,12801,24192
41,41020,2030-12-31,11437,12918,24355
41,41020,2031-12-31,11474,13038,24512
41,41020,2032-12-31,11510,13152,24662
41,41020,2033-12-31,11566,13263,24829
41,41020,2034-12-31,11590,13364,24954
41,41020,2035-12-31,11612,13471,25083
41,41026,1985-12-31,1702,840,2542
41,41026,1986-12-31,1799,855,2654
41,41026,1987-12-31,1834,852,2686
41,41026,1988-12-31,1901,907,2808
41,41026,1989-12-31,1959,944,2903
41,41026,1990-12-31,1976,965,2941
41,41026,1991-12-31,2007,976,2983
41,41026,1992-12-31,2038,988,3026
41,41026,1993-12-31,2065,998,3063
41,41026,1994-12-31,2082,1049,3131
41,41026,1995-12-31,2088,1079,3167
41,41026,1996-12-31,2107,1095,3202
41,41026,1997-12-31,2122,1144,3266
41,41026,1998-12-31,2142,1168,3310
41,41026,1999-12-31,2158,1213,3371
41,41026,2000-12-31,2181,1264,3445
41,41026,2001-12-31,2186,1308,3494
41,41026,2002-12-31,2192,1342,3534
41,41026,2003-12-31,2201,1374,3575
41,41026,2004-12-31,2227,1407,3634
41,41026,2005-12-31,2240,1423,3663
41,41026,2006-12-31,2262,1464,3726
41,41026,2007-12-31,2287,1501,3788
41,41026,2008-12-31,2271,1522,3793
41,41026,2009-12-31,2287,1570,3857
41,41026,2010-12-31,2346,1604,3950
41,41026,2011-12-31,2324,1616,3940
41,41026,2012-12-31,2316,1624,3940
41,41026,2013-12-31,2325,1663,3988
41,41026,2014-12-31,2340,1706,4046
41,41026,2015-12-31,2361,1737,4098
41,41026,2016-12-31,2375,1777,4152
41,41026,2017-12-31,2398,1814,4212
41,41026,2018-12-31,2425,1850,4275
41,41026,2019-12-31,2425,1898,4323
41,41026,2020-12-31,2429,1938,4367
41,41026,2021-12-31,2441,1963,4404
41,41026,2022-12-31,2452,1987,4439
41,41026,2023-12-31,2462,2010,4472
41,41026,2024-12-31,2476,2026,4502
41,41026,2025-12-31,2481,2048,4529
41,41026,2026-12-31,2496,2079,4575
41,41026,2027-12-31,2505,2106,4611
41,41026,2028-12-31,2516,2120,4636
41,41026,2029-12-31,2535,2133,4668
41,41026,2030-12-31,2533,2156,4689
41,41026,2031-12-31,2547,2173,4720
41,41026,2032-12-31,2560,2196,4756
41,41026,2033-12-31,2576,2219,4795
41,41026,2034-12-31,2578,2241,4819
41,41026,2035-12-31,2588,2263,4851
41,41078,1985-12-31,3604,4669,8273
41,41078,1986-12-31,3686,4518,8204
41,41078,1987-12-31,3785,4403,8188
41,41078,1988-12-31,3839,4316,8155
41,41078,1989-12-31,3890,4246,8136
41,41078,1990-12-31,3914,4208,8122
41,41078,1991-12-31,3936,4181,8117
41,41078,1992-12-31,3947,4167,8114
41,41078,1993-12-31,3969,4190,8159
41,41078,1994-12-31,3979,4169,8148
41,41078,1995-12-31,3999,4176,8175
41,41078,1996-12-31,4020,4191,8211
41,41078,1997-12-31,3972,4201,8173
41,41078,1998-12-31,3979,4192,8171
41,41078,1999-12-31,4000,4204,8204
41,41078,2000-12-31,4005,4214,8219
41,41078,2001-12-31,3989,4185,8174
41,41078,2002-12-31,3986,4225,8211
41,41078,2003-12-31,3974,4208,8182
41,41078,2004-12-31,3951,4219,8170
41,41078,2005-12-31,3975,4262,8237
41,41078,2006-12-31,3987,4257,8244
41,41078,2007-12-31,3995,4270,8265
41,41078,2008-12-31,3973,4271,8244
41,41078,2009-12-31,3981,4272,8253
41,41078,2010-12-31,3986,4292,8278
41,41078,2011-12-31,3978,4289,8267
41,41078,2012-12-31,3947,4330,8277
41,41078,2013-12-31,3946,4333,8279
41,41078,2014-12-31,3933,4340,8273
41,41078,2015-12-31,3917,4355,8272
41,41078,2016-12-31,3908,4359,8267
41,41078,2017-12-31,3936,4367,8303
41,41078,2018-12-31,3975,4363,8338
41,41078,2019-12-31,3927,4355,8282
41,41078,2020-12-31,3903,4366,8269
41,41078,2021-12-31,3916,4421,8337
41,41078,2022-12-31,3928,4475,8403
41,41078,2023-12-31,3939,4528,8467
41,41078,2024-12-31,3954,4581,8535
41,41078,2025-12-31,3975,4624,8599
41,41078,2026-12-31,3981,4687,8668
41,41078,2027-12-31,4010,4721,8731
41,41078,2028-12-31,4021,4771,8792
41,41078,2029-12-31,4043,4813,8856
41,41078,2030-12-31,4064,4860,8924
41,41078,2031-12-31,4081,4904,8985
41,41078,2032-12-31,4093,4955,9048
41,41078,2033-12-31,4101,4998,9099
41,41078,2034-12-31,4116,5032,9148
41,41078,2035-12-31,4118,5073,9191
41,41132,1985-12-31,17196,7719,24915
41,41132,1986-12-31,17838,7516,25354
41,41132,1987-12-31,18370,7281,25651
41,41132,1988-12-31,18827,7140,25967
41,41132,1989-12-31,19206,7040,26246
41,41132,1990-12-31,19524,6983,26507
41,41132,1991-12-31,19811,6933,26744
41,41132,1992-12-31,20068,6909,26977
41,41132,1993-12-31,20281,6902,27183
41,41132,1994-12-31,20505,6901,27406
41,41132,1995-12-31,20695,6916,27611
41,41132,1996-12-31,20876,6934,27810
41,41132,1997-12-31,21051,6943,27994
41,41132,1998-12-31,21227,6974,28201
41,41132,1999-12-31,21375,6988,28363
41,41132,2000-12-31,21505,6990,28495
41,41132,2001-12-31,21644,7020,28664
41,41132,2002-12-31,21775,7047,28822
41,41132,2003-12-31,21894,7077,28971
41,41132,2004-12-31,22006,7070,29076
41,41132,2005-12-31,22122,7088,29210
41,41132,2006-12-31,22240,7130,29370
41,41132,2007-12-31,22354,7130,29484
41,41132,2008-12-31,22469,7143,29612
41,41132,2009-12-31,22605,7156,29761
41,41132,2010-12-31,22726,7173,29899
41,41132,2011-12-31,22851,7186,30037
41,41132,2012-12-31,22978,7180,30158
41,41132,2013-12-31,23077,7178,30255
41,41132,2014-12-31,23234,7179,30413
41,41132,2015-12-31,23346,7227,30573
41,41132,2016-12-31,23469,7303,30772
41,41132,2017-12-31,23640,7286,30926
41,41132,2018-12-31,23787,7300,31087
41,41132,2019-12-31,23778,7417,31195
41,41132,2020-12-31,23818,7539,31357
41,41132,2021-12-31,23978,7636,31614
41,41132,2022-12-31,24136,7729,31865
41,41132,2023-12-31,24288,7820,32108
41,41132,2024-12-31,24419,7902,32321
41,41132,2025-12-31,24526,8005,32531
41,41132,2026-12-31,24646,8076,32722
41,41132,2027-12-31,24759,8163,32922
41,41132,2028-12-31,24870,8259,33129
41,41132,2029-12-31,24986,8318,33304
41,41132,2030-12-31,25081,8397,33478
41,41132,2031-12-31,25193,8474,33667
41,41132,2032-12-31,25281,8550,33831
41,41132,2033-12-31,25360,8630,33990
41,41132,2034-12-31,25420,8697,34117
41,41132,2035-12-31,25497,8754,34251
41,41206,1985-12-31,1884,8685,10569
41,41206,1986-12-31,1929,8329,10258
41,41206,1987-12-31,1990,7992,9982
41,41206,1988-12-31,2039,7752,9791
41,41206,1989-12-31,2052,7556,9608
41,41206,1990-12-31,2087,7394,9481
41,41206,1991-12-31,2102,7264,9366
41,41206,1992-12-31,2111,7124,9235
41,41206,1993-12-31,2123,7059,9182
41,41206,1994-12-31,2147,6946,9093
41,41206,1995-12-31,2164,6896,9060
41,41206,1996-12-31,2166,6816,8982
41,41206,1997-12-31,2191,6739,8930
41,41206,1998-12-31,2193,6684,8877
41,41206,1999-12-31,2197,6621,8818
41,41206,2000-12-31,2163,6548,8711
41,41206,2001-12-31,2174,6444,8618
41,41206,2002-12-31,2151,6375,8526
41,41206,2003-12-31,2161,6305,8466
41,41206,2004-12-31,2170,6242,8412
41,41206,2005-12-31,2189,6162,8351
41,41206,2006-12-31,2153,6110,8263
41,41206,2007-12-31,2150,5990,8140
41,41206,2008-12-31,2130,5909,8039
41,41206,2009-12-31,2160,5826,7986
41,41206,2010-12-31,2155,5735,7890
41,41206,2011-12-31,2156,5648,7804
41,41206,2012-12-31,2140,5559,7699
41,41206,2013-12-31,2161,5479,7640
41,41206,2014-12-31,2161,5400,7561
41,41206,2015-12-31,2162,5363,7525
41,41206,2016-12-31,2166,5261,7427
41,41206,2017-12-31,2175,5187,7362
41,41206,2018-12-31,2205,5080,7285
41,41206,2019-12-31,2131,5005,7136
41,41206,2020-12-31,2062,5002,7064
41,41206,2021-12-31,2056,5066,7122
41,41206,2022-12-31,2052,5127,7179
41,41206,2023-12-31,2046,5187,7233
41,41206,2024-12-31,2047,5246,7293
41,41206,2025-12-31,2060,5303,7363
41,41206,2026-12-31,2069,5362,7431
41,41206,2027-12-31,2081,5418,7499
41,41206,2028-12-31,2089,5463,7552
41,41206,2029-12-31,2092,5511,7603
41,41206,2030-12-31,2103,5570,7673
41,41206,2031-12-31,2111,5626,7737
41,41206,2032-12-31,2125,5651,7776
41,41206,2033-12-31,2130,5705,7835
41,41206,2034-12-31,2137,5754,7891
41,41206,2035-12-31,2142,5798,7940
41,41244,1985-12-31,898,2088,2986
41,41244,1986-12-31,913,2011,2924
41,41244,1987-12-31,990,2037,3027
41,41244,1988-12-31,1024,2022,3046
41,41244,1989-12-31,1055,1976,3031
41,41244,1990-12-31,1074,2004,3078
41,41244,1991-12-31,1096,2002,3098
41,41244,1992-12-31,1112,2025,3137
41,41244,1993-12-31,1135,2037,3172
41,41244,1994-12-31,1115,2065,3180
41,41244,1995-12-31,1118,2091,3209
41,41244,1996-12-31,1135,2117,3252
41,41244,1997-12-31,1135,2156,3291
41,41244,1998-12-31,1180,2177,3357
41,41244,1999-12-31,1212,2212,3424
41,41244,2000-12-31,1217,2253,3470
41,41244,2001-12-31,1232,2263,3495
41,41244,2002-12-31,1243,2288,3531
41,41244,2003-12-31,1241,2325,3566
41,41244,2004-12-31,1243,2354,3597
41,41244,2005-12-31,1260,2387,3647
41,41244,2006-12-31,1260,2413,3673
41,41244,2007-12-31,1269,2474,3743
41,41244,2008-12-31,1270,2467,3737
41,41244,2009-12-31,1266,2520,3786
41,41244,2010-12-31,1287,2562,3849
41,41244,2011-12-31,1280,2590,3870
41,41244,2012-12-31,1304,2633,3937
41,41244,2013-12-31,1337,2651,3988
41,41244,2014-12-31,1357,2657,4014
41,41244,2015-12-31,1380,2654,4034
41,41244,2016-12-31,1397,2689,4086
41,41244,2017-12-31,1415,2735,4150
41,41244,2018-12-31,1439,2772,4211
41,41244,2019-12-31,1445,2812,4257
41,41244,2020-12-31,1451,2849,4300
41,41244,2021-12-31,1451,2885,4336
41,41244,2022-12-31,1451,2920,4371
41,41244,2023-12-31,1449,2955,4404
41,41244,2024-12-31,1445,2994,4439
41,41244,2025-12-31,1455,3023,4478
41,41244,2026-12-31,1465,3046,4511
41,41244,2027-12-31,1472,3083,4555
41,41244,2028-12-31,1482,3114,4596
41,41244,2029-12-31,1495,3140,4635
41,41244,2030-12-31,1495,3173,4668
41,41244,2031-12-31,1501,3203,4704
41,41244,2032-12-31,1508,3225,4733
41,41244,2033-12-31,1511,3252,4763
41,41244,2034-12-31,1523,3282,4805
41,41244,2035-12-31,1520,3308,4828
41,41298,1985-12-31,19943,22441,42384
41,41298,1986-12-31,21050,22107,43157
41,41298,1987-12-31,22050,21890,43940
41,41298,1988-12-31,22947,21820,44767
41,41298,1989-12-31,23765,21889,45654
41,41298,1990-12-31,24516,22025,46541
41,41298,1991-12-31,25241,22228,47469
41,41298,1992-12-31,25908,22517,48425
41,41298,1993-12-31,26549,22840,49389
41,41298,1994-12-31,27166,23199,50365
41,41298,1995-12-31,27753,23593,51346
41,41298,1996-12-31,28343,23989,52332
41,41298,1997-12-31,28895,24426,53321
41,41298,1998-12-31,29450,24841,54291
41,41298,1999-12-31,29981,25279,55260
41,41298,2000-12-31,30494,25711,56205
41,41298,2001-12-31,31002,26140,57142
41,41298,2002-12-31,31480,26573,58053
41,41298,2003-12-31,31958,26982,58940
41,41298,2004-12-31,32413,27406,59819
41,41298,2005-12-31,32866,27810,60676
41,41298,2006-12-31,33342,28230,61572
41,41298,2007-12-31,33791,28646,62437
41,41298,2008-12-31,34251,29079,63330
41,41298,2009-12-31,34710,29494,64204
41,41298,2010-12-31,35172,29924,65096
41,41298,2011-12-31,35621,30344,65965
41,41298,2012-12-31,36086,30775,66861
41,41298,2013-12-31,36533,31198,67731
41,41298,2014-12-31,37003,31652,68655
41,41298,2015-12-31,37475,32059,69534
41,41298,2016-12-31,37954,32533,70487
41,41298,2017-12-31,38455,32978,71433
41,41298,2018-12-31,38923,33459,72382
41,41298,2019-12-31,39248,34044,73292
41,41298,2020-12-31,39544,34592,74136
41,41298,2021-12-31,39720,35038,74758
41,41298,2022-12-31,39887,35466,75353
41,41298,2023-12-31,40046,35880,75926
41,41298,2024-12-31,40230,36290,76520
41,41298,2025-12-31,40418,36685,77103
41,41298,2026-12-31,40607,37056,77663
41,41298,2027-12-31,40786,37429,78215
41,41298,2028-12-31,40974,37808,78782
41,41298,2029-12-31,41150,38168,79318
41,41298,2030-12-31,41327,38514,79841
41,41298,2031-12-31,41494,38850,80344
41,41298,2032-12-31,41652,39193,80845
41,41298,2033-12-31,41778,39518,81296
41,41298,2034-12-31,41908,39839,81747
41,41298,2035-12-31,41987,40156,82143
41,41306,1985-12-31,7010,14438,21448
41,41306,1986-12-31,7252,14024,21276
41,41306,1987-12-31,7471,13680,21151
41,41306,1988-12-31,7668,13458,21126
41,41306,1989-12-31,7830,13302,21132
41,41306,1990-12-31,7950,13210,21160
41,41306,1991-12-31,8081,13140,21221
41,41306,1992-12-31,8173,13169,21342
41,41306,1993-12-31,8271,13180,21451
41,41306,1994-12-31,8361,13209,21570
41,41306,1995-12-31,8453,13266,21719
41,41306,1996-12-31,8516,13330,21846
41,41306,1997-12-31,8595,13392,21987
41,41306,1998-12-31,8680,13469,22149
41,41306,1999-12-31,8721,13548,22269
41,41306,2000-12-31,8781,13614,22395
41,41306,2001-12-31,8845,13695,22540
41,41306,2002-12-31,8907,13768,22675
41,41306,2003-12-31,8952,13815,22767
41,41306,2004-12-31,9012,13891,22903
41,41306,2005-12-31,9061,13950,23011
41,41306,2006-12-31,9109,14004,23113
41,41306,2007-12-31,9161,14073,23234
41,41306,2008-12-31,9201,14138,23339
41,41306,2009-12-31,9260,14229,23489
41,41306,2010-12-31,9301,14276,23577
41,41306,2011-12-31,9376,14320,23696
41,41306,2012-12-31,9443,14396,23839
41,41306,2013-12-31,9469,14469,23938
41,41306,2014-12-31,9550,14528,24078
41,41306,2015-12-31,9624,14597,24221
41,41306,2016-12-31,9648,14628,24276
41,41306,2017-12-31,9666,14717,24383
41,41306,2018-12-31,9766,14817,24583
41,41306,2019-12-31,9843,14791,24634
41,41306,2020-12-31,9913,14813,24726
41,41306,2021-12-31,9928,15001,24929
41,41306,2022-12-31,9943,15184,25127
41,41306,2023-12-31,9956,15362,25318
41,41306,2024-12-31,9988,15530,25518
41,41306,2025-12-31,10037,15716,25753
41,41306,2026-12-31,10087,15860,25947
41,41306,2027-12-31,10127,16034,26161
41,41306,2028-12-31,10172,16192,26364
41,41306,2029-12-31,10218,16346,26564
41,41306,2030-12-31,10262,16492,26754
41,41306,2031-12-31,10289,16651,26940
41,41306,2032-12-31,10325,16791,27116
41,41306,2033-12-31,10368,16929,27297
41,41306,2034-12-31,10394,17069,27463
41,41306,2035-12-31,10427,17213,27640
41,41319,1985-12-31,3236,8650,11886
41,41319,1986-12-31,3395,8493,11888
41,41319,1987-12-31,3510,8400,11910
41,41319,1988-12-31,3611,8380,11991
41,41319,1989-12-31,3725,8385,12110
41,41319,1990-12-31,3816,8424,12240
41,41319,1991-12-31,3899,8489,12388
41,41319,1992-12-31,3981,8585,12566
41,41319,1993-12-31,4048,8694,12742
41,41319,1994-12-31,4121,8817,12938
41,41319,1995-12-31,4204,8956,13160
41,41319,1996-12-31,4279,9105,13384
41,41319,1997-12-31,4351,9234,13585
41,41319,1998-12-31,4421,9395,13816
41,41319,1999-12-31,4481,9546,14027
41,41319,2000-12-31,4554,9701,14255
41,41319,2001-12-31,4584,9839,14423
41,41319,2002-12-31,4623,9994,14617
41,41319,2003-12-31,4673,10145,14818
41,41319,2004-12-31,4766,10273,15039
41,41319,2005-12-31,4771,10422,15193
41,41319,2006-12-31,4822,10575,15397
41,41319,2007-12-31,4903,10723,15626
41,41319,2008-12-31,4974,10857,15831
41,41319,2009-12-31,5011,10981,15992
41,41319,2010-12-31,5078,11131,16209
41,41319,2011-12-31,5147,11318,16465
41,41319,2012-12-31,5208,11471,16679
41,41319,2013-12-31,5260,11595,16855
41,41319,2014-12-31,5285,11764,17049
41,41319,2015-12-31,5287,11904,17191
41,41319,2016-12-31,5359,12022,17381
41,41319,2017-12-31,5423,12197,17620
41,41319,2018-12-31,5497,12393,17890
41,41319,2019-12-31,5507,12597,18104
41,41319,2020-12-31,5514,12788,18302
41,41319,2021-12-31,5503,12953,18456
41,41319,2022-12-31,5491,13111,18602
41,41319,2023-12-31,5480,13264,18744
41,41319,2024-12-31,5504,13422,18926
41,41319,2025-12-31,5525,13564,19089
41,41319,2026-12-31,5553,13702,19255
41,41319,2027-12-31,5583,13843,19426
41,41319,2028-12-31,5602,13978,19580
41,41319,2029-12-31,5628,14113,19741
41,41319,2030-12-31,5640,14237,19877
41,41319,2031-12-31,5669,14363,20032
41,41319,2032-12-31,5698,14499,20197
41,41319,2033-12-31,5709,14620,20329
41,41319,2034-12-31,5724,14742,20466
41,41319,2035-12-31,5736,14850,20586
41,41349,1985-12-31,3531,1809,5340
41,41349,1986-12-31,3698,1694,5392
41,41349,1987-12-31,3827,1699,5526
41,41349,1988-12-31,3945,1656,5601
41,41349,1989-12-31,4042,1634,5676
41,41349,1990-12-31,4137,1622,5759
41,41349,1991-12-31,4224,1613,5837
41,41349,1992-12-31,4307,1598,5905
41,41349,1993-12-31,4365,1600,5965
41,41349,1994-12-31,4441,1603,6044
41,41349,1995-12-31,4505,1596,6101
41,41349,1996-12-31,4590,1596,6186
41,41349,1997-12-31,4626,1591,6217
41,41349,1998-12-31,4650,1598,6248
41,41349,1999-12-31,4719,1592,6311
41,41349,2000-12-31,4757,1601,6358
41,41349,2001-12-31,4799,1613,6412
41,41349,2002-12-31,4864,1624,6488
41,41349,2003-12-31,4927,1619,6546
41,41349,2004-12-31,4978,1627,6605
41,41349,2005-12-31,5015,1633,6648
41,41349,2006-12-31,5035,1633,6668
41,41349,2007-12-31,5093,1642,6735
41,41349,2008-12-31,5128,1666,6794
41,41349,2009-12-31,5176,1665,6841
41,41349,2010-12-31,5219,1661,6880
41,41349,2011-12-31,5291,1656,6947
41,41349,2012-12-31,5345,1665,7010
41,41349,2013-12-31,5392,1671,7063
41,41349,2014-12-31,5435,1658,7093
41,41349,2015-12-31,5448,1637,7085
41,41349,2016-12-31,5505,1611,7116
41,41349,2017-12-31,5569,1632,7201
41,41349,2018-12-31,5639,1647,7286
41,41349,2019-12-31,5654,1681,7335
41,41349,2020-12-31,5668,1719,7387
41,41349,2021-12-31,5707,1741,7448
41,41349,2022-12-31,5745,1762,7507
41,41349,2023-12-31,5781,1783,7564
41,41349,2024-12-31,5809,1797,7606
41,41349,2025-12-31,5836,1809,7645
41,41349,2026-12-31,5866,1839,7705
41,41349,2027-12-31,5890,1857,7747
41,41349,2028-12-31,5907,1881,7788
41,41349,2029-12-31,5936,1890,7826
41,41349,2030-12-31,5954,1900,7854
41,41349,2031-12-31,5995,1930,7925
41,41349,2032-12-31,6016,1945,7961
41,41349,2033-12-31,6029,1955,7984
41,41349,2034-12-31,6053,1982,8035
41,41349,2035-12-31,6063,1991,8054
41,41357,1985-12-31,2038,5150,7188
41,41357,1986-12-31,2118,5018,7136
41,41357,1987-12-31,2162,4967,7129
41,41357,1988-12-31,2255,4918,7173
41,41357,1989-12-31,2276,4903,7179
41,41357,1990-12-31,2313,4910,7223
41,41357,1991-12-31,2340,4911,7251
41,41357,1992-12-31,2362,4957,7319
41,41357,1993-12-31,2395,4989,7384
41,41357,1994-12-31,2396,5040,7436
41,41357,1995-12-31,2406,5109,7515
41,41357,1996-12-31,2429,5164,7593
41,41357,1997-12-31,2441,5265,7706
41,41357,1998-12-31,2424,5305,7729
41,41357,1999-12-31,2469,5368,7837
41,41357,2000-12-31,2484,5439,7923
41,41357,2001-12-31,2502,5491,7993
41,41357,2002-12-31,2473,5557,8030
41,41357,2003-12-31,2493,5616,8109
41,41357,2004-12-31,2508,5707,8215
41,41357,2005-12-31,2500,5771,8271
41,41357,2006-12-31,2521,5825,8346
41,41357,2007-12-31,2537,5879,8416
41,41357,2008-12-31,2552,5947,8499
41,41357,2009-12-31,2546,6000,8546
41,41357,2010-12-31,2535,6078,8613
41,41357,2011-12-31,2533,6143,8676
41,41357,2012-12-31,2520,6198,8718
41,41357,2013-12-31,2526,6255,8781
41,41357,2014-12-31,2534,6346,8880
41,41357,2015-12-31,2552,6424,8976
41,41357,2016-12-31,2590,6495,9085
41,41357,2017-12-31,2623,6552,9175
41,41357,2018-12-31,2652,6596,9248
41,41357,2019-12-31,2644,6647,9291
41,41357,2020-12-31,2647,6698,9345
41,41357,2021-12-31,2639,6783,9422
41,41357,2022-12-31,2631,6866,9497
41,41357,2023-12-31,2623,6946,9569
41,41357,2024-12-31,2632,7025,9657
41,41357,2025-12-31,2641,7102,9743
41,41357,2026-12-31,2652,7180,9832
41,41357,2027-12-31,2671,7246,9917
41,41357,2028-12-31,2675,7314,9989
41,41357,2029-12-31,2693,7393,10086
41,41357,2030-12-31,2709,7453,10162
41,41357,2031-12-31,2712,7526,10238
41,41357,2032-12-31,2724,7590,10314
41,41357,2033-12-31,2736,7646,10382
41,41357,2034-12-31,2745,7710,10455
41,41357,2035-12-31,2747,7782,10529
41,41359,1985-12-31,2058,14270,16328
41,41359,1986-12-31,2257,14006,16263
41,41359,1987-12-31,2433,13799,16232
41,41359,1988-12-31,2587,13699,16286
41,41359,1989-12-31,2744,13667,16411
41,41359,1990-12-31,2893,13701,16594
41,41359,1991-12-31,3041,13771,16812
41,41359,1992-12-31,3185,13888,17073
41,41359,1993-12-31,3322,14031,17353
41,41359,1994-12-31,3458,14193,17651
41,41359,1995-12-31,3593,14377,17970
41,41359,1996-12-31,3719,14555,18274
41,41359,1997-12-31,3839,14772,18611
41,41359,1998-12-31,3967,14961,18928
41,41359,1999-12-31,4072,15161,19233
41,41359,2000-12-31,4199,15382,19581
41,41359,2001-12-31,4297,15584,19881
41,41359,2002-12-31,4443,15785,20228
41,41359,2003-12-31,4541,15980,20521
41,41359,2004-12-31,4667,16175,20842
41,41359,2005-12-31,4755,16360,21115
41,41359,2006-12-31,4878,16564,21442
41,41359,2007-12-31,4972,16787,21759
41,41359,2008-12-31,5090,16974,22064
41,41359,2009-12-31,5199,17142,22341
41,41359,2010-12-31,5281,17362,22643
41,41359,2011-12-31,5393,17563,22956
41,41359,2012-12-31,5514,17737,23251
41,41359,2013-12-31,5638,17944,23582
41,41359,2014-12-31,5761,18149,23910
41,41359,2015-12-31,5825,18369,24194
41,41359,2016-12-31,5906,18590,24496
41,41359,2017-12-31,6053,18758,24811
41,41359,2018-12-31,6148,19038,25186
41,41359,2019-12-31,6254,19209,25463
41,41359,2020-12-31,6340,19379,25719
41,41359,2021-12-31,6310,19625,25935
41,41359,2022-12-31,6277,19864,26141
41,41359,2023-12-31,6243,20097,26340
41,41359,2024-12-31,6269,20325,26594
41,41359,2025-12-31,6291,20548,26839
41,41359,2026-12-31,6328,20763,27091
41,41359,2027-12-31,6359,20988,27347
41,41359,2028-12-31,6379,21197,27576
41,41359,2029-12-31,6408,21400,27808
41,41359,2030-12-31,6432,21600,28032
41,41359,2031-12-31,6469,21794,28263
41,41359,2032-12-31,6479,21973,28452
41,41359,2033-12-31,6505,22176,28681
41,41359,2034-12-31,6532,22355,28887
41,41359,2035-12-31,6541,22545,29086
41,41378,1985-12-31,1475,5832,7307
41,41378,1986-12-31,1643,5733,7376
41,41378,1987-12-31,1775,5670,7445
41,41378,1988-12-31,1911,5642,7553
41,41378,1989-12-31,2021,5652,7673
41,41378,1990-12-31,2151,5629,7780
41,41378,1991-12-31,2265,5665,7930
41,41378,1992-12-31,2344,5737,8081
41,41378,1993-12-31,2466,5781,8247
41,41378,1994-12-31,2592,5871,8463
41,41378,1995-12-31,2714,5961,8675
41,41378,1996-12-31,2808,6051,8859
41,41378,1997-12-31,2914,6151,9065
41,41378,1998-12-31,3023,6240,9263
41,41378,1999-12-31,3108,6333,9441
41,41378,2000-12-31,3201,6431,9632
41,41378,2001-12-31,3287,6516,9803
41,41378,2002-12-31,3367,6605,9972
41,41378,2003-12-31,3482,6700,10182
41,41378,2004-12-31,3561,6772,10333
41,41378,2005-12-31,3653,6866,10519
41,41378,2006-12-31,3747,6978,10725
41,41378,2007-12-31,3846,7062,10908
41,41378,2008-12-31,3930,7152,11082
41,41378,2009-12-31,4012,7237,11249
41,41378,2010-12-31,4104,7338,11442
41,41378,2011-12-31,4199,7420,11619
41,41378,2012-12-31,4287,7489,11776
41,41378,2013-12-31,4391,7551,11942
41,41378,2014-12-31,4432,7641,12073
41,41378,2015-12-31,4490,7733,12223
41,41378,2016-12-31,4596,7847,12443
41,41378,2017-12-31,4727,7980,12707
41,41378,2018-12-31,4796,8070,12866
41,41378,2019-12-31,4891,8130,13021
41,41378,2020-12-31,4966,8196,13162
41,41378,2021-12-31,4972,8300,13272
41,41378,2022-12-31,4977,8401,13378
41,41378,2023-12-31,4980,8500,13480
41,41378,2024-12-31,4996,8600,13596
41,41378,2025-12-31,5026,8692,13718
41,41378,2026-12-31,5042,8782,13824
41,41378,2027-12-31,5073,8870,13943
41,41378,2028-12-31,5091,8953,14044
41,41378,2029-12-31,5104,9050,14154
41,41378,2030-12-31,5137,9126,14263
41,41378,2031-12-31,5153,9203,14356
41,41378,2032-12-31,5172,9278,14450
41,41378,2033-12-31,5199,9360,14559
41,41378,2034-12-31,5205,9439,14644
41,41378,2035-12-31,5212,9513,14725
41,41396,1985-12-31,12883,23842,36725
41,41396,1986-12-31,13607,23485,37092
41,41396,1987-12-31,14262,23239,37501
41,41396,1988-12-31,14879,23162,38041
41,41396,1989-12-31,15419,23222,38641
41,41396,1990-12-31,15935,23362,39297
41,41396,1991-12-31,16409,23572,39981
41,41396,1992-12-31,16870,23872,40742
41,41396,1993-12-31,17301,24196,41497
41,41396,1994-12-31,17727,24563,42290
41,41396,1995-12-31,18130,24994,43124
41,41396,1996-12-31,18516,25398,43914
41,41396,1997-12-31,18913,25825,44738
41,41396,1998-12-31,19281,26277,45558
41,41396,1999-12-31,19639,26719,46358
41,41396,2000-12-31,20017,27172,47189
41,41396,2001-12-31,20314,27615,47929
41,41396,2002-12-31,20653,28058,48711
41,41396,2003-12-31,20998,28492,49490
41,41396,2004-12-31,21327,28928,50255
41,41396,2005-12-31,21636,29361,50997
41,41396,2006-12-31,21934,29786,51720
41,41396,2007-12-31,22262,30221,52483
41,41396,2008-12-31,22569,30673,53242
41,41396,2009-12-31,22910,31127,54037
41,41396,2010-12-31,23237,31566,54803
41,41396,2011-12-31,23537,31995,55532
41,41396,2012-12-31,23863,32435,56298
41,41396,2013-12-31,24176,32886,57062
41,41396,2014-12-31,24501,33337,57838
41,41396,2015-12-31,24823,33794,58617
41,41396,2016-12-31,25127,34250,59377
41,41396,2017-12-31,25514,34718,60232
41,41396,2018-12-31,25791,35235,61026
41,41396,2019-12-31,25995,35740,61735
41,41396,2020-12-31,26183,36197,62380
41,41396,2021-12-31,26247,36657,62904
41,41396,2022-12-31,26300,37104,63404
41,41396,2023-12-31,26348,37538,63886
41,41396,2024-12-31,26451,37951,64402
41,41396,2025-12-31,26549,38380,64929
41,41396,2026-12-31,26670,38789,65459
41,41396,2027-12-31,26803,39177,65980
41,41396,2028-12-31,26914,39558,66472
41,41396,2029-12-31,27033,39927,66960
41,41396,2030-12-31,27159,40285,67444
41,41396,2031-12-31,27267,40655,67922
41,41396,2032-12-31,27367,41001,68368
41,41396,2033-12-31,27445,41352,68797
41,41396,2034-12-31,27535,41690,69225
41,41396,2035-12-31,27597,42018,69615
41,41483,1985-12-31,1382,3261,4643
41,41483,1986-12-31,1463,3164,4627
41,41483,1987-12-31,1495,3159,4654
41,41483,1988-12-31,1568,3110,4678
41,41483,1989-12-31,1633,3089,4722
41,41483,1990-12-31,1673,3078,4751
41,41483,1991-12-31,1728,3068,4796
41,41483,1992-12-31,1776,3086,4862
41,41483,1993-12-31,1824,3101,4925
41,41483,1994-12-31,1866,3129,4995
41,41483,1995-12-31,1907,3159,5066
41,41483,1996-12-31,1963,3189,5152
41,41483,1997-12-31,1973,3240,5213
41,41483,1998-12-31,2009,3261,5270
41,41483,1999-12-31,2055,3266,5321
41,41483,2000-12-31,2098,3283,5381
41,41483,2001-12-31,2139,3308,5447
41,41483,2002-12-31,2175,3340,5515
41,41483,2003-12-31,2202,3372,5574
41,41483,2004-12-31,2220,3409,5629
41,41483,2005-12-31,2232,3443,5675
41,41483,2006-12-31,2256,3472,5728
41,41483,2007-12-31,2297,3507,5804
41,41483,2008-12-31,2329,3506,5835
41,41483,2009-12-31,2358,3519,5877
41,41483,2010-12-31,2366,3551,5917
41,41483,2011-12-31,2406,3614,6020
41,41483,2012-12-31,2408,3644,6052
41,41483,2013-12-31,2428,3678,6106
41,41483,2014-12-31,2476,3695,6171
41,41483,2015-12-31,2523,3728,6251
41,41483,2016-12-31,2569,3749,6318
41,41483,2017-12-31,2610,3783,6393
41,41483,2018-12-31,2648,3821,6469
41,41483,2019-12-31,2669,3851,6520
41,41483,2020-12-31,2688,3885,6573
41,41483,2021-12-31,2693,3934,6627
41,41483,2022-12-31,2698,3982,6680
41,41483,2023-12-31,2701,4029,6730
41,41483,2024-12-31,2710,4081,6791
41,41483,2025-12-31,2732,4116,6848
41,41483,2026-12-31,2742,4161,6903
41,41483,2027-12-31,2748,4211,6959
41,41483,2028-12-31,2767,4252,7019
41,41483,2029-12-31,2775,4286,7061
41,41483,2030-12-31,2786,4335,7121
41,41483,2031-12-31,2794,4360,7154
41,41483,2032-12-31,2806,4402,7208
41,41483,2033-12-31,2809,4445,7254
41,41483,2034-12-31,2822,4476,7298
41,41483,2035-12-31,2824,4515,7339
41,41503,1985-12-31,1756,5610,7366
41,41503,1986-12-31,1818,5559,7377
41,41503,1987-12-31,1879,5536,7415
41,41503,1988-12-31,1918,5548,7466
41,41503,1989-12-31,1959,5578,7537
41,41503,1990-12-31,1999,5644,7643
41,41503,1991-12-31,2015,5720,7735
41,41503,1992-12-31,2038,5811,7849
41,41503,1993-12-31,2065,5916,7981
41,41503,1994-12-31,2111,6030,8141
41,41503,1995-12-31,2116,6154,8270
41,41503,1996-12-31,2118,6282,8400
41,41503,1997-12-31,2129,6415,8544
41,41503,1998-12-31,2158,6555,8713
41,41503,1999-12-31,2177,6700,8877
41,41503,2000-12-31,2169,6834,9003
41,41503,2001-12-31,2174,6966,9140
41,41503,2002-12-31,2191,7091,9282
41,41503,2003-12-31,2209,7221,9430
41,41503,2004-12-31,2230,7353,9583
41,41503,2005-12-31,2194,7477,9671
41,41503,2006-12-31,2228,7626,9854
41,41503,2007-12-31,2224,7760,9984
41,41503,2008-12-31,2242,7907,10149
41,41503,2009-12-31,2257,8032,10289
41,41503,2010-12-31,2261,8165,10426
41,41503,2011-12-31,2270,8287,10557
41,41503,2012-12-31,2279,8409,10688
41,41503,2013-12-31,2262,8555,10817
41,41503,2014-12-31,2298,8696,10994
41,41503,2015-12-31,2337,8816,11153
41,41503,2016-12-31,2341,8969,11310
41,41503,2017-12-31,2346,9121,11467
41,41503,2018-12-31,2355,9274,11629
41,41503,2019-12-31,2373,9406,11779
41,41503,2020-12-31,2390,9530,11920
41,41503,2021-12-31,2369,9651,12020
41,41503,2022-12-31,2347,9769,12116
41,41503,2023-12-31,2325,9883,12208
41,41503,2024-12-31,2329,10000,12329
41,41503,2025-12-31,2339,10107,12446
41,41503,2026-12-31,2355,10215,12570
41,41503,2027-12-31,2360,10322,12682
41,41503,2028-12-31,2373,10416,12789
41,41503,2029-12-31,2394,10512,12906
41,41503,2030-12-31,2399,10612,13011
41,41503,2031-12-31,2410,10716,13126
41,41503,2032-12-31,2413,10798,13211
41,41503,2033-12-31,2427,10894,13321
41,41503,2034-12-31,2431,10976,13407
41,41503,2035-12-31,2433,11075,13508
41,41518,1985-12-31,1341,3102,4443
41,41518,1986-12-31,1407,2995,4402
41,41518,1987-12-31,1470,2985,4455
41,41518,1988-12-31,1532,2957,4489
41,41518,1989-12-31,1596,2928,4524
41,41518,1990-12-31,1678,2931,4609
41,41518,1991-12-31,1740,2950,4690
41,41518,1992-12-31,1788,2958,4746
41,41518,1993-12-31,1827,2959,4786
41,41518,1994-12-31,1896,3035,4931
41,41518,1995-12-31,1938,3014,4952
41,41518,1996-12-31,1962,3056,5018
41,41518,1997-12-31,2024,3081,5105
41,41518,1998-12-31,2067,3110,5177
41,41518,1999-12-31,2081,3146,5227
41,41518,2000-12-31,2122,3178,5300
41,41518,2001-12-31,2156,3221,5377
41,41518,2002-12-31,2201,3262,5463
41,41518,2003-12-31,2236,3291,5527
41,41518,2004-12-31,2290,3333,5623
41,41518,2005-12-31,2313,3354,5667
41,41518,2006-12-31,2334,3381,5715
41,41518,2007-12-31,2374,3411,5785
41,41518,2008-12-31,2417,3436,5853
41,41518,2009-12-31,2422,3482,5904
41,41518,2010-12-31,2441,3525,5966
41,41518,2011-12-31,2492,3574,6066
41,41518,2012-12-31,2519,3615,6134
41,41518,2013-12-31,2544,3656,6200
41,41518,2014-12-31,2602,3695,6297
41,41518,2015-12-31,2637,3729,6366
41,41518,2016-12-31,2689,3738,6427
41,41518,2017-12-31,2733,3747,6480
41,41518,2018-12-31,2775,3808,6583
41,41518,2019-12-31,2799,3856,6655
41,41518,2020-12-31,2821,3901,6722
41,41518,2021-12-31,2827,3951,6778
41,41518,2022-12-31,2833,3999,6832
41,41518,2023-12-31,2839,4045,6884
41,41518,2024-12-31,2856,4080,6936
41,41518,2025-12-31,2868,4127,6995
41,41518,2026-12-31,2868,4168,7036
41,41518,2027-12-31,2886,4206,7092
41,41518,2028-12-31,2903,4248,7151
41,41518,2029-12-31,2912,4284,7196
41,41518,2030-12-31,2927,4333,7260
41,41518,2031-12-31,2941,4374,7315
41,41518,2032-12-31,2954,4401,7355
41,41518,2033-12-31,2958,4442,7400
41,41518,2034-12-31,2972,4478,7450
41,41518,2035-12-31,2976,4513,7489
41,41524,1985-12-31,6473,10014,16487
41,41524,1986-12-31,6837,9840,16677
41,41524,1987-12-31,7152,9676,16828
41,41524,1988-12-31,7436,9658,17094
41,41524,1989-12-31,7689,9639,17328
41,41524,1990-12-31,7932,9669,17601
41,41524,1991-12-31,8150,9738,17888
41,41524,1992-12-31,8359,9826,18185
41,41524,1993-12-31,8563,9936,18499
41,41524,1994-12-31,8767,10069,18836
41,41524,1995-12-31,8954,10202,19156
41,41524,1996-12-31,9154,10363,19517
41,41524,1997-12-31,9315,10507,19822
41,41524,1998-12-31,9486,10666,20152
41,41524,1999-12-31,9648,10827,20475
41,41524,2000-12-31,9818,10981,20799
41,41524,2001-12-31,9970,11130,21100
41,41524,2002-12-31,10129,11278,21407
41,41524,2003-12-31,10291,11442,21733
41,41524,2004-12-31,10422,11592,22014
41,41524,2005-12-31,10579,11741,22320
41,41524,2006-12-31,10733,11893,22626
41,41524,2007-12-31,10856,12037,22893
41,41524,2008-12-31,11006,12193,23199
41,41524,2009-12-31,11153,12355,23508
41,41524,2010-12-31,11311,12511,23822
41,41524,2011-12-31,11459,12676,24135
41,41524,2012-12-31,11580,12816,24396
41,41524,2013-12-31,11762,13012,24774
41,41524,2014-12-31,11882,13180,25062
41,41524,2015-12-31,12065,13280,25345
41,41524,2016-12-31,12238,13407,25645
41,41524,2017-12-31,12315,13631,25946
41,41524,2018-12-31,12475,13804,26279
41,41524,2019-12-31,12604,13986,26590
41,41524,2020-12-31,12726,14155,26881
41,41524,2021-12-31,12772,14335,27107
41,41524,2022-12-31,12812,14510,27322
41,41524,2023-12-31,12851,14679,27530
41,41524,2024-12-31,12891,14845,27736
41,41524,2025-12-31,12957,15011,27968
41,41524,2026-12-31,13015,15163,28178
41,41524,2027-12-31,13080,15320,28400
41,41524,2028-12-31,13151,15472,28623
41,41524,2029-12-31,13194,15611,28805
41,41524,2030-12-31,13253,15757,29010
41,41524,2031-12-31,13303,15900,29203
41,41524,2032-12-31,13349,16031,29380
41,41524,2033-12-31,13397,16175,29572
41,41524,2034-12-31,13430,16309,29739
41,41524,2035-12-31,13469,16435,29904
41,41530,1985-12-31,763,5877,6640
41,41530,1986-12-31,828,5815,6643
41,41530,1987-12-31,901,5796,6697
41,41530,1988-12-31,931,5791,6722
41,41530,1989-12-31,975,5827,6802
41,41530,1990-12-31,1012,5885,6897
41,41530,1991-12-31,1041,5960,7001
41,41530,1992-12-31,1074,6047,7121
41,41530,1993-12-31,1103,6151,7254
41,41530,1994-12-31,1139,6247,7386
41,41530,1995-12-31,1174,6369,7543
41,41530,1996-12-31,1200,6507,7707
41,41530,1997-12-31,1235,6637,7872
41,41530,1998-12-31,1246,6763,8009
41,41530,1999-12-31,1275,6885,8160
41,41530,2000-12-31,1303,7008,8311
41,41530,2001-12-31,1324,7146,8470
41,41530,2002-12-31,1354,7281,8635
41,41530,2003-12-31,1379,7416,8795
41,41530,2004-12-31,1410,7542,8952
41,41530,2005-12-31,1429,7613,9042
41,41530,2006-12-31,1483,7753,9236
41,41530,2007-12-31,1492,7913,9405
41,41530,2008-12-31,1508,8056,9564
41,41530,2009-12-31,1497,8194,9691
41,41530,2010-12-31,1535,8325,9860
41,41530,2011-12-31,1566,8438,10004
41,41530,2012-12-31,1582,8593,10175
41,41530,2013-12-31,1608,8702,10310
41,41530,2014-12-31,1637,8816,10453
41,41530,2015-12-31,1706,8936,10642
41,41530,2016-12-31,1730,9073,10803
41,41530,2017-12-31,1738,9289,11027
41,41530,2018-12-31,1755,9404,11159
41,41530,2019-12-31,1772,9510,11282
41,41530,2020-12-31,1789,9606,11395
41,41530,2021-12-31,1763,9728,11491
41,41530,2022-12-31,1735,9847,11582
41,41530,2023-12-31,1708,9962,11670
41,41530,2024-12-31,1715,10075,11790
41,41530,2025-12-31,1722,10181,11903
41,41530,2026-12-31,1729,10297,12026
41,41530,2027-12-31,1731,10398,12129
41,41530,2028-12-31,1742,10493,12235
41,41530,2029-12-31,1752,10600,12352
41,41530,2030-12-31,1761,10696,12457
41,41530,2031-12-31,1768,10791,12559
41,41530,2032-12-31,1771,10887,12658
41,41530,2033-12-31,1774,10974,12748
41,41530,2034-12-31,1780,11068,12848
41,41530,2035-12-31,1787,11156,12943
41,41548,1985-12-31,3447,7323,10770
41,41548,1986-12-31,3559,7161,10720
41,41548,1987-12-31,3664,7053,10717
41,41548,1988-12-31,3751,6969,10720
41,41548,1989-12-31,3844,6940,10784
41,41548,1990-12-31,3905,6921,10826
41,41548,1991-12-31,3971,6937,10908
41,41548,1992-12-31,4023,6968,10991
41,41548,1993-12-31,4082,7020,11102
41,41548,1994-12-31,4110,7090,11200
41,41548,1995-12-31,4168,7117,11285
41,41548,1996-12-31,4210,7198,11408
41,41548,1997-12-31,4257,7276,11533
41,41548,1998-12-31,4276,7357,11633
41,41548,1999-12-31,4315,7426,11741
41,41548,2000-12-31,4368,7509,11877
41,41548,2001-12-31,4383,7602,11985
41,41548,2002-12-31,4408,7663,12071
41,41548,2003-12-31,4456,7735,12191
41,41548,2004-12-31,4481,7808,12289
41,41548,2005-12-31,4486,7876,12362
41,41548,2006-12-31,4528,7940,12468
41,41548,2007-12-31,4561,8015,12576
41,41548,2008-12-31,4579,8112,12691
41,41548,2009-12-31,4586,8206,12792
41,41548,2010-12-31,4621,8268,12889
41,41548,2011-12-31,4658,8328,12986
41,41548,2012-12-31,4695,8402,13097
41,41548,2013-12-31,4676,8479,13155
41,41548,2014-12-31,4713,8547,13260
41,41548,2015-12-31,4730,8632,13362
41,41548,2016-12-31,4777,8734,13511
41,41548,2017-12-31,4832,8815,13647
41,41548,2018-12-31,4892,8895,13787
41,41548,2019-12-31,4931,8920,13851
41,41548,2020-12-31,4966,8961,13927
41,41548,2021-12-31,4966,9075,14041
41,41548,2022-12-31,4968,9185,14153
41,41548,2023-12-31,4967,9293,14260
41,41548,2024-12-31,4984,9405,14389
41,41548,2025-12-31,5003,9503,14506
41,41548,2026-12-31,5032,9611,14643
41,41548,2027-12-31,5048,9703,14751
41,41548,2028-12-31,5078,9793,14871
41,41548,2029-12-31,5102,9889,14991
41,41548,2030-12-31,5114,9982,15096
41,41548,2031-12-31,5136,10064,15200
41,41548,2032-12-31,5170,10159,15329
41,41548,2033-12-31,5174,10237,15411
41,41548,2034-12-31,5191,10329,15520
41,41548,2035-12-31,5208,10412,15620
41,41551,1985-12-31,27885,25163,53048
41,41551,1986-12-31,30041,25233,55274
41,41551,1987-12-31,32051,25361,57412
41,41551,1988-12-31,33936,25687,59623
41,41551,1989-12-31,35717,26112,61829
41,41551,1990-12-31,37417,26637,64054
41,41551,1991-12-31,39045,27265,66310
41,41551,1992-12-31,40618,27948,68566
41,41551,1993-12-31,42129,28697,70826
41,41551,1994-12-31,43621,29471,73092
41,41551,1995-12-31,45065,30311,75376
41,41551,1996-12-31,46484,31161,77645
41,41551,1997-12-31,47873,32023,79896
41,41551,1998-12-31,49222,32904,82126
41,41551,1999-12-31,50548,33791,84339
41,41551,2000-12-31,51843,34687,86530
41,41551,2001-12-31,53137,35571,88708
41,41551,2002-12-31,54387,36464,90851
41,41551,2003-12-31,55592,37346,92938
41,41551,2004-12-31,56788,38233,95021
41,41551,2005-12-31,57976,39108,97084
41,41551,2006-12-31,59167,39990,99157
41,41551,2007-12-31,60335,40882,101217
41,41551,2008-12-31,61535,41766,103301
41,41551,2009-12-31,62693,42686,105379
41,41551,2010-12-31,63869,43598,107467
41,41551,2011-12-31,65054,44510,109564
41,41551,2012-12-31,66201,45415,111616
41,41551,2013-12-31,67344,46319,113663
41,41551,2014-12-31,68522,47237,115759
41,41551,2015-12-31,69706,48170,117876
41,41551,2016-12-31,70904,49106,120010
41,41551,2017-12-31,72133,50049,122182
41,41551,2018-12-31,73319,51040,124359
41,41551,2019-12-31,74478,52204,126682
41,41551,2020-12-31,75434,53196,128630
41,41551,2021-12-31,75828,53882,129710
41,41551,2022-12-31,76203,54539,130742
41,41551,2023-12-31,76558,55177,131735
41,41551,2024-12-31,76897,55807,132704
41,41551,2025-12-31,77263,56400,133663
41,41551,2026-12-31,77611,57008,134619
41,41551,2027-12-31,77963,57586,135549
41,41551,2028-12-31,78314,58162,136476
41,41551,2029-12-31,78640,58712,137352
41,41551,2030-12-31,78988,59260,138248
41,41551,2031-12-31,79300,59783,139083
41,41551,2032-12-31,79606,60315,139921
41,41551,2033-12-31,79855,60828,140683
41,41551,2034-12-31,80092,61331,141423
41,41551,2035-12-31,80281,61832,142113
41,41615,1985-12-31,4860,6978,11838
41,41615,1986-12-31,5190,6928,12118
41,41615,1987-12-31,5492,6952,12444
41,41615,1988-12-31,5791,6969,12760
41,41615,1989-12-31,6062,7051,13113
41,41615,1990-12-31,6317,7159,13476
41,41615,1991-12-31,6581,7289,13870
41,41615,1992-12-31,6840,7433,14273
41,41615,1993-12-31,7079,7600,14679
41,41615,1994-12-31,7298,7773,15071
41,41615,1995-12-31,7499,7966,15465
41,41615,1996-12-31,7746,8143,15889
41,41615,1997-12-31,7912,8343,16255
41,41615,1998-12-31,8084,8526,16610
41,41615,1999-12-31,8287,8745,17032
41,41615,2000-12-31,8484,8945,17429
41,41615,2001-12-31,8673,9136,17809
41,41615,2002-12-31,8882,9326,18208
41,41615,2003-12-31,9061,9540,18601
41,41615,2004-12-31,9253,9729,18982
41,41615,2005-12-31,9417,9924,19341
41,41615,2006-12-31,9604,10114,19718
41,41615,2007-12-31,9782,10310,20092
41,41615,2008-12-31,9935,10530,20465
41,41615,2009-12-31,10152,10710,20862
41,41615,2010-12-31,10328,10909,21237
41,41615,2011-12-31,10504,11125,21629
41,41615,2012-12-31,10686,11347,22033
41,41615,2013-12-31,10842,11534,22376
41,41615,2014-12-31,11029,11712,22741
41,41615,2015-12-31,11214,11929,23143
41,41615,2016-12-31,11420,12117,23537
41,41615,2017-12-31,11541,12391,23932
41,41615,2018-12-31,11720,12592,24312
41,41615,2019-12-31,11872,12885,24757
41,41615,2020-12-31,11999,13132,25131
41,41615,2021-12-31,12041,13301,25342
41,41615,2022-12-31,12080,13464,25544
41,41615,2023-12-31,12117,13621,25738
41,41615,2024-12-31,12168,13770,25938
41,41615,2025-12-31,12222,13930,26152
41,41615,2026-12-31,12266,14074,26340
41,41615,2027-12-31,12329,14231,26560
41,41615,2028-12-31,12383,14344,26727
41,41615,2029-12-31,12442,14505,26947
41,41615,2030-12-31,12493,14623,27116
41,41615,2031-12-31,12535,14760,27295
41,41615,2032-12-31,12588,14880,27468
41,41615,2033-12-31,12624,15003,27627
41,41615,2034-12-31,12654,15130,27784
41,41615,2035-12-31,12695,15256,27951
41,41660,1985-12-31,905,7143,8048
41,41660,1986-12-31,947,6989,7936
41,41660,1987-12-31,1045,6843,7888
41,41660,1988-12-31,1104,6765,7869
41,41660,1989-12-31,1144,6726,7870
41,41660,1990-12-31,1176,6715,7891
41,41660,1991-12-31,1194,6748,7942
41,41660,1992-12-31,1226,6766,7992
41,41660,1993-12-31,1255,6813,8068
41,41660,1994-12-31,1262,6858,8120
41,41660,1995-12-31,1303,6933,8236
41,41660,1996-12-31,1329,6997,8326
41,41660,1997-12-31,1354,7065,8419
41,41660,1998-12-31,1389,7145,8534
41,41660,1999-12-31,1391,7223,8614
41,41660,2000-12-31,1418,7293,8711
41,41660,2001-12-31,1447,7374,8821
41,41660,2002-12-31,1472,7438,8910
41,41660,2003-12-31,1506,7507,9013
41,41660,2004-12-31,1525,7572,9097
41,41660,2005-12-31,1541,7644,9185
41,41660,2006-12-31,1557,7697,9254
41,41660,2007-12-31,1579,7787,9366
41,41660,2008-12-31,1608,7872,9480
41,41660,2009-12-31,1629,7936,9565
41,41660,2010-12-31,1645,7998,9643
41,41660,2011-12-31,1656,8064,9720
41,41660,2012-12-31,1678,8150,9828
41,41660,2013-12-31,1710,8207,9917
41,41660,2014-12-31,1735,8261,9996
41,41660,2015-12-31,1784,8352,10136
41,41660,2016-12-31,1825,8444,10269
41,41660,2017-12-31,1832,8521,10353
41,41660,2018-12-31,1844,8600,10444
41,41660,2019-12-31,1865,8637,10502
41,41660,2020-12-31,1885,8682,10567
41,41660,2021-12-31,1862,8792,10654
41,41660,2022-12-31,1839,8899,10738
41,41660,2023-12-31,1816,9004,10820
41,41660,2024-12-31,1812,9108,10920
41,41660,2025-12-31,1828,9201,11029
41,41660,2026-12-31,1834,9308,11142
41,41660,2027-12-31,1849,9393,11242
41,41660,2028-12-31,1848,9495,11343
41,41660,2029-12-31,1862,9580,11442
41,41660,2030-12-31,1870,9677,11547
41,41660,2031-12-31,1882,9749,11631
41,41660,2032-12-31,1884,9845,11729
41,41660,2033-12-31,1888,9922,11810
41,41660,2034-12-31,1894,10007,11901
41,41660,2035-12-31,1907,10092,11999
41,41668,1985-12-31,6295,16038,22333
41,41668,1986-12-31,6606,15756,22362
41,41668,1987-12-31,6875,15527,22402
41,41668,1988-12-31,7130,15430,22560
41,41668,1989-12-31,7346,15410,22756
41,41668,1990-12-31,7552,15451,23003
41,41668,1991-12-31,7744,15551,23295
41,41668,1992-12-31,7912,15699,23611
41,41668,1993-12-31,8070,15868,23938
41,41668,1994-12-31,8235,16057,24292
41,41668,1995-12-31,8386,16291,24677
41,41668,1996-12-31,8530,16511,25041
41,41668,1997-12-31,8671,16747,25418
41,41668,1998-12-31,8812,16997,25809
41,41668,1999-12-31,8945,17238,26183
41,41668,2000-12-31,9075,17481,26556
41,41668,2001-12-31,9189,17722,26911
41,41668,2002-12-31,9308,17966,27274
41,41668,2003-12-31,9426,18209,27635
41,41668,2004-12-31,9544,18440,27984
41,41668,2005-12-31,9660,18675,28335
41,41668,2006-12-31,9783,18903,28686
41,41668,2007-12-31,9886,19132,29018
41,41668,2008-12-31,9998,19373,29371
41,41668,2009-12-31,10112,19623,29735
41,41668,2010-12-31,10246,19851,30097
41,41668,2011-12-31,10332,20109,30441
41,41668,2012-12-31,10479,20341,30820
41,41668,2013-12-31,10556,20580,31136
41,41668,2014-12-31,10691,20823,31514
41,41668,2015-12-31,10839,21078,31917
41,41668,2016-12-31,10991,21342,32333
41,41668,2017-12-31,11019,21566,32585
41,41668,2018-12-31,11158,21870,33028
41,41668,2019-12-31,11246,22145,33391
41,41668,2020-12-31,11327,22400,33727
41,41668,2021-12-31,11325,22685,34010
41,41668,2022-12-31,11320,22961,34281
41,41668,2023-12-31,11311,23230,34541
41,41668,2024-12-31,11353,23490,34843
41,41668,2025-12-31,11403,23761,35164
41,41668,2026-12-31,11466,24011,35477
41,41668,2027-12-31,11513,24257,35770
41,41668,2028-12-31,11559,24494,36053
41,41668,2029-12-31,11612,24730,36342
41,41668,2030-12-31,11657,24950,36607
41,41668,2031-12-31,11702,25167,36869
41,41668,2032-12-31,11744,25407,37151
41,41668,2033-12-31,11786,25609,37395
41,41668,2034-12-31,11809,25824,37633
41,41668,2035-12-31,11856,26029,37885
41,41676,1985-12-31,1865,7267,9132
41,41676,1986-12-31,1941,7065,9006
41,41676,1987-12-31,2002,6910,8912
41,41676,1988-12-31,2045,6808,8853
41,41676,1989-12-31,2075,6746,8821
41,41676,1990-12-31,2105,6701,8806
41,41676,1991-12-31,2134,6693,8827
41,41676,1992-12-31,2184,6699,8883
41,41676,1993-12-31,2206,6729,8935
41,41676,1994-12-31,2210,6750,8960
41,41676,1995-12-31,2224,6794,9018
41,41676,1996-12-31,2225,6839,9064
41,41676,1997-12-31,2236,6886,9122
41,41676,1998-12-31,2258,6936,9194
41,41676,1999-12-31,2297,6991,9288
41,41676,2000-12-31,2327,7031,9358
41,41676,2001-12-31,2352,7091,9443
41,41676,2002-12-31,2342,7146,9488
41,41676,2003-12-31,2338,7185,9523
41,41676,2004-12-31,2344,7229,9573
41,41676,2005-12-31,2354,7271,9625
41,41676,2006-12-31,2381,7316,9697
41,41676,2007-12-31,2414,7376,9790
41,41676,2008-12-31,2403,7431,9834
41,41676,2009-12-31,2425,7444,9869
41,41676,2010-12-31,2420,7498,9918
41,41676,2011-12-31,2424,7553,9977
41,41676,2012-12-31,2431,7584,10015
41,41676,2013-12-31,2464,7612,10076
41,41676,2014-12-31,2461,7657,10118
41,41676,2015-12-31,2473,7702,10175
41,41676,2016-12-31,2495,7788,10283
41,41676,2017-12-31,2507,7837,10344
41,41676,2018-12-31,2527,7878,10405
41,41676,2019-12-31,2525,7897,10422
41,41676,2020-12-31,2529,7933,10462
41,41676,2021-12-31,2514,8034,10548
41,41676,2022-12-31,2500,8132,10632
41,41676,2023-12-31,2485,8227,10712
41,41676,2024-12-31,2494,8323,10817
41,41676,2025-12-31,2506,8410,10916
41,41676,2026-12-31,2520,8492,11012
41,41676,2027-12-31,2528,8586,11114
41,41676,2028-12-31,2541,8671,11212
41,41676,2029-12-31,2548,8750,11298
41,41676,2030-12-31,2561,8834,11395
41,41676,2031-12-31,2573,8911,11484
41,41676,2032-12-31,2582,8989,11571
41,41676,2033-12-31,2587,9066,11653
41,41676,2034-12-31,2600,9137,11737
41,41676,2035-12-31,2602,9209,11811
41,41770,1985-12-31,1930,7177,9107
41,41770,1986-12-31,2076,7252,9328
41,41770,1987-12-31,2195,7392,9587
41,41770,1988-12-31,2326,7544,9870
41,41770,1989-12-31,2432,7748,10180
41,41770,1990-12-31,2521,7978,10499
41,41770,1991-12-31,2608,8245,10853
41,41770,1992-12-31,2713,8503,11216
41,41770,1993-12-31,2804,8796,11600
41,41770,1994-12-31,2876,9092,11968
41,41770,1995-12-31,2944,9432,12376
41,41770,1996-12-31,3022,9740,12762
41,41770,1997-12-31,3111,10074,13185
41,41770,1998-12-31,3192,10414,13606
41,41770,1999-12-31,3268,10753,14021
41,41770,2000-12-31,3337,11097,14434
41,41770,2001-12-31,3395,11441,14836
41,41770,2002-12-31,3456,11784,15240
41,41770,2003-12-31,3530,12115,15645
41,41770,2004-12-31,3585,12448,16033
41,41770,2005-12-31,3660,12797,16457
41,41770,2006-12-31,3720,13114,16834
41,41770,2007-12-31,3782,13457,17239
41,41770,2008-12-31,3853,13797,17650
41,41770,2009-12-31,3882,14153,18035
41,41770,2010-12-31,3971,14503,18474
41,41770,2011-12-31,4062,14833,18895
41,41770,2012-12-31,4137,15188,19325
41,41770,2013-12-31,4190,15542,19732
41,41770,2014-12-31,4235,15895,20130
41,41770,2015-12-31,4295,16205,20500
41,41770,2016-12-31,4364,16586,20950
41,41770,2017-12-31,4437,16949,21386
41,41770,2018-12-31,4507,17346,21853
41,41770,2019-12-31,4555,17787,22342
41,41770,2020-12-31,4596,18133,22729
41,41770,2021-12-31,4553,18367,22920
41,41770,2022-12-31,4511,18591,23102
41,41770,2023-12-31,4470,18808,23278
41,41770,2024-12-31,4490,19010,23500
41,41770,2025-12-31,4502,19223,23725
41,41770,2026-12-31,4521,19423,23944
41,41770,2027-12-31,4543,19627,24170
41,41770,2028-12-31,4566,19824,24390
41,41770,2029-12-31,4586,20006,24592
41,41770,2030-12-31,4607,20190,24797
41,41770,2031-12-31,4625,20367,24992
41,41770,2032-12-31,4638,20543,25181
41,41770,2033-12-31,4661,20722,25383
41,41770,2034-12-31,4666,20890,25556
41,41770,2035-12-31,4681,21057,25738
41,41791,1985-12-31,2920,9677,12597
41,41791,1986-12-31,3045,9449,12494
41,41791,1987-12-31,3174,9286,12460
41,41791,1988-12-31,3302,9190,12492
41,41791,1989-12-31,3401,9140,12541
41,41791,1990-12-31,3531,9141,12672
41,41791,1991-12-31,3631,9162,12793
41,41791,1992-12-31,3730,9213,12943
41,41791,1993-12-31,3824,9278,13102
41,41791,1994-12-31,3914,9358,13272
41,41791,1995-12-31,4001,9461,13462
41,41791,1996-12-31,4076,9567,13643
41,41791,1997-12-31,4153,9666,13819
41,41791,1998-12-31,4219,9772,13991
41,41791,1999-12-31,4283,9882,14165
41,41791,2000-12-31,4351,10008,14359
41,41791,2001-12-31,4432,10115,14547
41,41791,2002-12-31,4487,10214,14701
41,41791,2003-12-31,4558,10319,14877
41,41791,2004-12-31,4627,10425,15052
41,41791,2005-12-31,4678,10547,15225
41,41791,2006-12-31,4736,10646,15382
41,41791,2007-12-31,4773,10748,15521
41,41791,2008-12-31,4841,10844,15685
41,41791,2009-12-31,4933,10936,15869
41,41791,2010-12-31,4933,11049,15982
41,41791,2011-12-31,5021,11185,16206
41,41791,2012-12-31,5118,11279,16397
41,41791,2013-12-31,5189,11363,16552
41,41791,2014-12-31,5235,11475,16710
41,41791,2015-12-31,5293,11583,16876
41,41791,2016-12-31,5338,11677,17015
41,41791,2017-12-31,5423,11820,17243
41,41791,2018-12-31,5499,11941,17440
41,41791,2019-12-31,5542,12045,17587
41,41791,2020-12-31,5582,12147,17729
41,41791,2021-12-31,5573,12301,17874
41,41791,2022-12-31,5565,12451,18016
41,41791,2023-12-31,5556,12597,18153
41,41791,2024-12-31,5579,12743,18322
41,41791,2025-12-31,5599,12881,18480
41,41791,2026-12-31,5621,13023,18644
41,41791,2027-12-31,5659,13151,18810
41,41791,2028-12-31,5676,13276,18952
41,41791,2029-12-31,5700,13421,19121
41,41791,2030-12-31,5729,13529,19258
41,41791,2031-12-31,5755,13648,19403
41,41791,2032-12-31,5772,13773,19545
41,41791,2033-12-31,5795,13892,19687
41,41791,2034-12-31,5808,13991,19799
41,41791,2035-12-31,5814,14099,19913
41,41797,1985-12-31,3325,3902,7227
41,41797,1986-12-31,3438,3810,7248
41,41797,1987-12-31,3565,3813,7378
41,41797,1988-12-31,3679,3772,7451
41,41797,1989-12-31,3781,3775,7556
41,41797,1990-12-31,3866,3769,7635
41,41797,1991-12-31,3937,3807,7744
41,41797,1992-12-31,4030,3847,7877
41,41797,1993-12-31,4107,3898,8005
41,41797,1994-12-31,4148,3925,8073
41,41797,1995-12-31,4201,3970,8171
41,41797,1996-12-31,4271,4033,8304
41,41797,1997-12-31,4316,4086,8402
41,41797,1998-12-31,4411,4155,8566
41,41797,1999-12-31,4490,4212,8702
41,41797,2000-12-31,4501,4293,8794
41,41797,2001-12-31,4546,4348,8894
41,41797,2002-12-31,4599,4380,8979
41,41797,2003-12-31,4652,4454,9106
41,41797,2004-12-31,4694,4507,9201
41,41797,2005-12-31,4745,4559,9304
41,41797,2006-12-31,4787,4639,9426
41,41797,2007-12-31,4827,4702,9529
41,41797,2008-12-31,4863,4739,9602
41,41797,2009-12-31,4901,4793,9694
41,41797,2010-12-31,4962,4858,9820
41,41797,2011-12-31,5016,4919,9935
41,41797,2012-12-31,5098,5007,10105
41,41797,2013-12-31,5141,5060,10201
41,41797,2014-12-31,5151,5144,10295
41,41797,2015-12-31,5142,5222,10364
41,41797,2016-12-31,5197,5260,10457
41,41797,2017-12-31,5250,5284,10534
41,41797,2018-12-31,5317,5380,10697
41,41797,2019-12-31,5364,5451,10815
41,41797,2020-12-31,5409,5514,10923
41,41797,2021-12-31,5431,5584,11015
41,41797,2022-12-31,5450,5652,11102
41,41797,2023-12-31,5469,5718,11187
41,41797,2024-12-31,5498,5786,11284
41,41797,2025-12-31,5514,5847,11361
41,41797,2026-12-31,5548,5903,11451
41,41797,2027-12-31,5570,5970,11540
41,41797,2028-12-31,5593,6031,11624
41,41797,2029-12-31,5622,6086,11708
41,41797,2030-12-31,5639,6140,11779
41,41797,2031-12-31,5664,6208,11872
41,41797,2032-12-31,5684,6246,11930
41,41797,2033-12-31,5703,6296,11999
41,41797,2034-12-31,5729,6356,12085
41,41797,2035-12-31,5739,6397,12136
41,41799,1985-12-31,3461,8018,11479
41,41799,1986-12-31,3566,7746,11312
41,41799,1987-12-31,3681,7520,11201
41,41799,1988-12-31,3791,7337,11128
41,41799,1989-12-31,3898,7210,11108
41,41799,1990-12-31,3973,7119,11092
41,41799,1991-12-31,4045,7056,11101
41,41799,1992-12-31,4105,7000,11105
41,41799,1993-12-31,4169,6952,11121
41,41799,1994-12-31,4222,6941,11163
41,41799,1995-12-31,4284,6938,11222
41,41799,1996-12-31,4332,6919,11251
41,41799,1997-12-31,4375,6908,11283
41,41799,1998-12-31,4419,6890,11309
41,41799,1999-12-31,4453,6888,11341
41,41799,2000-12-31,4507,6885,11392
41,41799,2001-12-31,4539,6880,11419
41,41799,2002-12-31,4593,6855,11448
41,41799,2003-12-31,4631,6831,11462
41,41799,2004-12-31,4671,6821,11492
41,41799,2005-12-31,4690,6807,11497
41,41799,2006-12-31,4744,6798,11542
41,41799,2007-12-31,4778,6784,11562
41,41799,2008-12-31,4802,6780,11582
41,41799,2009-12-31,4847,6748,11595
41,41799,2010-12-31,4888,6734,11622
41,41799,2011-12-31,4919,6708,11627
41,41799,2012-12-31,4942,6688,11630
41,41799,2013-12-31,4990,6662,11652
41,41799,2014-12-31,5018,6673,11691
41,41799,2015-12-31,5027,6653,11680
41,41799,2016-12-31,5096,6684,11780
41,41799,2017-12-31,5136,6669,11805
41,41799,2018-12-31,5173,6627,11800
41,41799,2019-12-31,5214,6561,11775
41,41799,2020-12-31,5251,6549,11800
41,41799,2021-12-31,5265,6632,11897
41,41799,2022-12-31,5278,6713,11991
41,41799,2023-12-31,5290,6792,12082
41,41799,2024-12-31,5311,6875,12186
41,41799,2025-12-31,5337,6951,12288
41,41799,2026-12-31,5356,7017,12373
41,41799,2027-12-31,5383,7098,12481
41,41799,2028-12-31,5402,7152,12554
41,41799,2029-12-31,5434,7218,12652
41,41799,2030-12-31,5451,7287,12738
41,41799,2031-12-31,5480,7347,12827
41,41799,2032-12-31,5496,7424,12920
41,41799,2033-12-31,5515,7472,12987
41,41799,2034-12-31,5529,7545,13074
41,41799,2035-12-31,5545,7612,13157
41,41801,1985-12-31,2741,4062,6803
41,41801,1986-12-31,2889,3904,6793
41,41801,1987-12-31,2956,3838,6794
41,41801,1988-12-31,3043,3770,6813
41,41801,1989-12-31,3124,3708,6832
41,41801,1990-12-31,3193,3665,6858
41,41801,1991-12-31,3249,3637,6886
41,41801,1992-12-31,3300,3627,6927
41,41801,1993-12-31,3338,3619,6957
41,41801,1994-12-31,3404,3622,7026
41,41801,1995-12-31,3454,3630,7084
41,41801,1996-12-31,3501,3636,7137
41,41801,1997-12-31,3541,3647,7188
41,41801,1998-12-31,3587,3662,7249
41,41801,1999-12-31,3639,3688,7327
41,41801,2000-12-31,3669,3676,7345
41,41801,2001-12-31,3718,3689,7407
41,41801,2002-12-31,3759,3686,7445
41,41801,2003-12-31,3774,3699,7473
41,41801,2004-12-31,3787,3706,7493
41,41801,2005-12-31,3809,3680,7489
41,41801,2006-12-31,3887,3725,7612
41,41801,2007-12-31,3891,3691,7582
41,41801,2008-12-31,3930,3692,7622
41,41801,2009-12-31,3958,3702,7660
41,41801,2010-12-31,3997,3733,7730
41,41801,2011-12-31,4039,3746,7785
41,41801,2012-12-31,4085,3762,7847
41,41801,2013-12-31,4126,3779,7905
41,41801,2014-12-31,4104,3783,7887
41,41801,2015-12-31,4141,3795,7936
41,41801,2016-12-31,4176,3782,7958
41,41801,2017-12-31,4219,3749,7968
41,41801,2018-12-31,4270,3782,8052
41,41801,2019-12-31,4281,3783,8064
41,41801,2020-12-31,4297,3797,8094
41,41801,2021-12-31,4315,3845,8160
41,41801,2022-12-31,4333,3892,8225
41,41801,2023-12-31,4350,3938,8288
41,41801,2024-12-31,4366,3982,8348
41,41801,2025-12-31,4395,4029,8424
41,41801,2026-12-31,4406,4062,8468
41,41801,2027-12-31,4427,4104,8531
41,41801,2028-12-31,4449,4156,8605
41,41801,2029-12-31,4468,4192,8660
41,41801,2030-12-31,4487,4235,8722
41,41801,2031-12-31,4505,4261,8766
41,41801,2032-12-31,4523,4293,8816
41,41801,2033-12-31,4538,4345,8883
41,41801,2034-12-31,4548,4374,8922
41,41801,2035-12-31,4558,4398,8956
41,41807,1985-12-31,5297,11176,16473
41,41807,1986-12-31,5500,10920,16420
41,41807,1987-12-31,5693,10746,16439
41,41807,1988-12-31,5848,10635,16483
41,41807,1989-12-31,5989,10601,16590
41,41807,1990-12-31,6101,10587,16688
41,41807,1991-12-31,6214,10622,16836
41,41807,1992-12-31,6316,10681,16997
41,41807,1993-12-31,6402,10768,17170
41,41807,1994-12-31,6478,10868,17346
41,41807,1995-12-31,6572,10979,17551
41,41807,1996-12-31,6625,11108,17733
41,41807,1997-12-31,6682,11227,17909
41,41807,1998-12-31,6761,11351,18112
41,41807,1999-12-31,6797,11499,18296
41,41807,2000-12-31,6873,11598,18471
41,41807,2001-12-31,6936,11737,18673
41,41807,2002-12-31,7001,11854,18855
41,41807,2003-12-31,7044,11982,19026
41,41807,2004-12-31,7121,12110,19231
41,41807,2005-12-31,7162,12234,19396
41,41807,2006-12-31,7210,12354,19564
41,41807,2007-12-31,7268,12483,19751
41,41807,2008-12-31,7340,12617,19957
41,41807,2009-12-31,7351,12729,20080
41,41807,2010-12-31,7422,12857,20279
41,41807,2011-12-31,7478,12996,20474
41,41807,2012-12-31,7524,13104,20628
41,41807,2013-12-31,7611,13227,20838
41,41807,2014-12-31,7658,13368,21026
41,41807,2015-12-31,7704,13476,21180
41,41807,2016-12-31,7721,13586,21307
41,41807,2017-12-31,7777,13786,21563
41,41807,2018-12-31,7883,13916,21799
41,41807,2019-12-31,7846,14075,21921
41,41807,2020-12-31,7817,14253,22070
41,41807,2021-12-31,7817,14434,22251
41,41807,2022-12-31,7818,14610,22428
41,41807,2023-12-31,7817,14781,22598
41,41807,2024-12-31,7844,14947,22791
41,41807,2025-12-31,7877,15111,22988
41,41807,2026-12-31,7916,15270,23186
41,41807,2027-12-31,7950,15429,23379
41,41807,2028-12-31,7982,15576,23558
41,41807,2029-12-31,8017,15732,23749
41,41807,2030-12-31,8065,15865,23930
41,41807,2031-12-31,8084,16010,24094
41,41807,2032-12-31,8117,16159,24276
41,41807,2033-12-31,8150,16294,24444
41,41807,2034-12-31,8169,16424,24593
41,41807,2035-12-31,8188,16572,24760
41,41872,1985-12-31,2526,4769,7295
41,41872,1986-12-31,2553,4621,7174
41,41872,1987-12-31,2613,4535,7148
41,41872,1988-12-31,2637,4457,7094
41,41872,1989-12-31,2661,4390,7051
41,41872,1990-12-31,2692,4386,7078
41,41872,1991-12-31,2683,4323,7006
41,41872,1992-12-31,2681,4341,7022
41,41872,1993-12-31,2707,4348,7055
41,41872,1994-12-31,2681,4373,7054
41,41872,1995-12-31,2701,4343,7044
41,41872,1996-12-31,2701,4364,7065
41,41872,1997-12-31,2702,4386,7088
41,41872,1998-12-31,2687,4432,7119
41,41872,1999-12-31,2675,4430,7105
41,41872,2000-12-31,2646,4444,7090
41,41872,2001-12-31,2640,4466,7106
41,41872,2002-12-31,2615,4497,7112
41,41872,2003-12-31,2608,4537,7145
41,41872,2004-12-31,2580,4535,7115
41,41872,2005-12-31,2572,4585,7157
41,41872,2006-12-31,2572,4598,7170
41,41872,2007-12-31,2570,4618,7188
41,41872,2008-12-31,2553,4622,7175
41,41872,2009-12-31,2529,4644,7173
41,41872,2010-12-31,2504,4651,7155
41,41872,2011-12-31,2481,4662,7143
41,41872,2012-12-31,2463,4666,7129
41,41872,2013-12-31,2477,4719,7196
41,41872,2014-12-31,2484,4760,7244
41,41872,2015-12-31,2471,4813,7284
41,41872,2016-12-31,2409,4835,7244
41,41872,2017-12-31,2433,4778,7211
41,41872,2018-12-31,2459,4829,7288
41,41872,2019-12-31,2418,4829,7247
41,41872,2020-12-31,2393,4847,7240
41,41872,2021-12-31,2390,4909,7299
41,41872,2022-12-31,2389,4968,7357
41,41872,2023-12-31,2386,5027,7413
41,41872,2024-12-31,2389,5091,7480
41,41872,2025-12-31,2399,5142,7541
41,41872,2026-12-31,2421,5200,7621
41,41872,2027-12-31,2428,5251,7679
41,41872,2028-12-31,2434,5294,7728
41,41872,2029-12-31,2448,5347,7795
41,41872,2030-12-31,2453,5397,7850
41,41872,2031-12-31,2472,5443,7915
41,41872,2032-12-31,2478,5491,7969
41,41872,2033-12-31,2488,5537,8025
41,41872,2034-12-31,2489,5588,8077
41,41872,2035-12-31,2497,5630,8127
41,41885,1985-12-31,4028,1043,5071
41,41885,1986-12-31,4208,986,5194
41,41885,1987-12-31,4361,1012,5373
41,41885,1988-12-31,4476,1014,5490
41,41885,1989-12-31,4611,1004,5615
41,41885,1990-12-31,4713,992,5705
41,41885,1991-12-31,4808,1001,5809
41,41885,1992-12-31,4896,989,5885
41,41885,1993-12-31,4977,1001,5978
41,41885,1994-12-31,5044,1012,6056
41,41885,1995-12-31,5129,1001,6130
41,41885,1996-12-31,5197,1038,6235
41,41885,1997-12-31,5270,1059,6329
41,41885,1998-12-31,5333,1090,6423
41,41885,1999-12-31,5393,1084,6477
41,41885,2000-12-31,5454,1106,6560
41,41885,2001-12-31,5520,1134,6654
41,41885,2002-12-31,5551,1147,6698
41,41885,2003-12-31,5601,1159,6760
41,41885,2004-12-31,5668,1183,6851
41,41885,2005-12-31,5735,1179,6914
41,41885,2006-12-31,5784,1178,6962
41,41885,2007-12-31,5841,1186,7027
41,41885,2008-12-31,5892,1196,7088
41,41885,2009-12-31,5927,1203,7130
41,41885,2010-12-31,5979,1207,7186
41,41885,2011-12-31,6036,1220,7256
41,41885,2012-12-31,6114,1227,7341
41,41885,2013-12-31,6174,1238,7412
41,41885,2014-12-31,6218,1255,7473
41,41885,2015-12-31,6299,1264,7563
41,41885,2016-12-31,6300,1272,7572
41,41885,2017-12-31,6352,1285,7637
41,41885,2018-12-31,6421,1309,7730
41,41885,2019-12-31,6466,1308,7774
41,41885,2020-12-31,6509,1315,7824
41,41885,2021-12-31,6556,1332,7888
41,41885,2022-12-31,6603,1348,7951
41,41885,2023-12-31,6647,1364,8011
41,41885,2024-12-31,6687,1374,8061
41,41885,2025-12-31,6710,1389,8099
41,41885,2026-12-31,6744,1403,8147
41,41885,2027-12-31,6774,1419,8193
41,41885,2028-12-31,6804,1427,8231
41,41885,2029-12-31,6837,1440,8277
41,41885,2030-12-31,6860,1460,8320
41,41885,2031-12-31,6896,1474,8370
41,41885,2032-12-31,6919,1482,8401
41,41885,2033-12-31,6937,1497,8434
41,41885,2034-12-31,6959,1507,8466
41,41885,2035-12-31,6975,1526,8501
44,44001,1985-12-31,81701,27689,109390
44,44001,1986-12-31,84589,26019,110608
44,44001,1987-12-31,87545,24720,112265
44,44001,1988-12-31,90542,23693,114235
44,44001,1989-12-31,93570,22795,116365
44,44001,1990-12-31,94487,23002,117489
44,44001,1991-12-31,97559,22410,119969
44,44001,1992-12-31,100663,21939,122602
44,44001,1993-12-31,103913,21571,125484
44,44001,1994-12-31,107228,21315,128543
44,44001,1995-12-31,108183,21649,129832
44,44001,1996-12-31,109534,14209,123743
44,44001,1997-12-31,112306,15348,127654
44,44001,1998-12-31,114695,16631,131326
44,44001,1999-12-31,115680,18293,133973
44,44001,2000-12-31,113463,20763,134226
44,44001,2001-12-31,112509,23360,135869
44,44001,2002-12-31,109941,26647,136588
44,44001,2003-12-31,106301,30381,136682
44,44001,2004-12-31,102549,34155,136704
44,44001,2005-12-31,99690,37514,137204
44,44001,2006-12-31,98290,40435,138725
44,44001,2007-12-31,98156,42821,140977
44,44001,2008-12-31,99025,44904,143929
44,44001,2009-12-31,100558,46707,147265
44,44001,2010-12-31,102500,48347,150847
44,44001,2011-12-31,104643,49896,154539
44,44001,2012-12-31,106944,51381,158325
44,44001,2013-12-31,109350,52846,162196
44,44001,2014-12-31,111806,54264,166070
44,44001,2015-12-31,114346,55685,170031
44,44001,2016-12-31,117371,57305,174676
44,44001,2017-12-31,120946,59229,180175
44,44001,2018-12-31,126103,61911,188014
44,44001,2019-12-31,137799,57948,195747
44,44001,2020-12-31,147244,54595,201839
44,44001,2021-12-31,151143,55292,206435
44,44001,2022-12-31,153672,55816,209488
44,44001,2023-12-31,156014,56300,212314
44,44001,2024-12-31,158587,56854,215441
44,44001,2025-12-31,161093,57389,218482
44,44001,2026-12-31,163485,57947,221432
44,44001,2027-12-31,165796,58518,224314
44,44001,2028-12-31,168000,59132,227132
44,44001,2029-12-31,170138,59780,229918
44,44001,2030-12-31,172201,60476,232677
44,44001,2031-12-31,174197,61180,235377
44,44001,2032-12-31,176106,61874,237980
44,44001,2033-12-31,177931,62555,240486
44,44001,2034-12-31,179658,63218,242876
44,44001,2035-12-31,181355,63868,245223
44,44035,1985-12-31,0,0,0
44,44035,1986-12-31,0,0,0
44,44035,1987-12-31,0,0,0
44,44035,1988-12-31,0,0,0
44,44035,1989-12-31,0,0,0
44,44035,1990-12-31,0,0,0
44,44035,1991-12-31,0,0,0
44,44035,1992-12-31,0,0,0
44,44035,1993-12-31,0,0,0
44,44035,1994-12-31,0,0,0
44,44035,1995-12-31,0,0,0
44,44035,1996-12-31,0,0,0
44,44035,1997-12-31,0,0,0
44,44035,1998-12-31,0,0,0
44,44035,1999-12-31,0,0,0
44,44035,2000-12-31,9476,6209,15685
44,44035,2001-12-31,9726,6762,16488
44,44035,2002-12-31,9844,7458,17302
44,44035,2003-12-31,9842,8310,18152
44,44035,2004-12-31,9791,9077,18868
44,44035,2005-12-31,9781,9736,19517
44,44035,2006-12-31,9899,10273,20172
44,44035,2007-12-31,10131,10684,20815
44,44035,2008-12-31,10444,10988,21432
44,44035,2009-12-31,10841,11244,22085
44,44035,2010-12-31,11273,11452,22725
44,44035,2011-12-31,11724,11664,23388
44,44035,2012-12-31,12205,11855,24060
44,44035,2013-12-31,12693,12040,24733
44,44035,2014-12-31,13188,12221,25409
44,44035,2015-12-31,13703,12362,26065
44,44035,2016-12-31,14291,12583,26874
44,44035,2017-12-31,14922,12877,27799
44,44035,2018-12-31,15783,13365,29148
44,44035,2019-12-31,17402,13446,30848
44,44035,2020-12-31,18836,13429,32265
44,44035,2021-12-31,19405,13601,33006
44,44035,2022-12-31,19765,13729,33494
44,44035,2023-12-31,20098,13848,33946
44,44035,2024-12-31,20438,13981,34419
44,44035,2025-12-31,20749,14118,34867
44,44035,2026-12-31,21063,14239,35302
44,44035,2027-12-31,21363,14375,35738
44,44035,2028-12-31,21641,14541,36182
44,44035,2029-12-31,21920,14702,36622
44,44035,2030-12-31,22181,14863,37044
44,44035,2031-12-31,22431,15041,37472
44,44035,2032-12-31,22673,15205,37878
44,44035,2033-12-31,22907,15374,38281
44,44035,2034-12-31,23142,15544,38686
44,44035,2035-12-31,23342,15704,39046
44,44078,1985-12-31,10223,11943,22166
44,44078,1986-12-31,10574,11653,22227
44,44078,1987-12-31,10945,11460,22405
44,44078,1988-12-31,11321,11341,22662
44,44078,1989-12-31,11701,11286,22987
44,44078,1990-12-31,11822,11714,23536
44,44078,1991-12-31,12197,11710,23907
44,44078,1992-12-31,12603,11750,24353
44,44078,1993-12-31,13004,11819,24823
44,44078,1994-12-31,13408,11964,25372
44,44078,1995-12-31,13534,5006,18540
44,44078,1996-12-31,13687,5384,19071
44,44078,1997-12-31,14040,5703,19743
44,44078,1998-12-31,14338,6070,20408
44,44078,1999-12-31,14477,6557,21034
44,44078,2000-12-31,14196,7364,21560
44,44078,2001-12-31,14084,8197,22281
44,44078,2002-12-31,13761,9250,23011
44,44078,2003-12-31,13300,10455,23755
44,44078,2004-12-31,12835,11657,24492
44,44078,2005-12-31,12477,12726,25203
44,44078,2006-12-31,12293,13627,25920
44,44078,2007-12-31,12271,14348,26619
44,44078,2008-12-31,12391,14955,27346
44,44078,2009-12-31,12592,15484,28076
44,44078,2010-12-31,12833,15971,28804
44,44078,2011-12-31,13110,16409,29519
44,44078,2012-12-31,13395,16830,30225
44,44078,2013-12-31,13705,17244,30949
44,44078,2014-12-31,14018,17679,31697
44,44078,2015-12-31,14346,18044,32390
44,44078,2016-12-31,14718,18557,33275
44,44078,2017-12-31,15160,19095,34255
44,44078,2018-12-31,15818,19925,35743
44,44078,2019-12-31,17285,19885,37170
44,44078,2020-12-31,18469,19879,38348
44,44078,2021-12-31,19087,20134,39221
44,44078,2022-12-31,19478,20323,39801
44,44078,2023-12-31,19838,20500,40338
44,44078,2024-12-31,20177,20684,40861
44,44078,2025-12-31,20492,20865,41357
44,44078,2026-12-31,20814,21060,41874
44,44078,2027-12-31,21107,21297,42404
44,44078,2028-12-31,21396,21501,42897
44,44078,2029-12-31,21661,21733,43394
44,44078,2030-12-31,21917,21977,43894
44,44078,2031-12-31,22180,22227,44407
44,44078,2032-12-31,22427,22496,44923
44,44078,2033-12-31,22661,22748,45409
44,44078,2034-12-31,22897,22997,45894
44,44078,2035-12-31,23104,23225,46329
44,44090,1985-12-31,0,0,0
44,44090,1986-12-31,0,0,0
44,44090,1987-12-31,0,0,0
44,44090,1988-12-31,0,0,0
44,44090,1989-12-31,0,0,0
44,44090,1990-12-31,0,0,0
44,44090,1991-12-31,0,0,0
44,44090,1992-12-31,0,0,0
44,44090,1993-12-31,0,0,0
44,44090,1994-12-31,0,0,0
44,44090,1995-12-31,0,0,0
44,44090,1996-12-31,1258,8279,9537
44,44090,1997-12-31,1484,8831,10315
44,44090,1998-12-31,1699,9458,11157
44,44090,1999-12-31,1914,10324,12238
44,44090,2000-12-31,2057,11628,13685
44,44090,2001-12-31,2211,13015,15226
44,44090,2002-12-31,2353,14760,17113
44,44090,2003-12-31,2428,16741,19169
44,44090,2004-12-31,2456,18735,21191
44,44090,2005-12-31,2537,20491,23028
44,44090,2006-12-31,2616,21995,24611
44,44090,2007-12-31,2768,23239,26007
44,44090,2008-12-31,2879,24276,27155
44,44090,2009-12-31,3053,25194,28247
44,44090,2010-12-31,3219,26028,29247
44,44090,2011-12-31,3405,26793,30198
44,44090,2012-12-31,3592,27535,31127
44,44090,2013-12-31,3758,28263,32021
44,44090,2014-12-31,3964,28978,32942
44,44090,2015-12-31,4172,29657,33829
44,44090,2016-12-31,4351,30505,34856
44,44090,2017-12-31,4569,31468,36037
44,44090,2018-12-31,4884,32856,37740
44,44090,2019-12-31,5373,34678,40051
44,44090,2020-12-31,5796,36264,42060
44,44090,2021-12-31,6290,36736,43026
44,44090,2022-12-31,6581,37082,43663
44,44090,2023-12-31,6847,37404,44251
44,44090,2024-12-31,6989,37729,44718
44,44090,2025-12-31,7108,38069,45177
44,44090,2026-12-31,7226,38436,45662
44,44090,2027-12-31,7318,38817,46135
44,44090,2028-12-31,7420,39211,46631
44,44090,2029-12-31,7513,39667,47180
44,44090,2030-12-31,7605,40116,47721
44,44090,2031-12-31,7687,40581,48268
44,44090,2032-12-31,7778,41038,48816
44,44090,2033-12-31,7857,41485,49342
44,44090,2034-12-31,7947,41936,49883
44,44090,2035-12-31,8018,42378,50396
44,44098,1985-12-31,0,0,0
44,44098,1986-12-31,0,0,0
44,44098,1987-12-31,0,0,0
44,44098,1988-12-31,0,0,0
44,44098,1989-12-31,0,0,0
44,44098,1990-12-31,0,0,0
44,44098,1991-12-31,0,0,0
44,44098,1992-12-31,0,0,0
44,44098,1993-12-31,0,0,0
44,44098,1994-12-31,0,0,0
44,44098,1995-12-31,0,0,0
44,44098,1996-12-31,4602,5006,9608
44,44098,1997-12-31,4759,4905,9664
44,44098,1998-12-31,4900,4858,9758
44,44098,1999-12-31,4983,4921,9904
44,44098,2000-12-31,4885,5193,10078
44,44098,2001-12-31,4893,5456,10349
44,44098,2002-12-31,4803,5832,10635
44,44098,2003-12-31,4659,6270,10929
44,44098,2004-12-31,4549,6670,11219
44,44098,2005-12-31,4427,6970,11397
44,44098,2006-12-31,4386,7144,11530
44,44098,2007-12-31,4400,7233,11633
44,44098,2008-12-31,4446,7256,11702
44,44098,2009-12-31,4537,7252,11789
44,44098,2010-12-31,4644,7223,11867
44,44098,2011-12-31,4747,7178,11925
44,44098,2012-12-31,4878,7115,11993
44,44098,2013-12-31,5002,7057,12059
44,44098,2014-12-31,5135,7006,12141
44,44098,2015-12-31,5276,7022,12298
44,44098,2016-12-31,5432,6981,12413
44,44098,2017-12-31,5614,7029,12643
44,44098,2018-12-31,5871,7145,13016
44,44098,2019-12-31,6452,7254,13706
44,44098,2020-12-31,6947,7301,14248
44,44098,2021-12-31,7177,7395,14572
44,44098,2022-12-31,7324,7464,14788
44,44098,2023-12-31,7458,7529,14987
44,44098,2024-12-31,7588,7599,15187
44,44098,2025-12-31,7699,7670,15369
44,44098,2026-12-31,7814,7745,15559
44,44098,2027-12-31,7928,7829,15757
44,44098,2028-12-31,8031,7913,15944
44,44098,2029-12-31,8125,7989,16114
44,44098,2030-12-31,8238,8080,16318
44,44098,2031-12-31,8322,8187,16509
44,44098,2032-12-31,8418,8271,16689
44,44098,2033-12-31,8508,8369,16877
44,44098,2034-12-31,8576,8455,17031
44,44098,2035-12-31,8664,8539,17203
44,44110,1985-12-31,0,0,0
44,44110,1986-12-31,0,0,0
44,44110,1987-12-31,0,0,0
44,44110,1988-12-31,0,0,0
44,44110,1989-12-31,0,0,0
44,44110,1990-12-31,7125,758,7883
44,44110,1991-12-31,7195,723,7918
44,44110,1992-12-31,7267,704,7971
44,44110,1993-12-31,7396,703,8099
44,44110,1994-12-31,7504,640,8144
44,44110,1995-12-31,7406,673,8079
44,44110,1996-12-31,7364,632,7996
44,44110,1997-12-31,7428,635,8063
44,44110,1998-12-31,7484,587,8071
44,44110,1999-12-31,7427,611,8038
44,44110,2000-12-31,7179,620,7799
44,44110,2001-12-31,7030,682,7712
44,44110,2002-12-31,6760,737,7497
44,44110,2003-12-31,6424,781,7205
44,44110,2004-12-31,6126,813,6939
44,44110,2005-12-31,5884,813,6697
44,44110,2006-12-31,5711,822,6533
44,44110,2007-12-31,5622,866,6488
44,44110,2008-12-31,5597,847,6444
44,44110,2009-12-31,5605,838,6443
44,44110,2010-12-31,5652,821,6473
44,44110,2011-12-31,5707,810,6517
44,44110,2012-12-31,5757,805,6562
44,44110,2013-12-31,5828,811,6639
44,44110,2014-12-31,5890,785,6675
44,44110,2015-12-31,5951,831,6782
44,44110,2016-12-31,6072,817,6889
44,44110,2017-12-31,6190,800,6990
44,44110,2018-12-31,6383,802,7185
44,44110,2019-12-31,6975,599,7574
44,44110,2020-12-31,7453,426,7879
44,44110,2021-12-31,7628,431,8059
44,44110,2022-12-31,7742,436,8178
44,44110,2023-12-31,7849,439,8288
44,44110,2024-12-31,7981,429,8410
44,44110,2025-12-31,8099,447,8546
44,44110,2026-12-31,8233,448,8681
44,44110,2027-12-31,8340,449,8789
44,44110,2028-12-31,8451,454,8905
44,44110,2029-12-31,8569,458,9027
44,44110,2030-12-31,8675,463,9138
44,44110,2031-12-31,8770,471,9241
44,44110,2032-12-31,8873,480,9353
44,44110,2033-12-31,8954,482,9436
44,44110,2034-12-31,9062,489,9551
44,44110,2035-12-31,9135,495,9630
44,44279,1985-12-31,26760,10821,37581
44,44279,1986-12-31,27477,10245,37722
44,44279,1987-12-31,28217,9738,37955
44,44279,1988-12-31,28978,9361,38339
44,44279,1989-12-31,29735,9074,38809
44,44279,1990-12-31,29839,9189,39028
44,44279,1991-12-31,30616,8978,39594
44,44279,1992-12-31,31423,8798,40221
44,44279,1993-12-31,32249,8689,40938
44,44279,1994-12-31,33082,8654,41736
44,44279,1995-12-31,33204,8816,42020
44,44279,1996-12-31,33417,1982,35399
44,44279,1997-12-31,34114,2052,36166
44,44279,1998-12-31,34674,2220,36894
44,44279,1999-12-31,34845,2375,37220
44,44279,2000-12-31,34037,2658,36695
44,44279,2001-12-31,33587,2950,36537
44,44279,2002-12-31,32716,3334,36050
44,44279,2003-12-31,31491,3742,35233
44,44279,2004-12-31,30298,4164,34462
44,44279,2005-12-31,29306,4532,33838
44,44279,2006-12-31,28786,4832,33618
44,44279,2007-12-31,28670,5083,33753
44,44279,2008-12-31,28827,5289,34116
44,44279,2009-12-31,29185,5473,34658
44,44279,2010-12-31,29662,5651,35313
44,44279,2011-12-31,30208,5815,36023
44,44279,2012-12-31,30780,5954,36734
44,44279,2013-12-31,31395,6110,37505
44,44279,2014-12-31,32024,6214,38238
44,44279,2015-12-31,32659,6420,39079
44,44279,2016-12-31,33433,6554,39987
44,44279,2017-12-31,34361,6739,41100
44,44279,2018-12-31,35754,7018,42772
44,44279,2019-12-31,37898,5830,43728
44,44279,2020-12-31,39662,4882,44544
44,44279,2021-12-31,40613,4945,45558
44,44279,2022-12-31,41241,4991,46232
44,44279,2023-12-31,41821,5034,46855
44,44279,2024-12-31,42454,5085,47539
44,44279,2025-12-31,43067,5132,48199
44,44279,2026-12-31,43664,5179,48843
44,44279,2027-12-31,44261,5232,49493
44,44279,2028-12-31,44842,5285,50127
44,44279,2029-12-31,45387,5338,50725
44,44279,2030-12-31,45930,5403,51333
44,44279,2031-12-31,46461,5460,51921
44,44279,2032-12-31,46968,5521,52489
44,44279,2033-12-31,47458,5583,53041
44,44279,2034-12-31,47923,5647,53570
44,44279,2035-12-31,48372,5711,54083
44,44378,1985-12-31,0,0,0
44,44378,1986-12-31,0,0,0
44,44378,1987-12-31,0,0,0
44,44378,1988-12-31,0,0,0
44,44378,1989-12-31,0,0,0
44,44378,1990-12-31,0,0,0
44,44378,1991-12-31,0,0,0
44,44378,1992-12-31,0,0,0
44,44378,1993-12-31,0,0,0
44,44378,1994-12-31,0,0,0
44,44378,1995-12-31,7689,4157,11846
44,44378,1996-12-31,7967,4208,12175
44,44378,1997-12-31,8324,4195,12519
44,44378,1998-12-31,8663,4232,12895
44,44378,1999-12-31,8870,4364,13234
44,44378,2000-12-31,8874,4680,13554
44,44378,2001-12-31,8928,4982,13910
44,44378,2002-12-31,8851,5419,14270
44,44378,2003-12-31,8668,5921,14589
44,44378,2004-12-31,8462,6407,14869
44,44378,2005-12-31,8348,6757,15105
44,44378,2006-12-31,8324,7029,15353
44,44378,2007-12-31,8404,7212,15616
44,44378,2008-12-31,8561,7331,15892
44,44378,2009-12-31,8803,7413,16216
44,44378,2010-12-31,9055,7485,16540
44,44378,2011-12-31,9319,7526,16845
44,44378,2012-12-31,9630,7570,17200
44,44378,2013-12-31,9937,7618,17555
44,44378,2014-12-31,10245,7653,17898
44,44378,2015-12-31,10565,7729,18294
44,44378,2016-12-31,10919,7794,18713
44,44378,2017-12-31,11338,7921,19259
44,44378,2018-12-31,11905,8139,20044
44,44378,2019-12-31,13055,8096,21151
44,44378,2020-12-31,14014,8019,22033
44,44378,2021-12-31,14417,8122,22539
44,44378,2022-12-31,14675,8198,22873
44,44378,2023-12-31,14912,8269,23181
44,44378,2024-12-31,15162,8359,23521
44,44378,2025-12-31,15413,8424,23837
44,44378,2026-12-31,15634,8507,24141
44,44378,2027-12-31,15859,8602,24461
44,44378,2028-12-31,16076,8682,24758
44,44378,2029-12-31,16276,8787,25063
44,44378,2030-12-31,16460,8881,25341
44,44378,2031-12-31,16655,8984,25639
44,44378,2032-12-31,16829,9079,25908
44,44378,2033-12-31,17009,9177,26186
44,44378,2034-12-31,17180,9287,26467
44,44378,2035-12-31,17338,9376,26714
44,44420,1985-12-31,0,0,0
44,44420,1986-12-31,0,0,0
44,44420,1987-12-31,0,0,0
44,44420,1988-12-31,0,0,0
44,44420,1989-12-31,0,0,0
44,44420,1990-12-31,0,0,0
44,44420,1991-12-31,0,0,0
44,44420,1992-12-31,0,0,0
44,44420,1993-12-31,0,0,0
44,44420,1994-12-31,0,0,0
44,44420,1995-12-31,0,0,0
44,44420,1996-12-31,0,0,0
44,44420,1997-12-31,0,0,0
44,44420,1998-12-31,0,0,0
44,44420,1999-12-31,2246,518,2764
44,44420,2000-12-31,2198,575,2773
44,44420,2001-12-31,2172,639,2811
44,44420,2002-12-31,2056,698,2754
44,44420,2003-12-31,1977,767,2744
44,44420,2004-12-31,1876,827,2703
44,44420,2005-12-31,1850,878,2728
44,44420,2006-12-31,1798,947,2745
44,44420,2007-12-31,1781,980,2761
44,44420,2008-12-31,1793,1032,2825
44,44420,2009-12-31,1819,1058,2877
44,44420,2010-12-31,1835,1093,2928
44,44420,2011-12-31,1863,1119,2982
44,44420,2012-12-31,1897,1107,3004
44,44420,2013-12-31,1929,1141,3070
44,44420,2014-12-31,1954,1164,3118
44,44420,2015-12-31,1988,1205,3193
44,44420,2016-12-31,2032,1231,3263
44,44420,2017-12-31,2085,1270,3355
44,44420,2018-12-31,2162,1336,3498
44,44420,2019-12-31,2361,1325,3686
44,44420,2020-12-31,2522,1312,3834
44,44420,2021-12-31,2592,1329,3921
44,44420,2022-12-31,2638,1341,3979
44,44420,2023-12-31,2680,1353,4033
44,44420,2024-12-31,2721,1360,4081
44,44420,2025-12-31,2771,1373,4144
44,44420,2026-12-31,2809,1380,4189
44,44420,2027-12-31,2837,1397,4234
44,44420,2028-12-31,2885,1412,4297
44,44420,2029-12-31,2917,1421,4338
44,44420,2030-12-31,2956,1434,4390
44,44420,2031-12-31,2988,1462,4450
44,44420,2032-12-31,3010,1474,4484
44,44420,2033-12-31,3049,1489,4538
44,44420,2034-12-31,3093,1518,4611
44,44420,2035-12-31,3126,1529,4655
44,44430,1985-12-31,87444,11077,98521
44,44430,1986-12-31,89297,12395,101692
44,44430,1987-12-31,91236,13609,104845
44,44430,1988-12-31,93150,14675,107825
44,44430,1989-12-31,95089,15691,110780
44,44430,1990-12-31,94877,17328,112205
44,44430,1991-12-31,96859,18254,115113
44,44430,1992-12-31,98911,19189,118100
44,44430,1993-12-31,101033,20095,121128
44,44430,1994-12-31,103212,21065,124277
44,44430,1995-12-31,103136,22518,125654
44,44430,1996-12-31,103438,23737,127175
44,44430,1997-12-31,105107,24617,129724
44,44430,1998-12-31,106471,25742,132213
44,44430,1999-12-31,106524,27469,133993
44,44430,2000-12-31,103516,20062,123578
44,44430,2001-12-31,101768,22918,124686
44,44430,2002-12-31,98676,26479,125155
44,44430,2003-12-31,94708,30542,125250
44,44430,2004-12-31,90737,34680,125417
44,44430,2005-12-31,87623,38369,125992
44,44430,2006-12-31,85857,41661,127518
44,44430,2007-12-31,85216,44439,129655
44,44430,2008-12-31,85456,46863,132319
44,44430,2009-12-31,86295,49029,135324
44,44430,2010-12-31,87483,51021,138504
44,44430,2011-12-31,88860,52899,141759
44,44430,2012-12-31,90339,54711,145050
44,44430,2013-12-31,91873,56478,148351
44,44430,2014-12-31,93444,58193,151637
44,44430,2015-12-31,95091,59922,155013
44,44430,2016-12-31,97116,61894,159010
44,44430,2017-12-31,99591,64140,163731
44,44430,2018-12-31,103354,67228,170582
44,44430,2019-12-31,112088,66744,178832
44,44430,2020-12-31,118889,66183,185072
44,44430,2021-12-31,122254,67031,189285
44,44430,2022-12-31,124423,67662,192085
44,44430,2023-12-31,126426,68249,194675
44,44430,2024-12-31,128507,68926,197433
44,44430,2025-12-31,130499,69571,200070
44,44430,2026-12-31,132418,70229,202647
44,44430,2027-12-31,134301,70942,205243
44,44430,2028-12-31,136109,71689,207798
44,44430,2029-12-31,137841,72470,210311
44,44430,2030-12-31,139520,73301,212821
44,44430,2031-12-31,141149,74165,215314
44,44430,2032-12-31,142709,75007,217716
44,44430,2033-12-31,144195,75840,220035
44,44430,2034-12-31,145618,76629,222247
44,44430,2035-12-31,146991,77429,224420
44,44560,1985-12-31,8191,5908,14099
44,44560,1986-12-31,8320,7838,16158
44,44560,1987-12-31,8452,9544,17996
44,44560,1988-12-31,8582,11033,19615
44,44560,1989-12-31,8716,12402,21118
44,44560,1990-12-31,8658,14230,22888
44,44560,1991-12-31,8803,15436,24239
44,44560,1992-12-31,8952,16607,25559
44,44560,1993-12-31,9109,17744,26853
44,44560,1994-12-31,9274,18835,28109
44,44560,1995-12-31,9253,20403,29656
44,44560,1996-12-31,9226,21763,30989
44,44560,1997-12-31,9341,22783,32124
44,44560,1998-12-31,9412,24074,33486
44,44560,1999-12-31,9385,25905,35290
44,44560,2000-12-31,9125,28863,37988
44,44560,2001-12-31,8979,31951,40930
44,44560,2002-12-31,8690,35888,44578
44,44560,2003-12-31,8323,40368,48691
44,44560,2004-12-31,7952,44864,52816
44,44560,2005-12-31,7649,48835,56484
44,44560,2006-12-31,7456,52126,59582
44,44560,2007-12-31,7356,54738,62094
44,44560,2008-12-31,7358,56909,64267
44,44560,2009-12-31,7404,58777,66181
44,44560,2010-12-31,7474,60442,67916
44,44560,2011-12-31,7570,61987,69557
44,44560,2012-12-31,7655,63476,71131
44,44560,2013-12-31,7790,64914,72704
44,44560,2014-12-31,7886,66337,74223
44,44560,2015-12-31,8004,67757,75761
44,44560,2016-12-31,8161,69464,77625
44,44560,2017-12-31,8338,71481,79819
44,44560,2018-12-31,8625,74447,83072
44,44560,2019-12-31,9935,78946,88881
44,44560,2020-12-31,11284,82147,93431
44,44560,2021-12-31,12361,83216,95577
44,44560,2022-12-31,12991,84000,96991
44,44560,2023-12-31,13570,84729,98299
44,44560,2024-12-31,13927,85451,99378
44,44560,2025-12-31,14211,86226,100437
44,44560,2026-12-31,14452,87079,101531
44,44560,2027-12-31,14658,87945,102603
44,44560,2028-12-31,14861,88884,103745
44,44560,2029-12-31,15042,89844,104886
44,44560,2030-12-31,15228,90894,106122
44,44560,2031-12-31,15394,91940,107334
44,44560,2032-12-31,15572,92987,108559
44,44560,2033-12-31,15728,94003,109731
44,44560,2034-12-31,15867,95020,110887
44,44560,2035-12-31,16033,96018,112051
44,44650,1985-12-31,28962,11979,40941
44,44650,1986-12-31,29432,11231,40663
44,44650,1987-12-31,29895,10664,40559
44,44650,1988-12-31,30377,10188,40565
44,44650,1989-12-31,30873,9800,40673
44,44650,1990-12-31,30664,9885,40549
44,44650,1991-12-31,31165,9619,40784
44,44650,1992-12-31,31683,9398,41081
44,44650,1993-12-31,32224,9243,41467
44,44650,1994-12-31,32757,9110,41867
44,44650,1995-12-31,32587,9234,41821
44,44650,1996-12-31,32543,9270,41813
44,44650,1997-12-31,32945,9183,42128
44,44650,1998-12-31,33237,9222,42459
44,44650,1999-12-31,33182,9484,42666
44,44650,2000-12-31,32215,10082,42297
44,44650,2001-12-31,31577,10737,42314
44,44650,2002-12-31,30535,11618,42153
44,44650,2003-12-31,29194,12613,41807
44,44650,2004-12-31,27904,13558,41462
44,44650,2005-12-31,26795,14352,41147
44,44650,2006-12-31,26174,14869,41043
44,44650,2007-12-31,25870,15205,41075
44,44650,2008-12-31,25876,15419,41295
44,44650,2009-12-31,26025,15537,41562
44,44650,2010-12-31,26295,15615,41910
44,44650,2011-12-31,26624,15664,42288
44,44650,2012-12-31,26979,15706,42685
44,44650,2013-12-31,27355,15758,43113
44,44650,2014-12-31,27752,15817,43569
44,44650,2015-12-31,28167,15848,44015
44,44650,2016-12-31,28689,15973,44662
44,44650,2017-12-31,29337,16146,45483
44,44650,2018-12-31,30385,16568,46953
44,44650,2019-12-31,33014,15373,48387
44,44650,2020-12-31,35079,14505,49584
44,44650,2021-12-31,36022,14691,50713
44,44650,2022-12-31,36634,14829,51463
44,44650,2023-12-31,37199,14958,52157
44,44650,2024-12-31,37814,15120,52934
44,44650,2025-12-31,38431,15248,53679
44,44650,2026-12-31,39006,15388,54394
44,44650,2027-12-31,39560,15542,55102
44,44650,2028-12-31,40065,15708,55773
44,44650,2029-12-31,40595,15870,56465
44,44650,2030-12-31,41065,16055,57120
44,44650,2031-12-31,41554,16236,57790
44,44650,2032-12-31,42025,16428,58453
44,44650,2033-12-31,42477,16615,59092
44,44650,2034-12-31,42899,16779,59678
44,44650,2035-12-31,43299,16967,60266
44,44847,1985-12-31,7604,20455,28059
44,44847,1986-12-31,7736,23635,31371
44,44847,1987-12-31,7840,26469,34309
44,44847,1988-12-31,7963,29042,37005
44,44847,1989-12-31,8071,31325,39396
44,44847,1990-12-31,8012,34880,42892
44,44847,1991-12-31,8134,37009,45143
44,44847,1992-12-31,8258,39069,47327
44,44847,1993-12-31,8383,41149,49532
44,44847,1994-12-31,8519,43145,51664
44,44847,1995-12-31,8462,46294,54756
44,44847,1996-12-31,8448,48907,57355
44,44847,1997-12-31,8547,50845,59392
44,44847,1998-12-31,8613,53320,61933
44,44847,1999-12-31,8578,56997,65575
44,44847,2000-12-31,8280,63115,71395
44,44847,2001-12-31,8093,69519,77612
44,44847,2002-12-31,7830,77740,85570
44,44847,2003-12-31,7470,87136,94606
44,44847,2004-12-31,7120,96533,103653
44,44847,2005-12-31,6867,104810,111677
44,44847,2006-12-31,6696,111518,118214
44,44847,2007-12-31,6629,116796,123425
44,44847,2008-12-31,6618,121133,127751
44,44847,2009-12-31,6650,124821,131471
44,44847,2010-12-31,6717,128108,134825
44,44847,2011-12-31,6794,131117,137911
44,44847,2012-12-31,6871,134007,140878
44,44847,2013-12-31,6977,136807,143784
44,44847,2014-12-31,7061,139568,146629
44,44847,2015-12-31,7155,142374,149529
44,44847,2016-12-31,7282,145745,153027
44,44847,2017-12-31,7436,149763,157199
44,44847,2018-12-31,7698,155764,163462
44,44847,2019-12-31,8412,169403,177815
44,44847,2020-12-31,8989,181095,190084
44,44847,2021-12-31,10999,183451,194450
44,44847,2022-12-31,12148,185179,197327
44,44847,2023-12-31,13200,186787,199987
44,44847,2024-12-31,13493,188296,201789
44,44847,2025-12-31,13719,190026,203745
44,44847,2026-12-31,13935,191847,205782
44,44847,2027-12-31,14125,193759,207884
44,44847,2028-12-31,14322,195775,210097
44,44847,2029-12-31,14494,197931,212425
44,44847,2030-12-31,14671,200214,214885
44,44847,2031-12-31,14835,202546,217381
44,44847,2032-12-31,14994,204839,219833
44,44847,2033-12-31,15149,207093,222242
44,44847,2034-12-31,15309,209312,224621
44,44847,2035-12-31,15438,211496,226934
44,44855,1985-12-31,9540,3711,13251
44,44855,1986-12-31,9681,3560,13241
44,44855,1987-12-31,9818,3441,13259
44,44855,1988-12-31,9953,3346,13299
44,44855,1989-12-31,10083,3322,13405
44,44855,1990-12-31,9998,3394,13392
44,44855,1991-12-31,10112,3358,13470
44,44855,1992-12-31,10270,3330,13600
44,44855,1993-12-31,10423,3319,13742
44,44855,1994-12-31,10575,3328,13903
44,44855,1995-12-31,10515,3431,13946
44,44855,1996-12-31,10485,3491,13976
44,44855,1997-12-31,10590,3488,14078
44,44855,1998-12-31,10662,3557,14219
44,44855,1999-12-31,10609,2202,12811
44,44855,2000-12-31,10265,2262,12527
44,44855,2001-12-31,10066,2317,12383
44,44855,2002-12-31,9690,2402,12092
44,44855,2003-12-31,9256,2512,11768
44,44855,2004-12-31,8838,2571,11409
44,44855,2005-12-31,8474,2591,11065
44,44855,2006-12-31,8250,2558,10808
44,44855,2007-12-31,8143,2553,10696
44,44855,2008-12-31,8128,2431,10559
44,44855,2009-12-31,8173,2333,10506
44,44855,2010-12-31,8239,2250,10489
44,44855,2011-12-31,8333,2137,10470
44,44855,2012-12-31,8428,2028,10456
44,44855,2013-12-31,8539,1928,10467
44,44855,2014-12-31,8658,1857,10515
44,44855,2015-12-31,8758,1768,10526
44,44855,2016-12-31,8910,1738,10648
44,44855,2017-12-31,9114,1622,10736
44,44855,2018-12-31,9423,1562,10985
44,44855,2019-12-31,9811,1303,11114
44,44855,2020-12-31,10146,1115,11261
44,44855,2021-12-31,10388,1129,11517
44,44855,2022-12-31,10548,1140,11688
44,44855,2023-12-31,10695,1150,11845
44,44855,2024-12-31,10852,1161,12013
44,44855,2025-12-31,11010,1169,12179
44,44855,2026-12-31,11185,1180,12365
44,44855,2027-12-31,11346,1186,12532
44,44855,2028-12-31,11497,1202,12699
44,44855,2029-12-31,11633,1213,12846
44,44855,2030-12-31,11779,1227,13006
44,44855,2031-12-31,11910,1238,13148
44,44855,2032-12-31,12044,1264,13308
44,44855,2033-12-31,12183,1277,13460
44,44855,2034-12-31,12290,1287,13577
44,44855,2035-12-31,12407,1306,13713
44,44874,1985-12-31,23565,7800,31365
44,44874,1986-12-31,23997,7593,31590
44,44874,1987-12-31,24446,7395,31841
44,44874,1988-12-31,24911,7274,32185
44,44874,1989-12-31,25393,7194,32587
44,44874,1990-12-31,25281,1501,26782
44,44874,1991-12-31,25767,1459,27226
44,44874,1992-12-31,26270,1393,27663
44,44874,1993-12-31,26785,1317,28102
44,44874,1994-12-31,27305,1322,28627
44,44874,1995-12-31,27189,1295,28484
44,44874,1996-12-31,27222,1293,28515
44,44874,1997-12-31,27620,1266,28886
44,44874,1998-12-31,27931,1252,29183
44,44874,1999-12-31,27970,1283,29253
44,44874,2000-12-31,27222,1360,28582
44,44874,2001-12-31,26731,1414,28145
44,44874,2002-12-31,25886,1528,27414
44,44874,2003-12-31,24817,1613,26430
44,44874,2004-12-31,23751,1738,25489
44,44874,2005-12-31,22835,1801,24636
44,44874,2006-12-31,22350,1848,24198
44,44874,2007-12-31,22157,1867,24024
44,44874,2008-12-31,22186,1875,24061
44,44874,2009-12-31,22348,1895,24243
44,44874,2010-12-31,22644,1881,24525
44,44874,2011-12-31,22955,1867,24822
44,44874,2012-12-31,23293,1851,25144
44,44874,2013-12-31,23652,1818,25470
44,44874,2014-12-31,24032,1825,25857
44,44874,2015-12-31,24446,1841,26287
44,44874,2016-12-31,24934,1848,26782
44,44874,2017-12-31,25544,1887,27431
44,44874,2018-12-31,26488,1858,28346
44,44874,2019-12-31,27298,1518,28816
44,44874,2020-12-31,27752,1484,29236
44,44874,2021-12-31,28399,1503,29902
44,44874,2022-12-31,28827,1517,30344
44,44874,2023-12-31,29223,1530,30753
44,44874,2024-12-31,29683,1544,31227
44,44874,2025-12-31,30131,1554,31685
44,44874,2026-12-31,30552,1576,32128
44,44874,2027-12-31,30994,1584,32578
44,44874,2028-12-31,31414,1610,33024
44,44874,2029-12-31,31831,1628,33459
44,44874,2030-12-31,32218,1639,33857
44,44874,2031-12-31,32603,1656,34259
44,44874,2032-12-31,32953,1670,34623
44,44874,2033-12-31,33299,1698,34997
44,44874,2034-12-31,33624,1714,35338
44,44874,2035-12-31,33948,1736,35684
47,47001,1985-12-31,176865,43692,220557
47,47001,1986-12-31,185149,43393,228542
47,47001,1987-12-31,194624,42856,237480
47,47001,1988-12-31,205364,42061,247425
47,47001,1989-12-31,217281,40939,258220
47,47001,1990-12-31,230192,39699,269891
47,47001,1991-12-31,243640,38351,281991
47,47001,1992-12-31,257137,37071,294208
47,47001,1993-12-31,270121,35900,306021
47,47001,1994-12-31,282447,34955,317402
47,47001,1995-12-31,293868,34251,328119
47,47001,1996-12-31,296633,34690,331323
47,47001,1997-12-31,307411,34164,341575
47,47001,1998-12-31,316303,34099,350402
47,47001,1999-12-31,318157,35008,353165
47,47001,2000-12-31,315793,35248,351041
47,47001,2001-12-31,329221,34212,363433
47,47001,2002-12-31,336649,34612,371261
47,47001,2003-12-31,343965,35064,379029
47,47001,2004-12-31,351315,35568,386883
47,47001,2005-12-31,358578,36109,394687
47,47001,2006-12-31,366037,36671,402708
47,47001,2007-12-31,373420,37226,410646
47,47001,2008-12-31,380715,37796,418511
47,47001,2009-12-31,387911,38364,426275
47,47001,2010-12-31,394981,38935,433916
47,47001,2011-12-31,401820,39471,441291
47,47001,2012-12-31,408446,40006,448452
47,47001,2013-12-31,415001,40525,455526
47,47001,2014-12-31,421364,41030,462394
47,47001,2015-12-31,427734,41538,469272
47,47001,2016-12-31,435062,42128,477190
47,47001,2017-12-31,443395,42851,486246
47,47001,2018-12-31,455299,43893,499192
47,47001,2019-12-31,471475,49764,521239
47,47001,2020-12-31,484025,54587,538612
47,47001,2021-12-31,490898,56081,546979
47,47001,2022-12-31,495072,57319,552391
47,47001,2023-12-31,498880,58508,557388
47,47001,2024-12-31,502306,59601,561907
47,47001,2025-12-31,505659,60708,566367
47,47001,2026-12-31,509157,61791,570948
47,47001,2027-12-31,512896,62844,575740
47,47001,2028-12-31,516843,63853,580696
47,47001,2029-12-31,521038,64813,585851
47,47001,2030-12-31,525562,65751,591313
47,47001,2031-12-31,530179,66664,596843
47,47001,2032-12-31,534676,67560,602236
47,47001,2033-12-31,539057,68482,607539
47,47001,2034-12-31,543296,69348,612644
47,47001,2035-12-31,547458,70240,617698
47,47030,1985-12-31,0,0,0
47,47030,1986-12-31,0,0,0
47,47030,1987-12-31,0,0,0
47,47030,1988-12-31,0,0,0
47,47030,1989-12-31,0,0,0
47,47030,1990-12-31,0,0,0
47,47030,1991-12-31,0,0,0
47,47030,1992-12-31,0,0,0
47,47030,1993-12-31,0,0,0
47,47030,1994-12-31,0,0,0
47,47030,1995-12-31,0,0,0
47,47030,1996-12-31,0,0,0
47,47030,1997-12-31,0,0,0
47,47030,1998-12-31,0,0,0
47,47030,1999-12-31,6904,3957,10861
47,47030,2000-12-31,6860,3984,10844
47,47030,2001-12-31,7161,3887,11048
47,47030,2002-12-31,7337,3957,11294
47,47030,2003-12-31,7496,4042,11538
47,47030,2004-12-31,7683,4113,11796
47,47030,2005-12-31,7853,4199,12052
47,47030,2006-12-31,8025,4283,12308
47,47030,2007-12-31,8192,4368,12560
47,47030,2008-12-31,8353,4450,12803
47,47030,2009-12-31,8517,4539,13056
47,47030,2010-12-31,8684,4630,13314
47,47030,2011-12-31,8862,4719,13581
47,47030,2012-12-31,9052,4800,13852
47,47030,2013-12-31,9176,4898,14074
47,47030,2014-12-31,9303,4974,14277
47,47030,2015-12-31,9451,5057,14508
47,47030,2016-12-31,9601,5151,14752
47,47030,2017-12-31,9792,5257,15049
47,47030,2018-12-31,10096,5415,15511
47,47030,2019-12-31,10488,5706,16194
47,47030,2020-12-31,10820,5965,16785
47,47030,2021-12-31,10918,6128,17046
47,47030,2022-12-31,10950,6264,17214
47,47030,2023-12-31,10976,6394,17370
47,47030,2024-12-31,11002,6514,17516
47,47030,2025-12-31,11029,6638,17667
47,47030,2026-12-31,11059,6751,17810
47,47030,2027-12-31,11081,6867,17948
47,47030,2028-12-31,11119,6968,18087
47,47030,2029-12-31,11147,7082,18229
47,47030,2030-12-31,11186,7179,18365
47,47030,2031-12-31,11232,7287,18519
47,47030,2032-12-31,11275,7384,18659
47,47030,2033-12-31,11301,7477,18778
47,47030,2034-12-31,11313,7583,18896
47,47030,2035-12-31,11339,7671,19010
47,47053,1985-12-31,11968,24647,36615
47,47053,1986-12-31,12292,24824,37116
47,47053,1987-12-31,12736,24863,37599
47,47053,1988-12-31,13232,24736,37968
47,47053,1989-12-31,13801,24431,38232
47,47053,1990-12-31,14440,23999,38439
47,47053,1991-12-31,15106,23487,38593
47,47053,1992-12-31,15748,22993,38741
47,47053,1993-12-31,16367,22539,38906
47,47053,1994-12-31,16929,22244,39173
47,47053,1995-12-31,17438,22052,39490
47,47053,1996-12-31,17443,12070,29513
47,47053,1997-12-31,17912,11899,29811
47,47053,1998-12-31,18277,11947,30224
47,47053,1999-12-31,18241,12282,30523
47,47053,2000-12-31,17980,12399,30379
47,47053,2001-12-31,18594,12055,30649
47,47053,2002-12-31,18889,12242,31131
47,47053,2003-12-31,19179,12433,31612
47,47053,2004-12-31,19471,12651,32122
47,47053,2005-12-31,19748,12871,32619
47,47053,2006-12-31,20042,13115,33157
47,47053,2007-12-31,20337,13354,33691
47,47053,2008-12-31,20636,13599,34235
47,47053,2009-12-31,20931,13832,34763
47,47053,2010-12-31,21201,14084,35285
47,47053,2011-12-31,21439,14332,35771
47,47053,2012-12-31,21715,14551,36266
47,47053,2013-12-31,21960,14781,36741
47,47053,2014-12-31,22202,15003,37205
47,47053,2015-12-31,22420,15239,37659
47,47053,2016-12-31,22704,15489,38193
47,47053,2017-12-31,23070,15807,38877
47,47053,2018-12-31,23623,16234,39857
47,47053,2019-12-31,24287,16439,40726
47,47053,2020-12-31,24803,16689,41492
47,47053,2021-12-31,24986,17142,42128
47,47053,2022-12-31,25024,17521,42545
47,47053,2023-12-31,25045,17885,42930
47,47053,2024-12-31,25035,18246,43281
47,47053,2025-12-31,25030,18588,43618
47,47053,2026-12-31,25001,18917,43918
47,47053,2027-12-31,24985,19238,44223
47,47053,2028-12-31,24960,19539,44499
47,47053,2029-12-31,24947,19838,44785
47,47053,2030-12-31,24930,20130,45060
47,47053,2031-12-31,24921,20411,45332
47,47053,2032-12-31,24885,20699,45584
47,47053,2033-12-31,24831,20965,45796
47,47053,2034-12-31,24758,21235,45993
47,47053,2035-12-31,24676,21498,46174
47,47058,1985-12-31,9311,16435,25746
47,47058,1986-12-31,9580,16186,25766
47,47058,1987-12-31,9961,15839,25800
47,47058,1988-12-31,10362,15382,25744
47,47058,1989-12-31,10818,14876,25694
47,47058,1990-12-31,11339,14290,25629
47,47058,1991-12-31,11874,13686,25560
47,47058,1992-12-31,12412,13111,25523
47,47058,1993-12-31,12906,12584,25490
47,47058,1994-12-31,13377,12157,25534
47,47058,1995-12-31,13797,11797,25594
47,47058,1996-12-31,13824,11848,25672
47,47058,1997-12-31,14217,11556,25773
47,47058,1998-12-31,14528,11431,25959
47,47058,1999-12-31,14500,12294,26794
47,47058,2000-12-31,14312,12185,26497
47,47058,2001-12-31,14832,11647,26479
47,47058,2002-12-31,15076,11609,26685
47,47058,2003-12-31,15315,11583,26898
47,47058,2004-12-31,15564,11555,27119
47,47058,2005-12-31,15812,11525,27337
47,47058,2006-12-31,16050,11519,27569
47,47058,2007-12-31,16295,11503,27798
47,47058,2008-12-31,16561,11488,28049
47,47058,2009-12-31,16780,11467,28247
47,47058,2010-12-31,17007,11432,28439
47,47058,2011-12-31,17260,11408,28668
47,47058,2012-12-31,17473,11343,28816
47,47058,2013-12-31,17707,11282,28989
47,47058,2014-12-31,17902,11224,29126
47,47058,2015-12-31,18095,11159,29254
47,47058,2016-12-31,18307,11110,29417
47,47058,2017-12-31,18623,11089,29712
47,47058,2018-12-31,19075,11143,30218
47,47058,2019-12-31,19677,11400,31077
47,47058,2020-12-31,20148,11646,31794
47,47058,2021-12-31,20319,11962,32281
47,47058,2022-12-31,20375,12226,32601
47,47058,2023-12-31,20416,12480,32896
47,47058,2024-12-31,20470,12728,33198
47,47058,2025-12-31,20517,12960,33477
47,47058,2026-12-31,20564,13186,33750
47,47058,2027-12-31,20617,13411,34028
47,47058,2028-12-31,20676,13629,34305
47,47058,2029-12-31,20725,13842,34567
47,47058,2030-12-31,20810,14034,34844
47,47058,2031-12-31,20864,14224,35088
47,47058,2032-12-31,20926,14422,35348
47,47058,2033-12-31,20989,14604,35593
47,47058,2034-12-31,21022,14794,35816
47,47058,2035-12-31,21059,14988,36047
47,47161,1985-12-31,3979,13679,17658
47,47161,1986-12-31,4039,13335,17374
47,47161,1987-12-31,4083,12938,17021
47,47161,1988-12-31,4173,12433,16606
47,47161,1989-12-31,4329,11908,16237
47,47161,1990-12-31,4450,11323,15773
47,47161,1991-12-31,4564,10728,15292
47,47161,1992-12-31,4684,10152,14836
47,47161,1993-12-31,4799,9631,14430
47,47161,1994-12-31,4901,9187,14088
47,47161,1995-12-31,4977,8823,13800
47,47161,1996-12-31,4921,8738,13659
47,47161,1997-12-31,4967,8414,13381
47,47161,1998-12-31,4990,8210,13200
47,47161,1999-12-31,4941,3137,8078
47,47161,2000-12-31,4812,3187,7999
47,47161,2001-12-31,4934,3099,8033
47,47161,2002-12-31,4928,3168,8096
47,47161,2003-12-31,4959,3244,8203
47,47161,2004-12-31,4984,3309,8293
47,47161,2005-12-31,5012,3393,8405
47,47161,2006-12-31,5046,3467,8513
47,47161,2007-12-31,5041,3538,8579
47,47161,2008-12-31,5069,3632,8701
47,47161,2009-12-31,5117,3708,8825
47,47161,2010-12-31,5127,3783,8910
47,47161,2011-12-31,5140,3864,9004
47,47161,2012-12-31,5123,3950,9073
47,47161,2013-12-31,5158,4020,9178
47,47161,2014-12-31,5189,4107,9296
47,47161,2015-12-31,5235,4193,9428
47,47161,2016-12-31,5273,4274,9547
47,47161,2017-12-31,5339,4371,9710
47,47161,2018-12-31,5365,4525,9890
47,47161,2019-12-31,5413,4472,9885
47,47161,2020-12-31,5461,4480,9941
47,47161,2021-12-31,5491,4602,10093
47,47161,2022-12-31,5490,4703,10193
47,47161,2023-12-31,5484,4801,10285
47,47161,2024-12-31,5484,4896,10380
47,47161,2025-12-31,5483,4994,10477
47,47161,2026-12-31,5497,5075,10572
47,47161,2027-12-31,5506,5161,10667
47,47161,2028-12-31,5517,5249,10766
47,47161,2029-12-31,5539,5334,10873
47,47161,2030-12-31,5542,5404,10946
47,47161,2031-12-31,5570,5479,11049
47,47161,2032-12-31,5587,5551,11138
47,47161,2033-12-31,5594,5625,11219
47,47161,2034-12-31,5600,5698,11298
47,47161,2035-12-31,5616,5765,11381
47,47170,1985-12-31,4655,6696,11351
47,47170,1986-12-31,4972,6775,11747
47,47170,1987-12-31,5271,6822,12093
47,47170,1988-12-31,5625,6819,12444
47,47170,1989-12-31,5979,6777,12756
47,47170,1990-12-31,6389,6688,13077
47,47170,1991-12-31,6810,6578,13388
47,47170,1992-12-31,7221,6467,13688
47,47170,1993-12-31,7624,6368,13992
47,47170,1994-12-31,8013,6312,14325
47,47170,1995-12-31,8383,6287,14670
47,47170,1996-12-31,8478,6479,14957
47,47170,1997-12-31,8825,6476,15301
47,47170,1998-12-31,9127,6572,15699
47,47170,1999-12-31,9240,4304,13544
47,47170,2000-12-31,9202,4443,13645
47,47170,2001-12-31,9613,4425,14038
47,47170,2002-12-31,9855,4583,14438
47,47170,2003-12-31,10132,4766,14898
47,47170,2004-12-31,10349,4948,15297
47,47170,2005-12-31,10578,5142,15720
47,47170,2006-12-31,10832,5336,16168
47,47170,2007-12-31,11082,5549,16631
47,47170,2008-12-31,11331,5747,17078
47,47170,2009-12-31,11565,5956,17521
47,47170,2010-12-31,11795,6176,17971
47,47170,2011-12-31,12037,6390,18427
47,47170,2012-12-31,12248,6606,18854
47,47170,2013-12-31,12488,6822,19310
47,47170,2014-12-31,12694,7043,19737
47,47170,2015-12-31,12861,7266,20127
47,47170,2016-12-31,13095,7507,20602
47,47170,2017-12-31,13385,7766,21151
47,47170,2018-12-31,13782,8080,21862
47,47170,2019-12-31,14256,8459,22715
47,47170,2020-12-31,14621,8767,23388
47,47170,2021-12-31,14740,9011,23751
47,47170,2022-12-31,14775,9211,23986
47,47170,2023-12-31,14800,9403,24203
47,47170,2024-12-31,14832,9589,24421
47,47170,2025-12-31,14865,9779,24644
47,47170,2026-12-31,14895,9951,24846
47,47170,2027-12-31,14937,10111,25048
47,47170,2028-12-31,14984,10277,25261
47,47170,2029-12-31,15025,10421,25446
47,47170,2030-12-31,15083,10579,25662
47,47170,2031-12-31,15141,10720,25861
47,47170,2032-12-31,15174,10865,26039
47,47170,2033-12-31,15206,11000,26206
47,47170,2034-12-31,15238,11155,26393
47,47170,2035-12-31,15269,11298,26567
47,47189,1985-12-31,56975,69390,126365
47,47189,1986-12-31,58346,69589,127935
47,47189,1987-12-31,60133,69355,129488
47,47189,1988-12-31,62268,68685,130953
47,47189,1989-12-31,64740,67515,132255
47,47189,1990-12-31,67478,66106,133584
47,47189,1991-12-31,70310,64467,134777
47,47189,1992-12-31,73153,62853,136006
47,47189,1993-12-31,75792,61402,137194
47,47189,1994-12-31,78243,60370,138613
47,47189,1995-12-31,80414,59682,140096
47,47189,1996-12-31,80230,60991,141221
47,47189,1997-12-31,82237,60540,142777
47,47189,1998-12-31,83735,60913,144648
47,47189,1999-12-31,83378,62992,146370
47,47189,2000-12-31,81958,25754,107712
47,47189,2001-12-31,84688,24229,108917
47,47189,2002-12-31,85845,23750,109595
47,47189,2003-12-31,86977,23297,110274
47,47189,2004-12-31,88140,22836,110976
47,47189,2005-12-31,89286,22377,111663
47,47189,2006-12-31,90468,21914,112382
47,47189,2007-12-31,91650,21466,113116
47,47189,2008-12-31,92810,20975,113785
47,47189,2009-12-31,93962,20467,114429
47,47189,2010-12-31,95068,19947,115015
47,47189,2011-12-31,96144,19377,115521
47,47189,2012-12-31,97173,18781,115954
47,47189,2013-12-31,98186,18163,116349
47,47189,2014-12-31,99077,17527,116604
47,47189,2015-12-31,100073,16861,116934
47,47189,2016-12-31,101272,16224,117496
47,47189,2017-12-31,102715,15607,118322
47,47189,2018-12-31,104999,15072,120071
47,47189,2019-12-31,108028,14257,122285
47,47189,2020-12-31,110303,14036,124339
47,47189,2021-12-31,111828,14417,126245
47,47189,2022-12-31,112758,14736,127494
47,47189,2023-12-31,113605,15042,128647
47,47189,2024-12-31,113988,15349,129337
47,47189,2025-12-31,114261,15636,129897
47,47189,2026-12-31,114529,15926,130455
47,47189,2027-12-31,114823,16179,131002
47,47189,2028-12-31,115160,16442,131602
47,47189,2029-12-31,115524,16687,132211
47,47189,2030-12-31,115903,16925,132828
47,47189,2031-12-31,116298,17167,133465
47,47189,2032-12-31,116650,17408,134058
47,47189,2033-12-31,116942,17626,134568
47,47189,2034-12-31,117177,17852,135029
47,47189,2035-12-31,117339,18079,135418
47,47205,1985-12-31,0,0,0
47,47205,1986-12-31,0,0,0
47,47205,1987-12-31,0,0,0
47,47205,1988-12-31,0,0,0
47,47205,1989-12-31,0,0,0
47,47205,1990-12-31,0,0,0
47,47205,1991-12-31,0,0,0
47,47205,1992-12-31,0,0,0
47,47205,1993-12-31,0,0,0
47,47205,1994-12-31,0,0,0
47,47205,1995-12-31,0,0,0
47,47205,1996-12-31,0,0,0
47,47205,1997-12-31,0,0,0
47,47205,1998-12-31,0,0,0
47,47205,1999-12-31,3613,5415,9028
47,47205,2000-12-31,3505,5418,8923
47,47205,2001-12-31,3646,5248,8894
47,47205,2002-12-31,3662,5285,8947
47,47205,2003-12-31,3680,5346,9026
47,47205,2004-12-31,3688,5386,9074
47,47205,2005-12-31,3746,5456,9202
47,47205,2006-12-31,3776,5520,9296
47,47205,2007-12-31,3826,5602,9428
47,47205,2008-12-31,3841,5649,9490
47,47205,2009-12-31,3896,5720,9616
47,47205,2010-12-31,3920,5774,9694
47,47205,2011-12-31,3889,5839,9728
47,47205,2012-12-31,3906,5890,9796
47,47205,2013-12-31,3940,5934,9874
47,47205,2014-12-31,3963,5998,9961
47,47205,2015-12-31,4004,6041,10045
47,47205,2016-12-31,4046,6122,10168
47,47205,2017-12-31,4083,6193,10276
47,47205,2018-12-31,4177,6328,10505
47,47205,2019-12-31,4317,6591,10908
47,47205,2020-12-31,4424,6803,11227
47,47205,2021-12-31,4413,6988,11401
47,47205,2022-12-31,4372,7142,11514
47,47205,2023-12-31,4328,7290,11618
47,47205,2024-12-31,4317,7426,11743
47,47205,2025-12-31,4332,7575,11907
47,47205,2026-12-31,4328,7698,12026
47,47205,2027-12-31,4346,7826,12172
47,47205,2028-12-31,4356,7950,12306
47,47205,2029-12-31,4373,8079,12452
47,47205,2030-12-31,4387,8192,12579
47,47205,2031-12-31,4403,8307,12710
47,47205,2032-12-31,4406,8425,12831
47,47205,2033-12-31,4416,8537,12953
47,47205,2034-12-31,4429,8635,13064
47,47205,2035-12-31,4436,8744,13180
47,47245,1985-12-31,23299,20782,44081
47,47245,1986-12-31,23844,20742,44586
47,47245,1987-12-31,24551,20564,45115
47,47245,1988-12-31,25383,20288,45671
47,47245,1989-12-31,26353,19826,46179
47,47245,1990-12-31,27429,19302,46731
47,47245,1991-12-31,28561,18706,47267
47,47245,1992-12-31,29682,18163,47845
47,47245,1993-12-31,30711,17668,48379
47,47245,1994-12-31,31687,17254,48941
47,47245,1995-12-31,32517,16982,49499
47,47245,1996-12-31,32427,17260,49687
47,47245,1997-12-31,33200,17039,50239
47,47245,1998-12-31,33789,17081,50870
47,47245,1999-12-31,33618,17594,51212
47,47245,2000-12-31,33011,17773,50784
47,47245,2001-12-31,34081,17317,51398
47,47245,2002-12-31,34531,17589,52120
47,47245,2003-12-31,34969,17880,52849
47,47245,2004-12-31,35400,18197,53597
47,47245,2005-12-31,35841,18552,54393
47,47245,2006-12-31,36297,18912,55209
47,47245,2007-12-31,36753,19255,56008
47,47245,2008-12-31,37193,19624,56817
47,47245,2009-12-31,37631,20004,57635
47,47245,2010-12-31,38052,20357,58409
47,47245,2011-12-31,38463,20721,59184
47,47245,2012-12-31,38864,21057,59921
47,47245,2013-12-31,39254,21398,60652
47,47245,2014-12-31,39613,21757,61370
47,47245,2015-12-31,39974,22095,62069
47,47245,2016-12-31,40436,22476,62912
47,47245,2017-12-31,40989,22929,63918
47,47245,2018-12-31,41881,23576,65457
47,47245,2019-12-31,42205,25606,67811
47,47245,2020-12-31,42521,27180,69701
47,47245,2021-12-31,42860,27923,70783
47,47245,2022-12-31,42944,28540,71484
47,47245,2023-12-31,42998,29133,72131
47,47245,2024-12-31,43072,29704,72776
47,47245,2025-12-31,43145,30248,73393
47,47245,2026-12-31,43239,30785,74024
47,47245,2027-12-31,43341,31297,74638
47,47245,2028-12-31,43454,31808,75262
47,47245,2029-12-31,43592,32285,75877
47,47245,2030-12-31,43757,32745,76502
47,47245,2031-12-31,43902,33191,77093
47,47245,2032-12-31,44028,33641,77669
47,47245,2033-12-31,44132,34104,78236
47,47245,2034-12-31,44223,34542,78765
47,47245,2035-12-31,44295,34969,79264
47,47258,1985-12-31,3569,10134,13703
47,47258,1986-12-31,3687,10378,14065
47,47258,1987-12-31,3796,10562,14358
47,47258,1988-12-31,3974,10655,14629
47,47258,1989-12-31,4163,10705,14868
47,47258,1990-12-31,4371,10653,15024
47,47258,1991-12-31,4589,10573,15162
47,47258,1992-12-31,4785,10471,15256
47,47258,1993-12-31,4996,10401,15397
47,47258,1994-12-31,5169,10377,15546
47,47258,1995-12-31,5340,10412,15752
47,47258,1996-12-31,5344,10786,16130
47,47258,1997-12-31,5492,10861,16353
47,47258,1998-12-31,5586,11068,16654
47,47258,1999-12-31,5618,11595,17213
47,47258,2000-12-31,5555,9804,15359
47,47258,2001-12-31,5731,9645,15376
47,47258,2002-12-31,5839,9887,15726
47,47258,2003-12-31,5942,10137,16079
47,47258,2004-12-31,6047,10416,16463
47,47258,2005-12-31,6159,10705,16864
47,47258,2006-12-31,6212,11025,17237
47,47258,2007-12-31,6315,11318,17633
47,47258,2008-12-31,6424,11645,18069
47,47258,2009-12-31,6508,11952,18460
47,47258,2010-12-31,6598,12265,18863
47,47258,2011-12-31,6707,12570,19277
47,47258,2012-12-31,6770,12903,19673
47,47258,2013-12-31,6838,13196,20034
47,47258,2014-12-31,6958,13514,20472
47,47258,2015-12-31,7059,13847,20906
47,47258,2016-12-31,7161,14157,21318
47,47258,2017-12-31,7258,14565,21823
47,47258,2018-12-31,7445,15085,22530
47,47258,2019-12-31,7700,15700,23400
47,47258,2020-12-31,7896,16187,24083
47,47258,2021-12-31,7831,16626,24457
47,47258,2022-12-31,7705,16994,24699
47,47258,2023-12-31,7575,17347,24922
47,47258,2024-12-31,7546,17701,25247
47,47258,2025-12-31,7534,18031,25565
47,47258,2026-12-31,7550,18344,25894
47,47258,2027-12-31,7566,18664,26230
47,47258,2028-12-31,7591,18947,26538
47,47258,2029-12-31,7632,19241,26873
47,47258,2030-12-31,7643,19502,27145
47,47258,2031-12-31,7676,19791,27467
47,47258,2032-12-31,7705,20053,27758
47,47258,2033-12-31,7728,20310,28038
47,47258,2034-12-31,7742,20574,28316
47,47258,2035-12-31,7747,20833,28580
47,47268,1985-12-31,0,0,0
47,47268,1986-12-31,0,0,0
47,47268,1987-12-31,0,0,0
47,47268,1988-12-31,0,0,0
47,47268,1989-12-31,0,0,0
47,47268,1990-12-31,0,0,0
47,47268,1991-12-31,0,0,0
47,47268,1992-12-31,0,0,0
47,47268,1993-12-31,0,0,0
47,47268,1994-12-31,0,0,0
47,47268,1995-12-31,0,0,0
47,47268,1996-12-31,10656,4194,14850
47,47268,1997-12-31,10988,4091,15079
47,47268,1998-12-31,11261,4032,15293
47,47268,1999-12-31,11304,4101,15405
47,47268,2000-12-31,11190,4085,15275
47,47268,2001-12-31,11634,3923,15557
47,47268,2002-12-31,11864,3919,15783
47,47268,2003-12-31,12095,3930,16025
47,47268,2004-12-31,12330,3942,16272
47,47268,2005-12-31,12549,3954,16503
47,47268,2006-12-31,12774,3961,16735
47,47268,2007-12-31,13006,3988,16994
47,47268,2008-12-31,13226,4013,17239
47,47268,2009-12-31,13457,4028,17485
47,47268,2010-12-31,13678,4038,17716
47,47268,2011-12-31,13880,4045,17925
47,47268,2012-12-31,14086,4046,18132
47,47268,2013-12-31,14317,4064,18381
47,47268,2014-12-31,14480,4067,18547
47,47268,2015-12-31,14669,4063,18732
47,47268,2016-12-31,14878,4075,18953
47,47268,2017-12-31,15152,4112,19264
47,47268,2018-12-31,15549,4148,19697
47,47268,2019-12-31,16075,4380,20455
47,47268,2020-12-31,16479,4573,21052
47,47268,2021-12-31,16681,4698,21379
47,47268,2022-12-31,16789,4802,21591
47,47268,2023-12-31,16884,4902,21786
47,47268,2024-12-31,16964,4992,21956
47,47268,2025-12-31,17037,5088,22125
47,47268,2026-12-31,17123,5187,22310
47,47268,2027-12-31,17191,5267,22458
47,47268,2028-12-31,17277,5348,22625
47,47268,2029-12-31,17373,5430,22803
47,47268,2030-12-31,17493,5511,23004
47,47268,2031-12-31,17593,5593,23186
47,47268,2032-12-31,17689,5655,23344
47,47268,2033-12-31,17784,5737,23521
47,47268,2034-12-31,17868,5809,23677
47,47268,2035-12-31,17972,5884,23856
47,47288,1985-12-31,29152,14274,43426
47,47288,1986-12-31,29956,14006,43962
47,47288,1987-12-31,30952,13646,44598
47,47288,1988-12-31,32153,13215,45368
47,47288,1989-12-31,33528,12728,46256
47,47288,1990-12-31,35022,12188,47210
47,47288,1991-12-31,36579,11629,48208
47,47288,1992-12-31,38164,11091,49255
47,47288,1993-12-31,39633,10603,50236
47,47288,1994-12-31,40997,10182,51179
47,47288,1995-12-31,42216,9846,52062
47,47288,1996-12-31,42200,9832,52032
47,47288,1997-12-31,43333,9549,52882
47,47288,1998-12-31,44195,9397,53592
47,47288,1999-12-31,44093,6903,50996
47,47288,2000-12-31,43432,6989,50421
47,47288,2001-12-31,44935,6829,51764
47,47288,2002-12-31,45615,6945,52560
47,47288,2003-12-31,46295,7079,53374
47,47288,2004-12-31,46985,7226,54211
47,47288,2005-12-31,47627,7363,54990
47,47288,2006-12-31,48323,7516,55839
47,47288,2007-12-31,49016,7681,56697
47,47288,2008-12-31,49704,7833,57537
47,47288,2009-12-31,50378,8005,58383
47,47288,2010-12-31,51040,8165,59205
47,47288,2011-12-31,51665,8332,59997
47,47288,2012-12-31,52274,8484,60758
47,47288,2013-12-31,52876,8643,61519
47,47288,2014-12-31,53423,8799,62222
47,47288,2015-12-31,53983,8964,62947
47,47288,2016-12-31,54682,9137,63819
47,47288,2017-12-31,55514,9338,64852
47,47288,2018-12-31,56814,9619,66433
47,47288,2019-12-31,58519,10162,68681
47,47288,2020-12-31,59828,10663,70491
47,47288,2021-12-31,60617,10955,71572
47,47288,2022-12-31,61083,11197,72280
47,47288,2023-12-31,61505,11429,72934
47,47288,2024-12-31,61715,11662,73377
47,47288,2025-12-31,61868,11876,73744
47,47288,2026-12-31,62027,12086,74113
47,47288,2027-12-31,62185,12294,74479
47,47288,2028-12-31,62372,12490,74862
47,47288,2029-12-31,62560,12677,75237
47,47288,2030-12-31,62794,12870,75664
47,47288,2031-12-31,62989,13037,76026
47,47288,2032-12-31,63179,13219,76398
47,47288,2033-12-31,63339,13377,76716
47,47288,2034-12-31,63469,13557,77026
47,47288,2035-12-31,63556,13738,77294
47,47318,1985-12-31,5424,18872,24296
47,47318,1986-12-31,5520,18741,24261
47,47318,1987-12-31,5655,18495,24150
47,47318,1988-12-31,5788,18107,23895
47,47318,1989-12-31,5999,17608,23607
47,47318,1990-12-31,6195,17053,23248
47,47318,1991-12-31,6404,16461,22865
47,47318,1992-12-31,6637,15899,22536
47,47318,1993-12-31,6823,15377,22200
47,47318,1994-12-31,7003,14932,21935
47,47318,1995-12-31,7151,14607,21758
47,47318,1996-12-31,7098,14758,21856
47,47318,1997-12-31,7224,14517,21741
47,47318,1998-12-31,7312,14473,21785
47,47318,1999-12-31,7241,14816,22057
47,47318,2000-12-31,7088,14918,22006
47,47318,2001-12-31,7270,14440,21710
47,47318,2002-12-31,7345,14597,21942
47,47318,2003-12-31,7415,14784,22199
47,47318,2004-12-31,7461,14990,22451
47,47318,2005-12-31,7534,15202,22736
47,47318,2006-12-31,7615,15430,23045
47,47318,2007-12-31,7669,15645,23314
47,47318,2008-12-31,7720,15848,23568
47,47318,2009-12-31,7783,16070,23853
47,47318,2010-12-31,7839,16287,24126
47,47318,2011-12-31,7904,16497,24401
47,47318,2012-12-31,7987,16699,24686
47,47318,2013-12-31,7974,16887,24861
47,47318,2014-12-31,8068,17072,25140
47,47318,2015-12-31,8122,17282,25404
47,47318,2016-12-31,8193,17496,25689
47,47318,2017-12-31,8278,17776,26054
47,47318,2018-12-31,8437,18183,26620
47,47318,2019-12-31,8606,18739,27345
47,47318,2020-12-31,8734,19184,27918
47,47318,2021-12-31,8641,19705,28346
47,47318,2022-12-31,8486,20140,28626
47,47318,2023-12-31,8327,20558,28885
47,47318,2024-12-31,8200,20970,29170
47,47318,2025-12-31,8115,21369,29484
47,47318,2026-12-31,8075,21740,29815
47,47318,2027-12-31,8068,22101,30169
47,47318,2028-12-31,8070,22458,30528
47,47318,2029-12-31,8087,22798,30885
47,47318,2030-12-31,8112,23118,31230
47,47318,2031-12-31,8134,23454,31588
47,47318,2032-12-31,8155,23764,31919
47,47318,2033-12-31,8173,24078,32251
47,47318,2034-12-31,8191,24375,32566
47,47318,2035-12-31,8200,24691,32891
47,47460,1985-12-31,0,0,0
47,47460,1986-12-31,0,0,0
47,47460,1987-12-31,0,0,0
47,47460,1988-12-31,0,0,0
47,47460,1989-12-31,0,0,0
47,47460,1990-12-31,0,0,0
47,47460,1991-12-31,0,0,0
47,47460,1992-12-31,0,0,0
47,47460,1993-12-31,0,0,0
47,47460,1994-12-31,0,0,0
47,47460,1995-12-31,0,0,0
47,47460,1996-12-31,0,0,0
47,47460,1997-12-31,0,0,0
47,47460,1998-12-31,0,0,0
47,47460,1999-12-31,0,0,0
47,47460,2000-12-31,5071,6411,11482
47,47460,2001-12-31,5308,6370,11678
47,47460,2002-12-31,5491,6610,12101
47,47460,2003-12-31,5654,6865,12519
47,47460,2004-12-31,5836,7131,12967
47,47460,2005-12-31,6003,7399,13402
47,47460,2006-12-31,6168,7677,13845
47,47460,2007-12-31,6334,7967,14301
47,47460,2008-12-31,6495,8253,14748
47,47460,2009-12-31,6656,8555,15211
47,47460,2010-12-31,6818,8858,15676
47,47460,2011-12-31,6960,9158,16118
47,47460,2012-12-31,7128,9464,16592
47,47460,2013-12-31,7249,9763,17012
47,47460,2014-12-31,7408,10077,17485
47,47460,2015-12-31,7567,10350,17917
47,47460,2016-12-31,7730,10684,18414
47,47460,2017-12-31,7859,11073,18932
47,47460,2018-12-31,8132,11531,19663
47,47460,2019-12-31,8434,12051,20485
47,47460,2020-12-31,8680,12486,21166
47,47460,2021-12-31,8668,12827,21495
47,47460,2022-12-31,8596,13111,21707
47,47460,2023-12-31,8520,13384,21904
47,47460,2024-12-31,8510,13635,22145
47,47460,2025-12-31,8545,13883,22428
47,47460,2026-12-31,8552,14149,22701
47,47460,2027-12-31,8581,14386,22967
47,47460,2028-12-31,8605,14611,23216
47,47460,2029-12-31,8631,14840,23471
47,47460,2030-12-31,8661,15065,23726
47,47460,2031-12-31,8691,15263,23954
47,47460,2032-12-31,8718,15469,24187
47,47460,2033-12-31,8732,15678,24410
47,47460,2034-12-31,8760,15898,24658
47,47460,2035-12-31,8763,16089,24852
47,47541,1985-12-31,1825,11879,13704
47,47541,1986-12-31,1867,11679,13546
47,47541,1987-12-31,1898,11410,13308
47,47541,1988-12-31,1948,11065,13013
47,47541,1989-12-31,2031,10703,12734
47,47541,1990-12-31,2093,10265,12358
47,47541,1991-12-31,2232,9813,12045
47,47541,1992-12-31,2289,9389,11678
47,47541,1993-12-31,2357,9001,11358
47,47541,1994-12-31,2437,8661,11098
47,47541,1995-12-31,2484,8398,10882
47,47541,1996-12-31,2428,8413,10841
47,47541,1997-12-31,2507,8199,10706
47,47541,1998-12-31,2554,8074,10628
47,47541,1999-12-31,2512,5591,8103
47,47541,2000-12-31,2477,4460,6937
47,47541,2001-12-31,2544,4348,6892
47,47541,2002-12-31,2550,4434,6984
47,47541,2003-12-31,2576,4523,7099
47,47541,2004-12-31,2605,4622,7227
47,47541,2005-12-31,2644,4707,7351
47,47541,2006-12-31,2679,4805,7484
47,47541,2007-12-31,2713,4911,7624
47,47541,2008-12-31,2736,5044,7780
47,47541,2009-12-31,2734,5142,7876
47,47541,2010-12-31,2749,5237,7986
47,47541,2011-12-31,2771,5351,8122
47,47541,2012-12-31,2816,5433,8249
47,47541,2013-12-31,2855,5533,8388
47,47541,2014-12-31,2861,5637,8498
47,47541,2015-12-31,2904,5746,8650
47,47541,2016-12-31,2922,5895,8817
47,47541,2017-12-31,2947,5999,8946
47,47541,2018-12-31,3017,6179,9196
47,47541,2019-12-31,3041,6184,9225
47,47541,2020-12-31,3059,6231,9290
47,47541,2021-12-31,3032,6400,9432
47,47541,2022-12-31,2984,6542,9526
47,47541,2023-12-31,2935,6677,9612
47,47541,2024-12-31,2880,6801,9681
47,47541,2025-12-31,2822,6933,9755
47,47541,2026-12-31,2770,7050,9820
47,47541,2027-12-31,2712,7175,9887
47,47541,2028-12-31,2663,7280,9943
47,47541,2029-12-31,2610,7394,10004
47,47541,2030-12-31,2551,7504,10055
47,47541,2031-12-31,2497,7606,10103
47,47541,2032-12-31,2443,7706,10149
47,47541,2033-12-31,2385,7821,10206
47,47541,2034-12-31,2323,7910,10233
47,47541,2035-12-31,2265,8014,10279
47,47545,1985-12-31,0,0,0
47,47545,1986-12-31,0,0,0
47,47545,1987-12-31,0,0,0
47,47545,1988-12-31,0,0,0
47,47545,1989-12-31,0,0,0
47,47545,1990-12-31,0,0,0
47,47545,1991-12-31,0,0,0
47,47545,1992-12-31,0,0,0
47,47545,1993-12-31,0,0,0
47,47545,1994-12-31,0,0,0
47,47545,1995-12-31,0,0,0
47,47545,1996-12-31,5394,6349,11743
47,47545,1997-12-31,5484,6180,11664
47,47545,1998-12-31,5496,6122,11618
47,47545,1999-12-31,5421,6208,11629
47,47545,2000-12-31,5253,6191,11444
47,47545,2001-12-31,5371,5957,11328
47,47545,2002-12-31,5387,5965,11352
47,47545,2003-12-31,5380,5958,11338
47,47545,2004-12-31,5397,5997,11394
47,47545,2005-12-31,5414,6033,11447
47,47545,2006-12-31,5432,6043,11475
47,47545,2007-12-31,5454,6081,11535
47,47545,2008-12-31,5492,6119,11611
47,47545,2009-12-31,5514,6143,11657
47,47545,2010-12-31,5525,6160,11685
47,47545,2011-12-31,5542,6181,11723
47,47545,2012-12-31,5537,6211,11748
47,47545,2013-12-31,5504,6218,11722
47,47545,2014-12-31,5548,6245,11793
47,47545,2015-12-31,5582,6233,11815
47,47545,2016-12-31,5593,6269,11862
47,47545,2017-12-31,5626,6291,11917
47,47545,2018-12-31,5710,6383,12093
47,47545,2019-12-31,5898,6650,12548
47,47545,2020-12-31,6042,6866,12908
47,47545,2021-12-31,6056,7052,13108
47,47545,2022-12-31,6030,7208,13238
47,47545,2023-12-31,6000,7358,13358
47,47545,2024-12-31,6001,7515,13516
47,47545,2025-12-31,6018,7652,13670
47,47545,2026-12-31,6025,7791,13816
47,47545,2027-12-31,6041,7923,13964
47,47545,2028-12-31,6052,8060,14112
47,47545,2029-12-31,6073,8177,14250
47,47545,2030-12-31,6102,8279,14381
47,47545,2031-12-31,6114,8399,14513
47,47545,2032-12-31,6132,8514,14646
47,47545,2033-12-31,6153,8620,14773
47,47545,2034-12-31,6146,8732,14878
47,47545,2035-12-31,6166,8851,15017
47,47551,1985-12-31,12728,24907,37635
47,47551,1986-12-31,12955,25136,38091
47,47551,1987-12-31,13327,25212,38539
47,47551,1988-12-31,13759,25131,38890
47,47551,1989-12-31,14244,24850,39094
47,47551,1990-12-31,14802,24441,39243
47,47551,1991-12-31,15375,23970,39345
47,47551,1992-12-31,15948,23496,39444
47,47551,1993-12-31,16488,23091,39579
47,47551,1994-12-31,16962,22811,39773
47,47551,1995-12-31,17386,22666,40052
47,47551,1996-12-31,17294,23293,40587
47,47551,1997-12-31,17686,23234,40920
47,47551,1998-12-31,17965,23481,41446
47,47551,1999-12-31,17847,11596,29443
47,47551,2000-12-31,17519,11739,29258
47,47551,2001-12-31,18057,11422,29479
47,47551,2002-12-31,18258,11608,29866
47,47551,2003-12-31,18478,11803,30281
47,47551,2004-12-31,18677,12005,30682
47,47551,2005-12-31,18892,12235,31127
47,47551,2006-12-31,19100,12475,31575
47,47551,2007-12-31,19325,12713,32038
47,47551,2008-12-31,19543,12977,32520
47,47551,2009-12-31,19731,13190,32921
47,47551,2010-12-31,19963,13421,33384
47,47551,2011-12-31,20104,13673,33777
47,47551,2012-12-31,20325,13885,34210
47,47551,2013-12-31,20521,14123,34644
47,47551,2014-12-31,20662,14332,34994
47,47551,2015-12-31,20811,14568,35379
47,47551,2016-12-31,21050,14831,35881
47,47551,2017-12-31,21316,15121,36437
47,47551,2018-12-31,21777,15564,37341
47,47551,2019-12-31,22295,15908,38203
47,47551,2020-12-31,22722,16251,38973
47,47551,2021-12-31,22878,16692,39570
47,47551,2022-12-31,22901,17061,39962
47,47551,2023-12-31,22908,17415,40323
47,47551,2024-12-31,22907,17767,40674
47,47551,2025-12-31,22906,18087,40993
47,47551,2026-12-31,22908,18402,41310
47,47551,2027-12-31,22922,18715,41637
47,47551,2028-12-31,22942,19005,41947
47,47551,2029-12-31,22975,19295,42270
47,47551,2030-12-31,23031,19575,42606
47,47551,2031-12-31,23089,19845,42934
47,47551,2032-12-31,23127,20110,43237
47,47551,2033-12-31,23165,20368,43533
47,47551,2034-12-31,23188,20623,43811
47,47551,2035-12-31,23203,20887,44090
47,47555,1985-12-31,24970,40983,65953
47,47555,1986-12-31,25617,39882,65499
47,47555,1987-12-31,26413,38564,64977
47,47555,1988-12-31,27394,37047,64441
47,47555,1989-12-31,28499,35301,63800
47,47555,1990-12-31,29742,33459,63201
47,47555,1991-12-31,31036,31633,62669
47,47555,1992-12-31,32321,29869,62190
47,47555,1993-12-31,33521,28265,61786
47,47555,1994-12-31,34617,26899,61516
47,47555,1995-12-31,35619,25736,61355
47,47555,1996-12-31,35562,25432,60994
47,47555,1997-12-31,36477,24393,60870
47,47555,1998-12-31,37175,23730,60905
47,47555,1999-12-31,37045,23699,60744
47,47555,2000-12-31,36450,8658,45108
47,47555,2001-12-31,37671,8564,46235
47,47555,2002-12-31,38222,8839,47061
47,47555,2003-12-31,38753,9127,47880
47,47555,2004-12-31,39285,9430,48715
47,47555,2005-12-31,39835,9753,49588
47,47555,2006-12-31,40386,10082,50468
47,47555,2007-12-31,40946,10431,51377
47,47555,2008-12-31,41482,10777,52259
47,47555,2009-12-31,42009,11122,53131
47,47555,2010-12-31,42531,11477,54008
47,47555,2011-12-31,43029,11831,54860
47,47555,2012-12-31,43517,12189,55706
47,47555,2013-12-31,43981,12534,56515
47,47555,2014-12-31,44437,12898,57335
47,47555,2015-12-31,44867,13234,58101
47,47555,2016-12-31,45414,13637,59051
47,47555,2017-12-31,46077,14065,60142
47,47555,2018-12-31,47141,14625,61766
47,47555,2019-12-31,48303,14723,63026
47,47555,2020-12-31,49028,14989,64017
47,47555,2021-12-31,49602,15396,64998
47,47555,2022-12-31,49905,15736,65641
47,47555,2023-12-31,50172,16063,66235
47,47555,2024-12-31,50304,16389,66693
47,47555,2025-12-31,50416,16686,67102
47,47555,2026-12-31,50545,16977,67522
47,47555,2027-12-31,50677,17267,67944
47,47555,2028-12-31,50815,17529,68344
47,47555,2029-12-31,50957,17802,68759
47,47555,2030-12-31,51128,18065,69193
47,47555,2031-12-31,51302,18305,69607
47,47555,2032-12-31,51483,18558,70041
47,47555,2033-12-31,51604,18804,70408
47,47555,2034-12-31,51706,19060,70766
47,47555,2035-12-31,51789,19280,71069
47,47570,1985-12-31,4475,10314,14789
47,47570,1986-12-31,4667,10540,15207
47,47570,1987-12-31,4852,10701,15553
47,47570,1988-12-31,5081,10773,15854
47,47570,1989-12-31,5334,10816,16150
47,47570,1990-12-31,5602,10736,16338
47,47570,1991-12-31,5874,10668,16542
47,47570,1992-12-31,6160,10555,16715
47,47570,1993-12-31,6442,10460,16902
47,47570,1994-12-31,6680,10423,17103
47,47570,1995-12-31,6917,10459,17376
47,47570,1996-12-31,6948,10803,17751
47,47570,1997-12-31,7149,10870,18019
47,47570,1998-12-31,7320,11099,18419
47,47570,1999-12-31,7339,11610,18949
47,47570,2000-12-31,7245,11921,19166
47,47570,2001-12-31,7522,11798,19320
47,47570,2002-12-31,7662,12152,19814
47,47570,2003-12-31,7797,12552,20349
47,47570,2004-12-31,7931,12959,20890
47,47570,2005-12-31,8072,13392,21464
47,47570,2006-12-31,8218,13827,22045
47,47570,2007-12-31,8343,14287,22630
47,47570,2008-12-31,8475,14745,23220
47,47570,2009-12-31,8633,15223,23856
47,47570,2010-12-31,8758,15691,24449
47,47570,2011-12-31,8884,16170,25054
47,47570,2012-12-31,9033,16644,25677
47,47570,2013-12-31,9144,17121,26265
47,47570,2014-12-31,9251,17577,26828
47,47570,2015-12-31,9317,18074,27391
47,47570,2016-12-31,9467,18597,28064
47,47570,2017-12-31,9637,19179,28816
47,47570,2018-12-31,9897,19927,29824
47,47570,2019-12-31,10230,20921,31151
47,47570,2020-12-31,10488,21700,32188
47,47570,2021-12-31,10395,22293,32688
47,47570,2022-12-31,10225,22786,33011
47,47570,2023-12-31,10051,23259,33310
47,47570,2024-12-31,10002,23697,33699
47,47570,2025-12-31,10019,24134,34153
47,47570,2026-12-31,10035,24568,34603
47,47570,2027-12-31,10062,24984,35046
47,47570,2028-12-31,10095,25380,35475
47,47570,2029-12-31,10120,25760,35880
47,47570,2030-12-31,10150,26138,36288
47,47570,2031-12-31,10181,26505,36686
47,47570,2032-12-31,10206,26861,37067
47,47570,2033-12-31,10234,27217,37451
47,47570,2034-12-31,10265,27576,37841
47,47570,2035-12-31,10280,27927,38207
47,47605,1985-12-31,3616,7171,10787
47,47605,1986-12-31,3772,7028,10800
47,47605,1987-12-31,3859,6846,10705
47,47605,1988-12-31,4031,6622,10653
47,47605,1989-12-31,4220,6378,10598
47,47605,1990-12-31,4442,6100,10542
47,47605,1991-12-31,4639,5808,10447
47,47605,1992-12-31,4837,5525,10362
47,47605,1993-12-31,5033,5267,10300
47,47605,1994-12-31,5215,5042,10257
47,47605,1995-12-31,5379,4839,10218
47,47605,1996-12-31,5376,4847,10223
47,47605,1997-12-31,5528,4722,10250
47,47605,1998-12-31,5644,4620,10264
47,47605,1999-12-31,5622,4648,10270
47,47605,2000-12-31,5551,4607,10158
47,47605,2001-12-31,5744,4388,10132
47,47605,2002-12-31,5853,4372,10225
47,47605,2003-12-31,5956,4345,10301
47,47605,2004-12-31,6030,4373,10403
47,47605,2005-12-31,6110,4328,10438
47,47605,2006-12-31,6210,4359,10569
47,47605,2007-12-31,6328,4313,10641
47,47605,2008-12-31,6413,4299,10712
47,47605,2009-12-31,6498,4293,10791
47,47605,2010-12-31,6576,4264,10840
47,47605,2011-12-31,6685,4240,10925
47,47605,2012-12-31,6780,4206,10986
47,47605,2013-12-31,6788,4192,10980
47,47605,2014-12-31,6903,4154,11057
47,47605,2015-12-31,7022,4108,11130
47,47605,2016-12-31,7088,4097,11185
47,47605,2017-12-31,7194,4043,11237
47,47605,2018-12-31,7375,4070,11445
47,47605,2019-12-31,7582,4120,11702
47,47605,2020-12-31,7731,4198,11929
47,47605,2021-12-31,7800,4312,12112
47,47605,2022-12-31,7825,4407,12232
47,47605,2023-12-31,7843,4499,12342
47,47605,2024-12-31,7850,4587,12437
47,47605,2025-12-31,7864,4675,12539
47,47605,2026-12-31,7862,4757,12619
47,47605,2027-12-31,7866,4832,12698
47,47605,2028-12-31,7866,4913,12779
47,47605,2029-12-31,7884,4983,12867
47,47605,2030-12-31,7894,5060,12954
47,47605,2031-12-31,7912,5128,13040
47,47605,2032-12-31,7914,5197,13111
47,47605,2033-12-31,7921,5260,13181
47,47605,2034-12-31,7932,5335,13267
47,47605,2035-12-31,7925,5399,13324
47,47660,1985-12-31,0,0,0
47,47660,1986-12-31,0,0,0
47,47660,1987-12-31,0,0,0
47,47660,1988-12-31,0,0,0
47,47660,1989-12-31,0,0,0
47,47660,1990-12-31,0,0,0
47,47660,1991-12-31,0,0,0
47,47660,1992-12-31,0,0,0
47,47660,1993-12-31,0,0,0
47,47660,1994-12-31,0,0,0
47,47660,1995-12-31,0,0,0
47,47660,1996-12-31,0,0,0
47,47660,1997-12-31,0,0,0
47,47660,1998-12-31,0,0,0
47,47660,1999-12-31,3131,8136,11267
47,47660,2000-12-31,3086,8238,11324
47,47660,2001-12-31,3239,8017,11256
47,47660,2002-12-31,3330,8163,11493
47,47660,2003-12-31,3388,8304,11692
47,47660,2004-12-31,3487,8456,11943
47,47660,2005-12-31,3537,8611,12148
47,47660,2006-12-31,3622,8770,12392
47,47660,2007-12-31,3675,8959,12634
47,47660,2008-12-31,3764,9135,12899
47,47660,2009-12-31,3863,9311,13174
47,47660,2010-12-31,3961,9489,13450
47,47660,2011-12-31,4008,9666,13674
47,47660,2012-12-31,4049,9855,13904
47,47660,2013-12-31,4132,10015,14147
47,47660,2014-12-31,4209,10191,14400
47,47660,2015-12-31,4279,10371,14650
47,47660,2016-12-31,4359,10549,14908
47,47660,2017-12-31,4446,10785,15231
47,47660,2018-12-31,4559,11085,15644
47,47660,2019-12-31,4734,11513,16247
47,47660,2020-12-31,4881,11843,16724
47,47660,2021-12-31,4820,12164,16984
47,47660,2022-12-31,4719,12433,17152
47,47660,2023-12-31,4616,12691,17307
47,47660,2024-12-31,4597,12938,17535
47,47660,2025-12-31,4596,13167,17763
47,47660,2026-12-31,4612,13403,18015
47,47660,2027-12-31,4615,13632,18247
47,47660,2028-12-31,4633,13855,18488
47,47660,2029-12-31,4642,14058,18700
47,47660,2030-12-31,4661,14253,18914
47,47660,2031-12-31,4679,14454,19133
47,47660,2032-12-31,4683,14655,19338
47,47660,2033-12-31,4701,14845,19546
47,47660,2034-12-31,4720,15045,19765
47,47660,2035-12-31,4719,15219,19938
47,47675,1985-12-31,4224,3226,7450
47,47675,1986-12-31,4341,3225,7566
47,47675,1987-12-31,4434,3153,7587
47,47675,1988-12-31,4584,3128,7712
47,47675,1989-12-31,4767,3069,7836
47,47675,1990-12-31,4946,2993,7939
47,47675,1991-12-31,5141,2904,8045
47,47675,1992-12-31,5313,2803,8116
47,47675,1993-12-31,5485,2723,8208
47,47675,1994-12-31,5642,2654,8296
47,47675,1995-12-31,5778,2621,8399
47,47675,1996-12-31,5742,2658,8400
47,47675,1997-12-31,5876,2627,8503
47,47675,1998-12-31,5962,2625,8587
47,47675,1999-12-31,5923,2722,8645
47,47675,2000-12-31,5804,2736,8540
47,47675,2001-12-31,5972,2662,8634
47,47675,2002-12-31,6045,2705,8750
47,47675,2003-12-31,6103,2741,8844
47,47675,2004-12-31,6169,2781,8950
47,47675,2005-12-31,6259,2838,9097
47,47675,2006-12-31,6332,2903,9235
47,47675,2007-12-31,6390,2960,9350
47,47675,2008-12-31,6434,3016,9450
47,47675,2009-12-31,6482,3051,9533
47,47675,2010-12-31,6567,3108,9675
47,47675,2011-12-31,6661,3146,9807
47,47675,2012-12-31,6716,3199,9915
47,47675,2013-12-31,6710,3259,9969
47,47675,2014-12-31,6791,3313,10104
47,47675,2015-12-31,6889,3359,10248
47,47675,2016-12-31,6929,3448,10377
47,47675,2017-12-31,7035,3476,10511
47,47675,2018-12-31,7151,3582,10733
47,47675,2019-12-31,7365,3678,11043
47,47675,2020-12-31,7520,3775,11295
47,47675,2021-12-31,7591,3877,11468
47,47675,2022-12-31,7619,3963,11582
47,47675,2023-12-31,7641,4045,11686
47,47675,2024-12-31,7664,4123,11787
47,47675,2025-12-31,7672,4195,11867
47,47675,2026-12-31,7688,4272,11960
47,47675,2027-12-31,7704,4344,12048
47,47675,2028-12-31,7731,4400,12131
47,47675,2029-12-31,7755,4477,12232
47,47675,2030-12-31,7774,4544,12318
47,47675,2031-12-31,7794,4606,12400
47,47675,2032-12-31,7817,4666,12483
47,47675,2033-12-31,7835,4725,12560
47,47675,2034-12-31,7854,4788,12642
47,47675,2035-12-31,7861,4851,12712
47,47692,1985-12-31,2878,11547,14425
47,47692,1986-12-31,2973,11548,14521
47,47692,1987-12-31,3073,11449,14522
47,47692,1988-12-31,3253,11265,14518
47,47692,1989-12-31,3385,11063,14448
47,47692,1990-12-31,3552,10785,14337
47,47692,1991-12-31,3732,10482,14214
47,47692,1992-12-31,3907,10169,14076
47,47692,1993-12-31,4074,9903,13977
47,47692,1994-12-31,4222,9660,13882
47,47692,1995-12-31,4360,9514,13874
47,47692,1996-12-31,4371,9683,14054
47,47692,1997-12-31,4480,9585,14065
47,47692,1998-12-31,4590,9602,14192
47,47692,1999-12-31,4604,9901,14505
47,47692,2000-12-31,4514,10022,14536
47,47692,2001-12-31,4715,9758,14473
47,47692,2002-12-31,4776,9924,14700
47,47692,2003-12-31,4839,10101,14940
47,47692,2004-12-31,4938,10292,15230
47,47692,2005-12-31,5007,10487,15494
47,47692,2006-12-31,5084,10702,15786
47,47692,2007-12-31,5167,10915,16082
47,47692,2008-12-31,5244,11125,16369
47,47692,2009-12-31,5314,11340,16654
47,47692,2010-12-31,5399,11552,16951
47,47692,2011-12-31,5497,11762,17259
47,47692,2012-12-31,5558,11979,17537
47,47692,2013-12-31,5607,12186,17793
47,47692,2014-12-31,5683,12373,18056
47,47692,2015-12-31,5743,12568,18311
47,47692,2016-12-31,5842,12809,18651
47,47692,2017-12-31,5940,13063,19003
47,47692,2018-12-31,6071,13452,19523
47,47692,2019-12-31,6251,13920,20171
47,47692,2020-12-31,6392,14304,20696
47,47692,2021-12-31,6321,14692,21013
47,47692,2022-12-31,6204,15017,21221
47,47692,2023-12-31,6084,15329,21413
47,47692,2024-12-31,6040,15629,21669
47,47692,2025-12-31,6049,15917,21966
47,47692,2026-12-31,6043,16198,22241
47,47692,2027-12-31,6059,16469,22528
47,47692,2028-12-31,6079,16741,22820
47,47692,2029-12-31,6101,16989,23090
47,47692,2030-12-31,6121,17243,23364
47,47692,2031-12-31,6139,17482,23621
47,47692,2032-12-31,6154,17716,23870
47,47692,2033-12-31,6157,17959,24116
47,47692,2034-12-31,6183,18172,24355
47,47692,2035-12-31,6186,18412,24598
47,47703,1985-12-31,1307,6703,8010
47,47703,1986-12-31,1321,6741,8062
47,47703,1987-12-31,1335,6787,8122
47,47703,1988-12-31,1339,6754,8093
47,47703,1989-12-31,1365,6706,8071
47,47703,1990-12-31,1371,6596,7967
47,47703,1991-12-31,1413,6463,7876
47,47703,1992-12-31,1465,6346,7811
47,47703,1993-12-31,1487,6232,7719
47,47703,1994-12-31,1496,6151,7647
47,47703,1995-12-31,1510,6139,7649
47,47703,1996-12-31,1502,6308,7810
47,47703,1997-12-31,1511,6269,7780
47,47703,1998-12-31,1519,6335,7854
47,47703,1999-12-31,1491,6579,8070
47,47703,2000-12-31,1427,6718,8145
47,47703,2001-12-31,1474,6610,8084
47,47703,2002-12-31,1466,6768,8234
47,47703,2003-12-31,1489,6943,8432
47,47703,2004-12-31,1464,7113,8577
47,47703,2005-12-31,1457,7313,8770
47,47703,2006-12-31,1461,7505,8966
47,47703,2007-12-31,1424,7714,9138
47,47703,2008-12-31,1412,7910,9322
47,47703,2009-12-31,1400,8130,9530
47,47703,2010-12-31,1402,8350,9752
47,47703,2011-12-31,1388,8546,9934
47,47703,2012-12-31,1395,8753,10148
47,47703,2013-12-31,1398,8964,10362
47,47703,2014-12-31,1408,9161,10569
47,47703,2015-12-31,1415,9378,10793
47,47703,2016-12-31,1426,9605,11031
47,47703,2017-12-31,1437,9869,11306
47,47703,2018-12-31,1470,10211,11681
47,47703,2019-12-31,1501,10603,12104
47,47703,2020-12-31,1529,10910,12439
47,47703,2021-12-31,1426,11206,12632
47,47703,2022-12-31,1303,11454,12757
47,47703,2023-12-31,1181,11692,12873
47,47703,2024-12-31,1129,11921,13050
47,47703,2025-12-31,1112,12136,13248
47,47703,2026-12-31,1113,12358,13471
47,47703,2027-12-31,1110,12556,13666
47,47703,2028-12-31,1104,12754,13858
47,47703,2029-12-31,1115,12957,14072
47,47703,2030-12-31,1126,13136,14262
47,47703,2031-12-31,1127,13323,14450
47,47703,2032-12-31,1124,13503,14627
47,47703,2033-12-31,1134,13695,14829
47,47703,2034-12-31,1139,13865,15004
47,47703,2035-12-31,1131,14041,15172
47,47707,1985-12-31,5785,24028,29813
47,47707,1986-12-31,6036,23999,30035
47,47707,1987-12-31,6367,23832,30199
47,47707,1988-12-31,6673,23533,30206
47,47707,1989-12-31,7018,23022,30040
47,47707,1990-12-31,7405,22424,29829
47,47707,1991-12-31,7808,21777,29585
47,47707,1992-12-31,8202,21162,29364
47,47707,1993-12-31,8590,20598,29188
47,47707,1994-12-31,8969,20183,29152
47,47707,1995-12-31,9302,19887,29189
47,47707,1996-12-31,9355,11691,21046
47,47707,1997-12-31,9672,11911,21583
47,47707,1998-12-31,9906,12291,22197
47,47707,1999-12-31,9956,13018,22974
47,47707,2000-12-31,9875,25504,35379
47,47707,2001-12-31,10263,23852,34115
47,47707,2002-12-31,10477,23230,33707
47,47707,2003-12-31,10684,22604,33288
47,47707,2004-12-31,10886,22014,32900
47,47707,2005-12-31,11117,21386,32503
47,47707,2006-12-31,11317,20766,32083
47,47707,2007-12-31,11531,20136,31667
47,47707,2008-12-31,11721,19469,31190
47,47707,2009-12-31,11944,18797,30741
47,47707,2010-12-31,12126,18090,30216
47,47707,2011-12-31,12325,17332,29657
47,47707,2012-12-31,12526,16553,29079
47,47707,2013-12-31,12733,15767,28500
47,47707,2014-12-31,12893,14920,27813
47,47707,2015-12-31,12998,14062,27060
47,47707,2016-12-31,13224,13217,26441
47,47707,2017-12-31,13486,12371,25857
47,47707,2018-12-31,13851,11587,25438
47,47707,2019-12-31,14317,11433,25750
47,47707,2020-12-31,14674,11401,26075
47,47707,2021-12-31,14765,11710,26475
47,47707,2022-12-31,14768,11969,26737
47,47707,2023-12-31,14761,12218,26979
47,47707,2024-12-31,14787,12456,27243
47,47707,2025-12-31,14814,12704,27518
47,47707,2026-12-31,14854,12918,27772
47,47707,2027-12-31,14888,13129,28017
47,47707,2028-12-31,14932,13347,28279
47,47707,2029-12-31,14985,13536,28521
47,47707,2030-12-31,15041,13733,28774
47,47707,2031-12-31,15098,13919,29017
47,47707,2032-12-31,15131,14117,29248
47,47707,2033-12-31,15171,14297,29468
47,47707,2034-12-31,15186,14466,29652
47,47707,2035-12-31,15210,14663,29873
47,47720,1985-12-31,0,0,0
47,47720,1986-12-31,0,0,0
47,47720,1987-12-31,0,0,0
47,47720,1988-12-31,0,0,0
47,47720,1989-12-31,0,0,0
47,47720,1990-12-31,0,0,0
47,47720,1991-12-31,0,0,0
47,47720,1992-12-31,0,0,0
47,47720,1993-12-31,0,0,0
47,47720,1994-12-31,0,0,0
47,47720,1995-12-31,0,0,0
47,47720,1996-12-31,0,0,0
47,47720,1997-12-31,0,0,0
47,47720,1998-12-31,0,0,0
47,47720,1999-12-31,0,0,0
47,47720,2000-12-31,6676,4551,11227
47,47720,2001-12-31,6798,4349,11147
47,47720,2002-12-31,6782,4324,11106
47,47720,2003-12-31,6762,4298,11060
47,47720,2004-12-31,6752,4286,11038
47,47720,2005-12-31,6710,4263,10973
47,47720,2006-12-31,6692,4238,10930
47,47720,2007-12-31,6671,4224,10895
47,47720,2008-12-31,6661,4200,10861
47,47720,2009-12-31,6648,4193,10841
47,47720,2010-12-31,6636,4181,10817
47,47720,2011-12-31,6613,4140,10753
47,47720,2012-12-31,6593,4121,10714
47,47720,2013-12-31,6548,4089,10637
47,47720,2014-12-31,6565,4025,10590
47,47720,2015-12-31,6572,4027,10599
47,47720,2016-12-31,6539,3982,10521
47,47720,2017-12-31,6557,3952,10509
47,47720,2018-12-31,6616,3959,10575
47,47720,2019-12-31,6838,4139,10977
47,47720,2020-12-31,7009,4286,11295
47,47720,2021-12-31,7067,4403,11470
47,47720,2022-12-31,7084,4500,11584
47,47720,2023-12-31,7096,4593,11689
47,47720,2024-12-31,7113,4692,11805
47,47720,2025-12-31,7125,4777,11902
47,47720,2026-12-31,7141,4860,12001
47,47720,2027-12-31,7172,4941,12113
47,47720,2028-12-31,7189,5027,12216
47,47720,2029-12-31,7212,5095,12307
47,47720,2030-12-31,7225,5165,12390
47,47720,2031-12-31,7260,5236,12496
47,47720,2032-12-31,7287,5317,12604
47,47720,2033-12-31,7297,5382,12679
47,47720,2034-12-31,7328,5456,12784
47,47720,2035-12-31,7333,5512,12845
47,47745,1985-12-31,7817,9495,17312
47,47745,1986-12-31,8003,9493,17496
47,47745,1987-12-31,8287,9496,17783
47,47745,1988-12-31,8565,9421,17986
47,47745,1989-12-31,8893,9297,18190
47,47745,1990-12-31,9261,9111,18372
47,47745,1991-12-31,9633,8904,18537
47,47745,1992-12-31,10023,8687,18710
47,47745,1993-12-31,10379,8505,18884
47,47745,1994-12-31,10722,8365,19087
47,47745,1995-12-31,11008,8277,19285
47,47745,1996-12-31,10982,8479,19461
47,47745,1997-12-31,11245,8415,19660
47,47745,1998-12-31,11438,8479,19917
47,47745,1999-12-31,11389,8775,20164
47,47745,2000-12-31,11197,8928,20125
47,47745,2001-12-31,11552,8751,20303
47,47745,2002-12-31,11708,8923,20631
47,47745,2003-12-31,11866,9150,21016
47,47745,2004-12-31,11999,9324,21323
47,47745,2005-12-31,12160,9560,21720
47,47745,2006-12-31,12308,9787,22095
47,47745,2007-12-31,12474,10019,22493
47,47745,2008-12-31,12634,10263,22897
47,47745,2009-12-31,12788,10500,23288
47,47745,2010-12-31,12920,10752,23672
47,47745,2011-12-31,13078,10989,24067
47,47745,2012-12-31,13198,11217,24415
47,47745,2013-12-31,13411,11462,24873
47,47745,2014-12-31,13421,11687,25108
47,47745,2015-12-31,13537,11923,25460
47,47745,2016-12-31,13701,12190,25891
47,47745,2017-12-31,13908,12515,26423
47,47745,2018-12-31,14239,12889,27128
47,47745,2019-12-31,14694,13560,28254
47,47745,2020-12-31,15039,14120,29159
47,47745,2021-12-31,15106,14506,29612
47,47745,2022-12-31,15078,14827,29905
47,47745,2023-12-31,15040,15135,30175
47,47745,2024-12-31,15044,15437,30481
47,47745,2025-12-31,15063,15720,30783
47,47745,2026-12-31,15097,15993,31090
47,47745,2027-12-31,15130,16268,31398
47,47745,2028-12-31,15173,16535,31708
47,47745,2029-12-31,15222,16787,32009
47,47745,2030-12-31,15277,17026,32303
47,47745,2031-12-31,15324,17271,32595
47,47745,2032-12-31,15372,17502,32874
47,47745,2033-12-31,15412,17727,33139
47,47745,2034-12-31,15445,17963,33408
47,47745,2035-12-31,15468,18195,33663
47,47798,1985-12-31,5324,13094,18418
47,47798,1986-12-31,5366,12951,18317
47,47798,1987-12-31,5432,12729,18161
47,47798,1988-12-31,5526,12426,17952
47,47798,1989-12-31,5678,12087,17765
47,47798,1990-12-31,5804,11664,17468
47,47798,1991-12-31,5948,11238,17186
47,47798,1992-12-31,6100,10807,16907
47,47798,1993-12-31,6207,10426,16633
47,47798,1994-12-31,6319,10116,16435
47,47798,1995-12-31,6407,9873,16280
47,47798,1996-12-31,6301,9965,16266
47,47798,1997-12-31,6367,9776,16143
47,47798,1998-12-31,6404,9689,16093
47,47798,1999-12-31,6290,9911,16201
47,47798,2000-12-31,6133,5695,11828
47,47798,2001-12-31,6241,5505,11746
47,47798,2002-12-31,6236,5552,11788
47,47798,2003-12-31,6252,5612,11864
47,47798,2004-12-31,6272,5672,11944
47,47798,2005-12-31,6287,5738,12025
47,47798,2006-12-31,6295,5810,12105
47,47798,2007-12-31,6302,5883,12185
47,47798,2008-12-31,6327,5966,12293
47,47798,2009-12-31,6331,6030,12361
47,47798,2010-12-31,6348,6104,12452
47,47798,2011-12-31,6358,6173,12531
47,47798,2012-12-31,6340,6234,12574
47,47798,2013-12-31,6335,6302,12637
47,47798,2014-12-31,6369,6360,12729
47,47798,2015-12-31,6378,6419,12797
47,47798,2016-12-31,6403,6489,12892
47,47798,2017-12-31,6450,6582,13032
47,47798,2018-12-31,6511,6725,13236
47,47798,2019-12-31,6557,6797,13354
47,47798,2020-12-31,6600,6903,13503
47,47798,2021-12-31,6620,7090,13710
47,47798,2022-12-31,6599,7247,13846
47,47798,2023-12-31,6573,7398,13971
47,47798,2024-12-31,6563,7535,14098
47,47798,2025-12-31,6548,7678,14226
47,47798,2026-12-31,6555,7810,14365
47,47798,2027-12-31,6552,7936,14488
47,47798,2028-12-31,6558,8070,14628
47,47798,2029-12-31,6570,8186,14756
47,47798,2030-12-31,6575,8309,14884
47,47798,2031-12-31,6600,8426,15026
47,47798,2032-12-31,6621,8538,15159
47,47798,2033-12-31,6635,8656,15291
47,47798,2034-12-31,6638,8768,15406
47,47798,2035-12-31,6648,8871,15519
47,47960,1985-12-31,0,0,0
47,47960,1986-12-31,0,0,0
47,47960,1987-12-31,0,0,0
47,47960,1988-12-31,0,0,0
47,47960,1989-12-31,0,0,0
47,47960,1990-12-31,0,0,0
47,47960,1991-12-31,0,0,0
47,47960,1992-12-31,0,0,0
47,47960,1993-12-31,0,0,0
47,47960,1994-12-31,0,0,0
47,47960,1995-12-31,0,0,0
47,47960,1996-12-31,0,0,0
47,47960,1997-12-31,0,0,0
47,47960,1998-12-31,0,0,0
47,47960,1999-12-31,0,0,0
47,47960,2000-12-31,2879,5051,7930
47,47960,2001-12-31,2978,4872,7850
47,47960,2002-12-31,3025,4925,7950
47,47960,2003-12-31,3103,4992,8095
47,47960,2004-12-31,3107,5050,8157
47,47960,2005-12-31,3226,5091,8317
47,47960,2006-12-31,3276,5164,8440
47,47960,2007-12-31,3328,5243,8571
47,47960,2008-12-31,3367,5308,8675
47,47960,2009-12-31,3419,5383,8802
47,47960,2010-12-31,3459,5451,8910
47,47960,2011-12-31,3468,5507,8975
47,47960,2012-12-31,3500,5577,9077
47,47960,2013-12-31,3548,5642,9190
47,47960,2014-12-31,3598,5693,9291
47,47960,2015-12-31,3637,5746,9383
47,47960,2016-12-31,3695,5819,9514
47,47960,2017-12-31,3750,5913,9663
47,47960,2018-12-31,3846,6049,9895
47,47960,2019-12-31,3980,6313,10293
47,47960,2020-12-31,4085,6528,10613
47,47960,2021-12-31,4073,6705,10778
47,47960,2022-12-31,4031,6853,10884
47,47960,2023-12-31,3987,6996,10983
47,47960,2024-12-31,3990,7137,11127
47,47960,2025-12-31,3985,7266,11251
47,47960,2026-12-31,3999,7393,11392
47,47960,2027-12-31,3998,7518,11516
47,47960,2028-12-31,4011,7636,11647
47,47960,2029-12-31,4029,7751,11780
47,47960,2030-12-31,4045,7860,11905
47,47960,2031-12-31,4058,7968,12026
47,47960,2032-12-31,4069,8081,12150
47,47960,2033-12-31,4075,8192,12267
47,47960,2034-12-31,4087,8301,12388
47,47960,2035-12-31,4088,8394,12482
47,47980,1985-12-31,0,0,0
47,47980,1986-12-31,0,0,0
47,47980,1987-12-31,0,0,0
47,47980,1988-12-31,0,0,0
47,47980,1989-12-31,0,0,0
47,47980,1990-12-31,0,0,0
47,47980,1991-12-31,0,0,0
47,47980,1992-12-31,0,0,0
47,47980,1993-12-31,0,0,0
47,47980,1994-12-31,0,0,0
47,47980,1995-12-31,0,0,0
47,47980,1996-12-31,0,0,0
47,47980,1997-12-31,0,0,0
47,47980,1998-12-31,0,0,0
47,47980,1999-12-31,0,0,0
47,47980,2000-12-31,3191,35683,38874
47,47980,2001-12-31,3345,35498,38843
47,47980,2002-12-31,3413,36819,40232
47,47980,2003-12-31,3460,38187,41647
47,47980,2004-12-31,3534,39648,43182
47,47980,2005-12-31,3558,41158,44716
47,47980,2006-12-31,3634,42744,46378
47,47980,2007-12-31,3704,44337,48041
47,47980,2008-12-31,3763,45971,49734
47,47980,2009-12-31,3828,47643,51471
47,47980,2010-12-31,3890,49324,53214
47,47980,2011-12-31,3964,51002,54966
47,47980,2012-12-31,3963,52692,56655
47,47980,2013-12-31,4051,54370,58421
47,47980,2014-12-31,4126,56084,60210
47,47980,2015-12-31,4222,57789,62011
47,47980,2016-12-31,4264,59642,63906
47,47980,2017-12-31,4328,61715,66043
47,47980,2018-12-31,4415,64307,68722
47,47980,2019-12-31,4563,67015,71578
47,47980,2020-12-31,4676,69257,73933
47,47980,2021-12-31,3944,71137,75081
47,47980,2022-12-31,3115,72709,75824
47,47980,2023-12-31,2291,74219,76510
47,47980,2024-12-31,1986,75681,77667
47,47980,2025-12-31,1898,77092,78990
47,47980,2026-12-31,1874,78460,80334
47,47980,2027-12-31,1872,79788,81660
47,47980,2028-12-31,1875,81061,82936
47,47980,2029-12-31,1890,82292,84182
47,47980,2030-12-31,1888,83484,85372
47,47980,2031-12-31,1896,84639,86535
47,47980,2032-12-31,1904,85792,87696
47,47980,2033-12-31,1909,86946,88855
47,47980,2034-12-31,1908,88073,89981
47,47980,2035-12-31,1910,89184,91094
50,50001,1985-12-31,159210,14535,173745
50,50001,1986-12-31,165693,15160,180853
50,50001,1987-12-31,172495,15793,188288
50,50001,1988-12-31,179583,16448,196031
50,50001,1989-12-31,186866,17167,204033
50,50001,1990-12-31,192394,18325,210719
50,50001,1991-12-31,203416,18812,222228
50,50001,1992-12-31,214904,19235,234139
50,50001,1993-12-31,223339,21281,244620
50,50001,1994-12-31,235778,21621,257399
50,50001,1995-12-31,245401,22619,268020
50,50001,1996-12-31,255699,23496,279195
50,50001,1997-12-31,266998,24230,291228
50,50001,1998-12-31,279301,24726,304027
50,50001,1999-12-31,292625,24992,317617
50,50001,2000-12-31,306529,25134,331663
50,50001,2001-12-31,320604,25276,345880
50,50001,2002-12-31,334203,25512,359715
50,50001,2003-12-31,347044,25913,372957
50,50001,2004-12-31,359272,26447,385719
50,50001,2005-12-31,371114,27195,398309
50,50001,2006-12-31,382311,28003,410314
50,50001,2007-12-31,392909,28838,421747
50,50001,2008-12-31,403111,29753,432864
50,50001,2009-12-31,412922,30713,443635
50,50001,2010-12-31,422512,31666,454178
50,50001,2011-12-31,431905,32622,464527
50,50001,2012-12-31,440943,33560,474503
50,50001,2013-12-31,449709,34507,484216
50,50001,2014-12-31,458276,35445,493721
50,50001,2015-12-31,466660,36382,503042
50,50001,2016-12-31,475139,37323,512462
50,50001,2017-12-31,483405,38295,521700
50,50001,2018-12-31,492052,39223,531275
50,50001,2019-12-31,497285,41539,538824
50,50001,2020-12-31,502047,43255,545302
50,50001,2021-12-31,506145,43777,549922
50,50001,2022-12-31,509910,44263,554173
50,50001,2023-12-31,513589,44710,558299
50,50001,2024-12-31,516988,45093,562081
50,50001,2025-12-31,520150,45511,565661
50,50001,2026-12-31,523225,45895,569120
50,50001,2027-12-31,526221,46288,572509
50,50001,2028-12-31,529129,46647,575776
50,50001,2029-12-31,531922,47005,578927
50,50001,2030-12-31,534586,47352,581938
50,50001,2031-12-31,537166,47710,584876
50,50001,2032-12-31,539514,48042,587556
50,50001,2033-12-31,541716,48363,590079
50,50001,2034-12-31,543738,48680,592418
50,50001,2035-12-31,545599,48990,594589
50,50006,1985-12-31,17074,7636,24710
50,50006,1986-12-31,18214,7952,26166
50,50006,1987-12-31,19385,8257,27642
50,50006,1988-12-31,20598,8591,29189
50,50006,1989-12-31,21735,8923,30658
50,50006,1990-12-31,22730,9553,32283
50,50006,1991-12-31,24345,9790,34135
50,50006,1992-12-31,26046,9989,36035
50,50006,1993-12-31,27346,11050,38396
50,50006,1994-12-31,29171,11215,40386
50,50006,1995-12-31,30631,11724,42355
50,50006,1996-12-31,32184,12171,44355
50,50006,1997-12-31,33863,12531,46394
50,50006,1998-12-31,35680,12786,48466
50,50006,1999-12-31,37617,12904,50521
50,50006,2000-12-31,39659,12963,52622
50,50006,2001-12-31,41741,13024,54765
50,50006,2002-12-31,43744,13121,56865
50,50006,2003-12-31,45644,13320,58964
50,50006,2004-12-31,47470,13631,61101
50,50006,2005-12-31,49241,13976,63217
50,50006,2006-12-31,50948,14388,65336
50,50006,2007-12-31,52553,14834,67387
50,50006,2008-12-31,54117,15302,69419
50,50006,2009-12-31,55626,15773,71399
50,50006,2010-12-31,57101,16269,73370
50,50006,2011-12-31,58558,16747,75305
50,50006,2012-12-31,59963,17224,77187
50,50006,2013-12-31,61336,17699,79035
50,50006,2014-12-31,62668,18173,80841
50,50006,2015-12-31,63983,18636,82619
50,50006,2016-12-31,65310,19151,84461
50,50006,2017-12-31,66607,19549,86156
50,50006,2018-12-31,67906,20117,88023
50,50006,2019-12-31,68872,21252,90124
50,50006,2020-12-31,69715,22114,91829
50,50006,2021-12-31,70226,22381,92607
50,50006,2022-12-31,70694,22629,93323
50,50006,2023-12-31,71158,22859,94017
50,50006,2024-12-31,71609,23083,94692
50,50006,2025-12-31,72055,23285,95340
50,50006,2026-12-31,72488,23487,95975
50,50006,2027-12-31,72916,23671,96587
50,50006,2028-12-31,73312,23874,97186
50,50006,2029-12-31,73704,24052,97756
50,50006,2030-12-31,74092,24262,98354
50,50006,2031-12-31,74442,24439,98881
50,50006,2032-12-31,74773,24615,99388
50,50006,2033-12-31,75085,24782,99867
50,50006,2034-12-31,75347,24955,100302
50,50006,2035-12-31,75613,25106,100719
50,50110,1985-12-31,0,0,0
50,50110,1986-12-31,0,0,0
50,50110,1987-12-31,0,0,0
50,50110,1988-12-31,0,0,0
50,50110,1989-12-31,0,0,0
50,50110,1990-12-31,0,0,0
50,50110,1991-12-31,654,1273,1927
50,50110,1992-12-31,774,1313,2087
50,50110,1993-12-31,889,1427,2316
50,50110,1994-12-31,1055,1333,2388
50,50110,1995-12-31,1162,1382,2544
50,50110,1996-12-31,1301,1457,2758
50,50110,1997-12-31,1427,1437,2864
50,50110,1998-12-31,1576,1445,3021
50,50110,1999-12-31,1753,1493,3246
50,50110,2000-12-31,1921,1505,3426
50,50110,2001-12-31,2069,1482,3551
50,50110,2002-12-31,2213,1482,3695
50,50110,2003-12-31,2349,1488,3837
50,50110,2004-12-31,2519,1508,4027
50,50110,2005-12-31,2672,1531,4203
50,50110,2006-12-31,2830,1562,4392
50,50110,2007-12-31,3016,1600,4616
50,50110,2008-12-31,3130,1636,4766
50,50110,2009-12-31,3278,1676,4954
50,50110,2010-12-31,3403,1709,5112
50,50110,2011-12-31,3545,1739,5284
50,50110,2012-12-31,3672,1786,5458
50,50110,2013-12-31,3797,1853,5650
50,50110,2014-12-31,3935,1897,5832
50,50110,2015-12-31,4034,1911,5945
50,50110,2016-12-31,4147,1924,6071
50,50110,2017-12-31,4291,1973,6264
50,50110,2018-12-31,4425,2015,6440
50,50110,2019-12-31,4587,1926,6513
50,50110,2020-12-31,4708,1870,6578
50,50110,2021-12-31,4740,1892,6632
50,50110,2022-12-31,4771,1913,6684
50,50110,2023-12-31,4800,1933,6733
50,50110,2024-12-31,4822,1949,6771
50,50110,2025-12-31,4857,1972,6829
50,50110,2026-12-31,4884,1989,6873
50,50110,2027-12-31,4911,2007,6918
50,50110,2028-12-31,4939,2029,6968
50,50110,2029-12-31,4968,2049,7017
50,50110,2030-12-31,5002,2053,7055
50,50110,2031-12-31,5022,2069,7091
50,50110,2032-12-31,5046,2082,7128
50,50110,2033-12-31,5071,2101,7172
50,50110,2034-12-31,5093,2119,7212
50,50110,2035-12-31,5104,2133,7237
50,50124,1985-12-31,589,1349,1938
50,50124,1986-12-31,699,1443,2142
50,50124,1987-12-31,744,1477,2221
50,50124,1988-12-31,787,1545,2332
50,50124,1989-12-31,845,1580,2425
50,50124,1990-12-31,895,1646,2541
50,50124,1991-12-31,944,1694,2638
50,50124,1992-12-31,1088,1729,2817
50,50124,1993-12-31,1119,1863,2982
50,50124,1994-12-31,1217,1888,3105
50,50124,1995-12-31,1303,1986,3289
50,50124,1996-12-31,1367,2042,3409
50,50124,1997-12-31,1381,2089,3470
50,50124,1998-12-31,1488,2099,3587
50,50124,1999-12-31,1599,2101,3700
50,50124,2000-12-31,1689,2105,3794
50,50124,2001-12-31,1739,2101,3840
50,50124,2002-12-31,1823,2113,3936
50,50124,2003-12-31,1908,2150,4058
50,50124,2004-12-31,2003,2178,4181
50,50124,2005-12-31,2083,2224,4307
50,50124,2006-12-31,2170,2278,4448
50,50124,2007-12-31,2236,2331,4567
50,50124,2008-12-31,2323,2406,4729
50,50124,2009-12-31,2385,2462,4847
50,50124,2010-12-31,2465,2555,5020
50,50124,2011-12-31,2532,2605,5137
50,50124,2012-12-31,2557,2652,5209
50,50124,2013-12-31,2616,2728,5344
50,50124,2014-12-31,2693,2838,5531
50,50124,2015-12-31,2775,2943,5718
50,50124,2016-12-31,2849,2981,5830
50,50124,2017-12-31,2923,3026,5949
50,50124,2018-12-31,2993,3069,6062
50,50124,2019-12-31,3050,3080,6130
50,50124,2020-12-31,3096,3096,6192
50,50124,2021-12-31,3110,3133,6243
50,50124,2022-12-31,3124,3167,6291
50,50124,2023-12-31,3138,3200,6338
50,50124,2024-12-31,3152,3234,6386
50,50124,2025-12-31,3167,3272,6439
50,50124,2026-12-31,3188,3281,6469
50,50124,2027-12-31,3212,3311,6523
50,50124,2028-12-31,3223,3339,6562
50,50124,2029-12-31,3235,3367,6602
50,50124,2030-12-31,3258,3400,6658
50,50124,2031-12-31,3276,3414,6690
50,50124,2032-12-31,3291,3443,6734
50,50124,2033-12-31,3297,3468,6765
50,50124,2034-12-31,3306,3479,6785
50,50124,2035-12-31,3325,3517,6842
50,50150,1985-12-31,686,2451,3137
50,50150,1986-12-31,862,2628,3490
50,50150,1987-12-31,1021,2793,3814
50,50150,1988-12-31,1154,2960,4114
50,50150,1989-12-31,1272,3135,4407
50,50150,1990-12-31,1439,3355,4794
50,50150,1991-12-31,1586,3497,5083
50,50150,1992-12-31,1761,3605,5366
50,50150,1993-12-31,1899,4004,5903
50,50150,1994-12-31,2095,4087,6182
50,50150,1995-12-31,2260,4320,6580
50,50150,1996-12-31,2383,4509,6892
50,50150,1997-12-31,2568,4665,7233
50,50150,1998-12-31,2748,4809,7557
50,50150,1999-12-31,2917,4880,7797
50,50150,2000-12-31,3126,4953,8079
50,50150,2001-12-31,3352,4999,8351
50,50150,2002-12-31,3516,5062,8578
50,50150,2003-12-31,3763,5154,8917
50,50150,2004-12-31,3934,5283,9217
50,50150,2005-12-31,4103,5451,9554
50,50150,2006-12-31,4275,5629,9904
50,50150,2007-12-31,4445,5822,10267
50,50150,2008-12-31,4610,6024,10634
50,50150,2009-12-31,4771,6240,11011
50,50150,2010-12-31,4981,6457,11438
50,50150,2011-12-31,5099,6647,11746
50,50150,2012-12-31,5273,6898,12171
50,50150,2013-12-31,5439,7041,12480
50,50150,2014-12-31,5590,7297,12887
50,50150,2015-12-31,5746,7516,13262
50,50150,2016-12-31,5860,7688,13548
50,50150,2017-12-31,6021,7907,13928
50,50150,2018-12-31,6154,8146,14300
50,50150,2019-12-31,6351,8835,15186
50,50150,2020-12-31,6498,9408,15906
50,50150,2021-12-31,6520,9521,16041
50,50150,2022-12-31,6538,9627,16165
50,50150,2023-12-31,6560,9725,16285
50,50150,2024-12-31,6596,9824,16420
50,50150,2025-12-31,6633,9927,16560
50,50150,2026-12-31,6673,10015,16688
50,50150,2027-12-31,6712,10124,16836
50,50150,2028-12-31,6743,10205,16948
50,50150,2029-12-31,6778,10276,17054
50,50150,2030-12-31,6817,10362,17179
50,50150,2031-12-31,6859,10448,17307
50,50150,2032-12-31,6885,10535,17420
50,50150,2033-12-31,6915,10622,17537
50,50150,2034-12-31,6941,10704,17645
50,50150,2035-12-31,6961,10764,17725
50,50223,1985-12-31,1490,4686,6176
50,50223,1986-12-31,1575,4615,6190
50,50223,1987-12-31,1635,4593,6228
50,50223,1988-12-31,1692,4585,6277
50,50223,1989-12-31,1741,4573,6314
50,50223,1990-12-31,1788,4670,6458
50,50223,1991-12-31,1892,4574,6466
50,50223,1992-12-31,2011,4471,6482
50,50223,1993-12-31,2089,2088,4177
50,50223,1994-12-31,2203,2073,4276
50,50223,1995-12-31,2285,2110,4395
50,50223,1996-12-31,2380,2121,4501
50,50223,1997-12-31,2495,2148,4643
50,50223,1998-12-31,2604,2110,4714
50,50223,1999-12-31,2758,2103,4861
50,50223,2000-12-31,2875,2067,4942
50,50223,2001-12-31,2996,2058,5054
50,50223,2002-12-31,3095,2005,5100
50,50223,2003-12-31,3222,2014,5236
50,50223,2004-12-31,3346,2015,5361
50,50223,2005-12-31,3442,2011,5453
50,50223,2006-12-31,3559,2042,5601
50,50223,2007-12-31,3668,2068,5736
50,50223,2008-12-31,3744,2080,5824
50,50223,2009-12-31,3839,2130,5969
50,50223,2010-12-31,3945,2160,6105
50,50223,2011-12-31,4062,2193,6255
50,50223,2012-12-31,4155,2248,6403
50,50223,2013-12-31,4239,2305,6544
50,50223,2014-12-31,4279,2333,6612
50,50223,2015-12-31,4321,2331,6652
50,50223,2016-12-31,4408,2343,6751
50,50223,2017-12-31,4496,2363,6859
50,50223,2018-12-31,4576,2387,6963
50,50223,2019-12-31,4623,2396,7019
50,50223,2020-12-31,4666,2402,7068
50,50223,2021-12-31,4696,2430,7126
50,50223,2022-12-31,4725,2457,7182
50,50223,2023-12-31,4753,2482,7235
50,50223,2024-12-31,4781,2497,7278
50,50223,2025-12-31,4814,2507,7321
50,50223,2026-12-31,4836,2541,7377
50,50223,2027-12-31,4858,2546,7404
50,50223,2028-12-31,4884,2572,7456
50,50223,2029-12-31,4913,2599,7512
50,50223,2030-12-31,4932,2602,7534
50,50223,2031-12-31,4961,2611,7572
50,50223,2032-12-31,4989,2616,7605
50,50223,2033-12-31,4999,2617,7616
50,50223,2034-12-31,5028,2628,7656
50,50223,2035-12-31,5040,2639,7679
50,50226,1985-12-31,5369,5247,10616
50,50226,1986-12-31,5550,5550,11100
50,50226,1987-12-31,5741,5876,11617
50,50226,1988-12-31,5924,6223,12147
50,50226,1989-12-31,6131,6545,12676
50,50226,1990-12-31,6250,7037,13287
50,50226,1991-12-31,6612,5093,11705
50,50226,1992-12-31,6932,5072,12004
50,50226,1993-12-31,7186,5532,12718
50,50226,1994-12-31,7552,5574,13126
50,50226,1995-12-31,7837,5688,13525
50,50226,1996-12-31,8134,5813,13947
50,50226,1997-12-31,8449,5905,14354
50,50226,1998-12-31,8821,5937,14758
50,50226,1999-12-31,9208,5948,15156
50,50226,2000-12-31,9597,5886,15483
50,50226,2001-12-31,10031,5847,15878
50,50226,2002-12-31,10489,5812,16301
50,50226,2003-12-31,10851,5861,16712
50,50226,2004-12-31,11187,5908,17095
50,50226,2005-12-31,11560,6010,17570
50,50226,2006-12-31,11877,6124,18001
50,50226,2007-12-31,12185,6259,18444
50,50226,2008-12-31,12476,6396,18872
50,50226,2009-12-31,12768,6539,19307
50,50226,2010-12-31,13034,6687,19721
50,50226,2011-12-31,13308,6833,20141
50,50226,2012-12-31,13569,6971,20540
50,50226,2013-12-31,13826,7110,20936
50,50226,2014-12-31,14074,7307,21381
50,50226,2015-12-31,14267,7415,21682
50,50226,2016-12-31,14589,7522,22111
50,50226,2017-12-31,14795,7706,22501
50,50226,2018-12-31,15006,7825,22831
50,50226,2019-12-31,15119,7895,23014
50,50226,2020-12-31,15233,7962,23195
50,50226,2021-12-31,15331,8056,23387
50,50226,2022-12-31,15422,8146,23568
50,50226,2023-12-31,15515,8228,23743
50,50226,2024-12-31,15609,8321,23930
50,50226,2025-12-31,15713,8383,24096
50,50226,2026-12-31,15801,8450,24251
50,50226,2027-12-31,15893,8537,24430
50,50226,2028-12-31,15984,8603,24587
50,50226,2029-12-31,16062,8667,24729
50,50226,2030-12-31,16147,8742,24889
50,50226,2031-12-31,16212,8804,25016
50,50226,2032-12-31,16297,8869,25166
50,50226,2033-12-31,16372,8927,25299
50,50226,2034-12-31,16420,8985,25405
50,50226,2035-12-31,16472,9036,25508
50,50245,1985-12-31,248,2332,2580
50,50245,1986-12-31,260,2308,2568
50,50245,1987-12-31,278,2272,2550
50,50245,1988-12-31,291,2237,2528
50,50245,1989-12-31,308,2200,2508
50,50245,1990-12-31,308,2162,2470
50,50245,1991-12-31,331,2135,2466
50,50245,1992-12-31,342,2100,2442
50,50245,1993-12-31,362,2171,2533
50,50245,1994-12-31,389,2114,2503
50,50245,1995-12-31,391,2092,2483
50,50245,1996-12-31,410,2062,2472
50,50245,1997-12-31,400,1965,2365
50,50245,1998-12-31,423,1899,2322
50,50245,1999-12-31,403,1851,2254
50,50245,2000-12-31,432,1798,2230
50,50245,2001-12-31,446,1727,2173
50,50245,2002-12-31,436,1666,2102
50,50245,2003-12-31,440,1600,2040
50,50245,2004-12-31,460,1539,1999
50,50245,2005-12-31,471,1530,2001
50,50245,2006-12-31,491,1504,1995
50,50245,2007-12-31,480,1476,1956
50,50245,2008-12-31,489,1470,1959
50,50245,2009-12-31,527,1412,1939
50,50245,2010-12-31,521,1415,1936
50,50245,2011-12-31,541,1396,1937
50,50245,2012-12-31,557,1383,1940
50,50245,2013-12-31,570,1356,1926
50,50245,2014-12-31,573,1329,1902
50,50245,2015-12-31,584,1268,1852
50,50245,2016-12-31,581,1220,1801
50,50245,2017-12-31,581,1187,1768
50,50245,2018-12-31,590,1186,1776
50,50245,2019-12-31,596,1100,1696
50,50245,2020-12-31,601,1051,1652
50,50245,2021-12-31,603,1063,1666
50,50245,2022-12-31,604,1075,1679
50,50245,2023-12-31,605,1086,1691
50,50245,2024-12-31,596,1092,1688
50,50245,2025-12-31,600,1095,1695
50,50245,2026-12-31,608,1102,1710
50,50245,2027-12-31,609,1119,1728
50,50245,2028-12-31,615,1110,1725
50,50245,2029-12-31,617,1117,1734
50,50245,2030-12-31,619,1126,1745
50,50245,2031-12-31,626,1136,1762
50,50245,2032-12-31,626,1139,1765
50,50245,2033-12-31,629,1146,1775
50,50245,2034-12-31,631,1156,1787
50,50245,2035-12-31,633,1163,1796
50,50251,1985-12-31,1663,8821,10484
50,50251,1986-12-31,1708,9562,11270
50,50251,1987-12-31,1694,10246,11940
50,50251,1988-12-31,1703,10905,12608
50,50251,1989-12-31,1722,11625,13347
50,50251,1990-12-31,1716,12668,14384
50,50251,1991-12-31,1769,13260,15029
50,50251,1992-12-31,1833,13770,15603
50,50251,1993-12-31,1852,7148,9000
50,50251,1994-12-31,1908,6938,8846
50,50251,1995-12-31,1967,6933,8900
50,50251,1996-12-31,2006,6878,8884
50,50251,1997-12-31,2084,6776,8860
50,50251,1998-12-31,2138,6623,8761
50,50251,1999-12-31,2198,6430,8628
50,50251,2000-12-31,2274,6179,8453
50,50251,2001-12-31,2326,5980,8306
50,50251,2002-12-31,2372,5787,8159
50,50251,2003-12-31,2419,5637,8056
50,50251,2004-12-31,2497,5540,8037
50,50251,2005-12-31,2551,5476,8027
50,50251,2006-12-31,2565,5421,7986
50,50251,2007-12-31,2651,5388,8039
50,50251,2008-12-31,2679,5358,8037
50,50251,2009-12-31,2723,5315,8038
50,50251,2010-12-31,2755,5290,8045
50,50251,2011-12-31,2784,5274,8058
50,50251,2012-12-31,2815,5224,8039
50,50251,2013-12-31,2828,5186,8014
50,50251,2014-12-31,2864,5115,7979
50,50251,2015-12-31,2893,5085,7978
50,50251,2016-12-31,2900,5094,7994
50,50251,2017-12-31,2955,5039,7994
50,50251,2018-12-31,3020,4957,7977
50,50251,2019-12-31,2920,4699,7619
50,50251,2020-12-31,2837,4571,7408
50,50251,2021-12-31,2844,4625,7469
50,50251,2022-12-31,2851,4676,7527
50,50251,2023-12-31,2859,4724,7583
50,50251,2024-12-31,2869,4757,7626
50,50251,2025-12-31,2890,4807,7697
50,50251,2026-12-31,2915,4853,7768
50,50251,2027-12-31,2931,4874,7805
50,50251,2028-12-31,2947,4924,7871
50,50251,2029-12-31,2959,4949,7908
50,50251,2030-12-31,2973,4985,7958
50,50251,2031-12-31,2988,5012,8000
50,50251,2032-12-31,2995,5040,8035
50,50251,2033-12-31,3009,5066,8075
50,50251,2034-12-31,3030,5083,8113
50,50251,2035-12-31,3027,5104,8131
50,50270,1985-12-31,0,0,0
50,50270,1986-12-31,0,0,0
50,50270,1987-12-31,0,0,0
50,50270,1988-12-31,0,0,0
50,50270,1989-12-31,0,0,0
50,50270,1990-12-31,0,0,0
50,50270,1991-12-31,0,0,0
50,50270,1992-12-31,0,0,0
50,50270,1993-12-31,690,2044,2734
50,50270,1994-12-31,761,1974,2735
50,50270,1995-12-31,796,2082,2878
50,50270,1996-12-31,835,2074,2909
50,50270,1997-12-31,848,2116,2964
50,50270,1998-12-31,878,2105,2983
50,50270,1999-12-31,922,2066,2988
50,50270,2000-12-31,963,2069,3032
50,50270,2001-12-31,968,2039,3007
50,50270,2002-12-31,994,2013,3007
50,50270,2003-12-31,1018,2003,3021
50,50270,2004-12-31,1044,2021,3065
50,50270,2005-12-31,1077,2029,3106
50,50270,2006-12-31,1099,2072,3171
50,50270,2007-12-31,1136,2095,3231
50,50270,2008-12-31,1152,2119,3271
50,50270,2009-12-31,1184,2188,3372
50,50270,2010-12-31,1212,2213,3425
50,50270,2011-12-31,1233,2227,3460
50,50270,2012-12-31,1257,2256,3513
50,50270,2013-12-31,1289,2299,3588
50,50270,2014-12-31,1346,2342,3688
50,50270,2015-12-31,1371,2390,3761
50,50270,2016-12-31,1381,2422,3803
50,50270,2017-12-31,1388,2441,3829
50,50270,2018-12-31,1412,2476,3888
50,50270,2019-12-31,1426,2506,3932
50,50270,2020-12-31,1440,2531,3971
50,50270,2021-12-31,1443,2561,4004
50,50270,2022-12-31,1446,2589,4035
50,50270,2023-12-31,1449,2616,4065
50,50270,2024-12-31,1452,2649,4101
50,50270,2025-12-31,1460,2663,4123
50,50270,2026-12-31,1471,2680,4151
50,50270,2027-12-31,1485,2715,4200
50,50270,2028-12-31,1486,2731,4217
50,50270,2029-12-31,1499,2725,4224
50,50270,2030-12-31,1507,2769,4276
50,50270,2031-12-31,1514,2771,4285
50,50270,2032-12-31,1520,2796,4316
50,50270,2033-12-31,1531,2801,4332
50,50270,2034-12-31,1536,2815,4351
50,50270,2035-12-31,1532,2815,4347
50,50287,1985-12-31,2098,1589,3687
50,50287,1986-12-31,2191,1771,3962
50,50287,1987-12-31,2313,1856,4169
50,50287,1988-12-31,2403,1981,4384
50,50287,1989-12-31,2511,2081,4592
50,50287,1990-12-31,2598,2204,4802
50,50287,1991-12-31,2761,2298,5059
50,50287,1992-12-31,2910,2388,5298
50,50287,1993-12-31,3040,2635,5675
50,50287,1994-12-31,3212,2706,5918
50,50287,1995-12-31,3351,2783,6134
50,50287,1996-12-31,3516,2924,6440
50,50287,1997-12-31,3668,3026,6694
50,50287,1998-12-31,3857,3113,6970
50,50287,1999-12-31,4042,3150,7192
50,50287,2000-12-31,4226,3228,7454
50,50287,2001-12-31,4442,3224,7666
50,50287,2002-12-31,4668,3283,7951
50,50287,2003-12-31,4873,3330,8203
50,50287,2004-12-31,5011,3415,8426
50,50287,2005-12-31,5168,3508,8676
50,50287,2006-12-31,5343,3630,8973
50,50287,2007-12-31,5504,3755,9259
50,50287,2008-12-31,5650,3873,9523
50,50287,2009-12-31,5790,4013,9803
50,50287,2010-12-31,5921,4169,10090
50,50287,2011-12-31,6050,4283,10333
50,50287,2012-12-31,6179,4416,10595
50,50287,2013-12-31,6318,4539,10857
50,50287,2014-12-31,6467,4667,11134
50,50287,2015-12-31,6615,4806,11421
50,50287,2016-12-31,6682,4995,11677
50,50287,2017-12-31,6825,5091,11916
50,50287,2018-12-31,6923,5206,12129
50,50287,2019-12-31,7017,5249,12266
50,50287,2020-12-31,7105,5283,12388
50,50287,2021-12-31,7145,5346,12491
50,50287,2022-12-31,7182,5405,12587
50,50287,2023-12-31,7221,5460,12681
50,50287,2024-12-31,7258,5509,12767
50,50287,2025-12-31,7318,5559,12877
50,50287,2026-12-31,7359,5604,12963
50,50287,2027-12-31,7398,5640,13038
50,50287,2028-12-31,7441,5686,13127
50,50287,2029-12-31,7481,5726,13207
50,50287,2030-12-31,7520,5746,13266
50,50287,2031-12-31,7552,5789,13341
50,50287,2032-12-31,7598,5785,13383
50,50287,2033-12-31,7626,5808,13434
50,50287,2034-12-31,7651,5809,13460
50,50287,2035-12-31,7686,5805,13491
50,50313,1985-12-31,20432,8970,29402
50,50313,1986-12-31,21130,8945,30075
50,50313,1987-12-31,21857,8911,30768
50,50313,1988-12-31,22636,8923,31559
50,50313,1989-12-31,23443,8941,32384
50,50313,1990-12-31,24016,9199,33215
50,50313,1991-12-31,25295,9108,34403
50,50313,1992-12-31,26622,8996,35618
50,50313,1993-12-31,27572,9656,37228
50,50313,1994-12-31,29023,9508,38531
50,50313,1995-12-31,30121,9662,39783
50,50313,1996-12-31,31295,9763,41058
50,50313,1997-12-31,32587,9805,42392
50,50313,1998-12-31,34004,9747,43751
50,50313,1999-12-31,35552,9608,45160
50,50313,2000-12-31,37148,9429,46577
50,50313,2001-12-31,38803,9250,48053
50,50313,2002-12-31,40392,9136,49528
50,50313,2003-12-31,41859,9066,50925
50,50313,2004-12-31,43265,9079,52344
50,50313,2005-12-31,44630,9132,53762
50,50313,2006-12-31,45906,9212,55118
50,50313,2007-12-31,47105,9315,56420
50,50313,2008-12-31,48271,9424,57695
50,50313,2009-12-31,49372,9556,58928
50,50313,2010-12-31,50462,9661,60123
50,50313,2011-12-31,51522,9805,61327
50,50313,2012-12-31,52543,9941,62484
50,50313,2013-12-31,53536,10007,63543
50,50313,2014-12-31,54505,10110,64615
50,50313,2015-12-31,55452,10244,65696
50,50313,2016-12-31,56406,10309,66715
50,50313,2017-12-31,57379,10356,67735
50,50313,2018-12-31,58293,10583,68876
50,50313,2019-12-31,58780,10990,69770
50,50313,2020-12-31,59213,11364,70577
50,50313,2021-12-31,59673,11501,71174
50,50313,2022-12-31,60096,11629,71725
50,50313,2023-12-31,60512,11747,72259
50,50313,2024-12-31,60902,11863,72765
50,50313,2025-12-31,61279,11975,73254
50,50313,2026-12-31,61645,12074,73719
50,50313,2027-12-31,62008,12163,74171
50,50313,2028-12-31,62363,12275,74638
50,50313,2029-12-31,62697,12350,75047
50,50313,2030-12-31,63012,12439,75451
50,50313,2031-12-31,63311,12518,75829
50,50313,2032-12-31,63583,12590,76173
50,50313,2033-12-31,63840,12671,76511
50,50313,2034-12-31,64096,12738,76834
50,50313,2035-12-31,64312,12819,77131
50,50318,1985-12-31,4222,3545,7767
50,50318,1986-12-31,4289,3521,7810
50,50318,1987-12-31,4383,3560,7943
50,50318,1988-12-31,4465,3601,8066
50,50318,1989-12-31,4585,3630,8215
50,50318,1990-12-31,4649,3705,8354
50,50318,1991-12-31,4807,3665,8472
50,50318,1992-12-31,5015,3623,8638
50,50318,1993-12-31,5151,3888,9039
50,50318,1994-12-31,5376,3866,9242
50,50318,1995-12-31,5528,3936,9464
50,50318,1996-12-31,5720,3972,9692
50,50318,1997-12-31,5903,4008,9911
50,50318,1998-12-31,6097,4003,10100
50,50318,1999-12-31,6346,3938,10284
50,50318,2000-12-31,6585,3910,10495
50,50318,2001-12-31,6841,3824,10665
50,50318,2002-12-31,7108,3788,10896
50,50318,2003-12-31,7311,3764,11075
50,50318,2004-12-31,7518,3754,11272
50,50318,2005-12-31,7715,3794,11509
50,50318,2006-12-31,7895,3834,11729
50,50318,2007-12-31,8065,3879,11944
50,50318,2008-12-31,8221,3952,12173
50,50318,2009-12-31,8383,4009,12392
50,50318,2010-12-31,8539,4057,12596
50,50318,2011-12-31,8680,4133,12813
50,50318,2012-12-31,8826,4193,13019
50,50318,2013-12-31,8922,4216,13138
50,50318,2014-12-31,9097,4268,13365
50,50318,2015-12-31,9260,4378,13638
50,50318,2016-12-31,9343,4472,13815
50,50318,2017-12-31,9423,4430,13853
50,50318,2018-12-31,9609,4510,14119
50,50318,2019-12-31,9691,4607,14298
50,50318,2020-12-31,9761,4701,14462
50,50318,2021-12-31,9826,4758,14584
50,50318,2022-12-31,9887,4810,14697
50,50318,2023-12-31,9948,4859,14807
50,50318,2024-12-31,10012,4900,14912
50,50318,2025-12-31,10076,4940,15016
50,50318,2026-12-31,10135,4991,15126
50,50318,2027-12-31,10191,5024,15215
50,50318,2028-12-31,10245,5064,15309
50,50318,2029-12-31,10289,5099,15388
50,50318,2030-12-31,10355,5139,15494
50,50318,2031-12-31,10403,5160,15563
50,50318,2032-12-31,10457,5195,15652
50,50318,2033-12-31,10490,5220,15710
50,50318,2034-12-31,10532,5262,15794
50,50318,2035-12-31,10570,5269,15839
50,50325,1985-12-31,0,0,0
50,50325,1986-12-31,0,0,0
50,50325,1987-12-31,0,0,0
50,50325,1988-12-31,0,0,0
50,50325,1989-12-31,0,0,0
50,50325,1990-12-31,984,6160,7144
50,50325,1991-12-31,1042,6033,7075
50,50325,1992-12-31,1079,5870,6949
50,50325,1993-12-31,1160,6176,7336
50,50325,1994-12-31,1194,6003,7197
50,50325,1995-12-31,1236,6014,7250
50,50325,1996-12-31,1292,5966,7258
50,50325,1997-12-31,1354,5857,7211
50,50325,1998-12-31,1409,5755,7164
50,50325,1999-12-31,1502,5599,7101
50,50325,2000-12-31,1556,5415,6971
50,50325,2001-12-31,1631,5226,6857
50,50325,2002-12-31,1671,5081,6752
50,50325,2003-12-31,1713,4970,6683
50,50325,2004-12-31,1760,4885,6645
50,50325,2005-12-31,1839,4851,6690
50,50325,2006-12-31,1888,4807,6695
50,50325,2007-12-31,1958,4787,6745
50,50325,2008-12-31,1993,4791,6784
50,50325,2009-12-31,2058,4753,6811
50,50325,2010-12-31,2057,4760,6817
50,50325,2011-12-31,2135,4744,6879
50,50325,2012-12-31,2189,4717,6906
50,50325,2013-12-31,2221,4684,6905
50,50325,2014-12-31,2239,4677,6916
50,50325,2015-12-31,2302,4674,6976
50,50325,2016-12-31,2361,4629,6990
50,50325,2017-12-31,2412,4574,6986
50,50325,2018-12-31,2471,4536,7007
50,50325,2019-12-31,2481,4605,7086
50,50325,2020-12-31,2489,4667,7156
50,50325,2021-12-31,2493,4722,7215
50,50325,2022-12-31,2496,4775,7271
50,50325,2023-12-31,2502,4823,7325
50,50325,2024-12-31,2514,4863,7377
50,50325,2025-12-31,2524,4920,7444
50,50325,2026-12-31,2539,4981,7520
50,50325,2027-12-31,2555,5016,7571
50,50325,2028-12-31,2569,5059,7628
50,50325,2029-12-31,2580,5114,7694
50,50325,2030-12-31,2595,5143,7738
50,50325,2031-12-31,2611,5188,7799
50,50325,2032-12-31,2619,5219,7838
50,50325,2033-12-31,2630,5268,7898
50,50325,2034-12-31,2641,5295,7936
50,50325,2035-12-31,2644,5323,7967
50,50330,1985-12-31,2848,13523,16371
50,50330,1986-12-31,2827,13722,16549
50,50330,1987-12-31,2836,13913,16749
50,50330,1988-12-31,2862,14097,16959
50,50330,1989-12-31,2843,14335,17178
50,50330,1990-12-31,2857,15001,17858
50,50330,1991-12-31,2928,7483,10411
50,50330,1992-12-31,2991,7312,10303
50,50330,1993-12-31,3037,7769,10806
50,50330,1994-12-31,3123,7582,10705
50,50330,1995-12-31,3158,7622,10780
50,50330,1996-12-31,3234,7595,10829
50,50330,1997-12-31,3295,7560,10855
50,50330,1998-12-31,3365,7437,10802
50,50330,1999-12-31,3460,7240,10700
50,50330,2000-12-31,3577,7028,10605
50,50330,2001-12-31,3672,6855,10527
50,50330,2002-12-31,3735,6688,10423
50,50330,2003-12-31,3858,6580,10438
50,50330,2004-12-31,3935,6511,10446
50,50330,2005-12-31,3986,6484,10470
50,50330,2006-12-31,4055,6478,10533
50,50330,2007-12-31,4104,6497,10601
50,50330,2008-12-31,4158,6520,10678
50,50330,2009-12-31,4203,6532,10735
50,50330,2010-12-31,4256,6509,10765
50,50330,2011-12-31,4296,6557,10853
50,50330,2012-12-31,4336,6575,10911
50,50330,2013-12-31,4376,6576,10952
50,50330,2014-12-31,4404,6589,10993
50,50330,2015-12-31,4406,6587,10993
50,50330,2016-12-31,4425,6596,11021
50,50330,2017-12-31,4473,6640,11113
50,50330,2018-12-31,4546,6613,11159
50,50330,2019-12-31,4460,6246,10706
50,50330,2020-12-31,4409,6021,10430
50,50330,2021-12-31,4424,6092,10516
50,50330,2022-12-31,4438,6160,10598
50,50330,2023-12-31,4453,6223,10676
50,50330,2024-12-31,4478,6282,10760
50,50330,2025-12-31,4504,6336,10840
50,50330,2026-12-31,4539,6402,10941
50,50330,2027-12-31,4561,6439,11000
50,50330,2028-12-31,4591,6510,11101
50,50330,2029-12-31,4617,6557,11174
50,50330,2030-12-31,4637,6601,11238
50,50330,2031-12-31,4652,6650,11302
50,50330,2032-12-31,4675,6699,11374
50,50330,2033-12-31,4694,6734,11428
50,50330,2034-12-31,4716,6788,11504
50,50330,2035-12-31,4727,6842,11569
50,50350,1985-12-31,1280,3682,4962
50,50350,1986-12-31,1363,4216,5579
50,50350,1987-12-31,1478,4763,6241
50,50350,1988-12-31,1536,5315,6851
50,50350,1989-12-31,1628,5860,7488
50,50350,1990-12-31,1692,6559,8251
50,50350,1991-12-31,1771,7032,8803
50,50350,1992-12-31,1899,7445,9344
50,50350,1993-12-31,1979,8520,10499
50,50350,1994-12-31,2106,8930,11036
50,50350,1995-12-31,2206,9592,11798
50,50350,1996-12-31,2306,10213,12519
50,50350,1997-12-31,2430,10763,13193
50,50350,1998-12-31,2544,11189,13733
50,50350,1999-12-31,2692,11543,14235
50,50350,2000-12-31,2823,11812,14635
50,50350,2001-12-31,2960,12055,15015
50,50350,2002-12-31,3064,12366,15430
50,50350,2003-12-31,3214,12680,15894
50,50350,2004-12-31,3346,13158,16504
50,50350,2005-12-31,3462,13672,17134
50,50350,2006-12-31,3576,14271,17847
50,50350,2007-12-31,3688,14891,18579
50,50350,2008-12-31,3786,15525,19311
50,50350,2009-12-31,3893,16184,20077
50,50350,2010-12-31,4002,16848,20850
50,50350,2011-12-31,4093,17517,21610
50,50350,2012-12-31,4205,18175,22380
50,50350,2013-12-31,4308,18844,23152
50,50350,2014-12-31,4384,19495,23879
50,50350,2015-12-31,4448,20157,24605
50,50350,2016-12-31,4511,20824,25335
50,50350,2017-12-31,4656,21473,26129
50,50350,2018-12-31,4723,22167,26890
50,50350,2019-12-31,4771,22763,27534
50,50350,2020-12-31,4815,23237,28052
50,50350,2021-12-31,4773,23517,28290
50,50350,2022-12-31,4730,23778,28508
50,50350,2023-12-31,4701,24020,28721
50,50350,2024-12-31,4732,24279,29011
50,50350,2025-12-31,4756,24518,29274
50,50350,2026-12-31,4792,24767,29559
50,50350,2027-12-31,4812,25010,29822
50,50350,2028-12-31,4841,25235,30076
50,50350,2029-12-31,4862,25482,30344
50,50350,2030-12-31,4890,25714,30604
50,50350,2031-12-31,4906,25952,30858
50,50350,2032-12-31,4931,26183,31114
50,50350,2033-12-31,4958,26428,31386
50,50350,2034-12-31,4966,26668,31634
50,50350,2035-12-31,4984,26897,31881
50,50370,1985-12-31,0,0,0
50,50370,1986-12-31,0,0,0
50,50370,1987-12-31,0,0,0
50,50370,1988-12-31,0,0,0
50,50370,1989-12-31,0,0,0
50,50370,1990-12-31,0,0,0
50,50370,1991-12-31,1142,6067,7209
50,50370,1992-12-31,1167,6031,7198
50,50370,1993-12-31,1191,6458,7649
50,50370,1994-12-31,1242,6376,7618
50,50370,1995-12-31,1272,6452,7724
50,50370,1996-12-31,1305,6510,7815
50,50370,1997-12-31,1358,6534,7892
50,50370,1998-12-31,1390,6498,7888
50,50370,1999-12-31,1459,6417,7876
50,50370,2000-12-31,1510,6296,7806
50,50370,2001-12-31,1559,6206,7765
50,50370,2002-12-31,1579,6113,7692
50,50370,2003-12-31,1618,6062,7680
50,50370,2004-12-31,1646,6072,7718
50,50370,2005-12-31,1722,6118,7840
50,50370,2006-12-31,1758,6188,7946
50,50370,2007-12-31,1783,6260,8043
50,50370,2008-12-31,1827,6347,8174
50,50370,2009-12-31,1859,6431,8290
50,50370,2010-12-31,1893,6507,8400
50,50370,2011-12-31,1927,6603,8530
50,50370,2012-12-31,1947,6692,8639
50,50370,2013-12-31,1981,6779,8760
50,50370,2014-12-31,1995,6859,8854
50,50370,2015-12-31,2028,6925,8953
50,50370,2016-12-31,2078,6972,9050
50,50370,2017-12-31,2112,7064,9176
50,50370,2018-12-31,2128,7156,9284
50,50370,2019-12-31,2150,7238,9388
50,50370,2020-12-31,2170,7312,9482
50,50370,2021-12-31,2161,7399,9560
50,50370,2022-12-31,2153,7481,9634
50,50370,2023-12-31,2149,7557,9706
50,50370,2024-12-31,2159,7626,9785
50,50370,2025-12-31,2175,7699,9874
50,50370,2026-12-31,2179,7772,9951
50,50370,2027-12-31,2195,7839,10034
50,50370,2028-12-31,2200,7902,10102
50,50370,2029-12-31,2216,7943,10159
50,50370,2030-12-31,2230,8006,10236
50,50370,2031-12-31,2243,8070,10313
50,50370,2032-12-31,2260,8140,10400
50,50370,2033-12-31,2261,8183,10444
50,50370,2034-12-31,2276,8234,10510
50,50370,2035-12-31,2277,8259,10536
50,50400,1985-12-31,3009,6626,9635
50,50400,1986-12-31,2996,6561,9557
50,50400,1987-12-31,3008,6559,9567
50,50400,1988-12-31,3011,6536,9547
50,50400,1989-12-31,3020,6517,9537
50,50400,1990-12-31,3016,6667,9683
50,50400,1991-12-31,3095,6544,9639
50,50400,1992-12-31,3176,6431,9607
50,50400,1993-12-31,3235,6864,10099
50,50400,1994-12-31,3324,6754,10078
50,50400,1995-12-31,3342,6805,10147
50,50400,1996-12-31,3434,6817,10251
50,50400,1997-12-31,3488,6804,10292
50,50400,1998-12-31,3573,6735,10308
50,50400,1999-12-31,3687,6616,10303
50,50400,2000-12-31,3784,6442,10226
50,50400,2001-12-31,3878,6308,10186
50,50400,2002-12-31,3964,6179,10143
50,50400,2003-12-31,4078,6136,10214
50,50400,2004-12-31,4156,6093,10249
50,50400,2005-12-31,4224,6092,10316
50,50400,2006-12-31,4272,6093,10365
50,50400,2007-12-31,4328,6152,10480
50,50400,2008-12-31,4388,6215,10603
50,50400,2009-12-31,4437,6258,10695
50,50400,2010-12-31,4493,6300,10793
50,50400,2011-12-31,4542,6336,10878
50,50400,2012-12-31,4584,6387,10971
50,50400,2013-12-31,4621,6463,11084
50,50400,2014-12-31,4643,6471,11114
50,50400,2015-12-31,4660,6480,11140
50,50400,2016-12-31,4696,6539,11235
50,50400,2017-12-31,4763,6626,11389
50,50400,2018-12-31,4823,6640,11463
50,50400,2019-12-31,4746,6510,11256
50,50400,2020-12-31,4707,6455,11162
50,50400,2021-12-31,4722,6532,11254
50,50400,2022-12-31,4737,6604,11341
50,50400,2023-12-31,4755,6671,11426
50,50400,2024-12-31,4783,6735,11518
50,50400,2025-12-31,4813,6807,11620
50,50400,2026-12-31,4842,6850,11692
50,50400,2027-12-31,4866,6903,11769
50,50400,2028-12-31,4901,6948,11849
50,50400,2029-12-31,4935,7016,11951
50,50400,2030-12-31,4956,7057,12013
50,50400,2031-12-31,4967,7108,12075
50,50400,2032-12-31,4997,7140,12137
50,50400,2033-12-31,5017,7190,12207
50,50400,2034-12-31,5027,7229,12256
50,50400,2035-12-31,5048,7285,12333
50,50450,1985-12-31,0,0,0
50,50450,1986-12-31,0,0,0
50,50450,1987-12-31,0,0,0
50,50450,1988-12-31,0,0,0
50,50450,1989-12-31,0,0,0
50,50450,1990-12-31,2144,5164,7308
50,50450,1991-12-31,2190,5091,7281
50,50450,1992-12-31,2243,5036,7279
50,50450,1993-12-31,2285,5304,7589
50,50450,1994-12-31,2341,5214,7555
50,50450,1995-12-31,2379,5239,7618
50,50450,1996-12-31,2414,5240,7654
50,50450,1997-12-31,2485,5210,7695
50,50450,1998-12-31,2550,5159,7709
50,50450,1999-12-31,2607,5055,7662
50,50450,2000-12-31,2718,4942,7660
50,50450,2001-12-31,2757,4822,7579
50,50450,2002-12-31,2803,4727,7530
50,50450,2003-12-31,2863,4655,7518
50,50450,2004-12-31,2955,4635,7590
50,50450,2005-12-31,3037,4632,7669
50,50450,2006-12-31,3059,4644,7703
50,50450,2007-12-31,3102,4673,7775
50,50450,2008-12-31,3136,4711,7847
50,50450,2009-12-31,3176,4722,7898
50,50450,2010-12-31,3185,4762,7947
50,50450,2011-12-31,3233,4821,8054
50,50450,2012-12-31,3249,4842,8091
50,50450,2013-12-31,3266,4860,8126
50,50450,2014-12-31,3281,4880,8161
50,50450,2015-12-31,3314,4911,8225
50,50450,2016-12-31,3349,4940,8289
50,50450,2017-12-31,3387,4975,8362
50,50450,2018-12-31,3420,4970,8390
50,50450,2019-12-31,3455,5029,8484
50,50450,2020-12-31,3487,5082,8569
50,50450,2021-12-31,3498,5142,8640
50,50450,2022-12-31,3508,5199,8707
50,50450,2023-12-31,3519,5252,8771
50,50450,2024-12-31,3519,5315,8834
50,50450,2025-12-31,3551,5357,8908
50,50450,2026-12-31,3582,5407,8989
50,50450,2027-12-31,3604,5454,9058
50,50450,2028-12-31,3623,5489,9112
50,50450,2029-12-31,3650,5538,9188
50,50450,2030-12-31,3662,5570,9232
50,50450,2031-12-31,3681,5604,9285
50,50450,2032-12-31,3691,5648,9339
50,50450,2033-12-31,3702,5682,9384
50,50450,2034-12-31,3721,5702,9423
50,50450,2035-12-31,3738,5736,9474
50,50568,1985-12-31,2139,3558,5697
50,50568,1986-12-31,2658,4049,6707
50,50568,1987-12-31,3138,4567,7705
50,50568,1988-12-31,3633,5096,8729
50,50568,1989-12-31,4124,5606,9730
50,50568,1990-12-31,4557,6253,10810
50,50568,1991-12-31,5110,6697,11807
50,50568,1992-12-31,5688,7099,12787
50,50568,1993-12-31,6174,8088,14262
50,50568,1994-12-31,6800,8477,15277
50,50568,1995-12-31,7321,9084,16405
50,50568,1996-12-31,7889,9667,17556
50,50568,1997-12-31,8467,10177,18644
50,50568,1998-12-31,9082,10582,19664
50,50568,1999-12-31,9740,10917,20657
50,50568,2000-12-31,10421,11133,21554
50,50568,2001-12-31,11112,11371,22483
50,50568,2002-12-31,11828,11654,23482
50,50568,2003-12-31,12475,11993,24468
50,50568,2004-12-31,13125,12393,25518
50,50568,2005-12-31,13733,12893,26626
50,50568,2006-12-31,14354,13441,27795
50,50568,2007-12-31,14950,14022,28972
50,50568,2008-12-31,15514,14620,30134
50,50568,2009-12-31,16071,15239,31310
50,50568,2010-12-31,16622,15869,32491
50,50568,2011-12-31,17148,16495,33643
50,50568,2012-12-31,17679,17128,34807
50,50568,2013-12-31,18162,17775,35937
50,50568,2014-12-31,18707,18384,37091
50,50568,2015-12-31,19158,18986,38144
50,50568,2016-12-31,19634,19606,39240
50,50568,2017-12-31,20204,20224,40428
50,50568,2018-12-31,20659,20854,41513
50,50568,2019-12-31,21270,21407,42677
50,50568,2020-12-31,21726,21879,43605
50,50568,2021-12-31,21831,22143,43974
50,50568,2022-12-31,21926,22388,44314
50,50568,2023-12-31,22028,22616,44644
50,50568,2024-12-31,22160,22856,45016
50,50568,2025-12-31,22291,23105,45396
50,50568,2026-12-31,22429,23328,45757
50,50568,2027-12-31,22553,23557,46110
50,50568,2028-12-31,22670,23778,46448
50,50568,2029-12-31,22786,24018,46804
50,50568,2030-12-31,22909,24229,47138
50,50568,2031-12-31,23031,24482,47513
50,50568,2032-12-31,23123,24713,47836
50,50568,2033-12-31,23223,24936,48159
50,50568,2034-12-31,23296,25161,48457
50,50568,2035-12-31,23373,25407,48780
50,50573,1985-12-31,10147,7159,17306
50,50573,1986-12-31,10187,7260,17447
50,50573,1987-12-31,10254,7375,17629
50,50573,1988-12-31,10343,7470,17813
50,50573,1989-12-31,10474,7587,18061
50,50573,1990-12-31,10489,7909,18398
50,50573,1991-12-31,10815,7920,18735
50,50573,1992-12-31,11166,7920,19086
50,50573,1993-12-31,11349,8591,19940
50,50573,1994-12-31,11742,8609,20351
50,50573,1995-12-31,11989,8823,20812
50,50573,1996-12-31,12260,8997,21257
50,50573,1997-12-31,12588,9116,21704
50,50573,1998-12-31,12947,9167,22114
50,50573,1999-12-31,13363,9133,22496
50,50573,2000-12-31,13790,9048,22838
50,50573,2001-12-31,14223,8972,23195
50,50573,2002-12-31,14664,8950,23614
50,50573,2003-12-31,15043,8977,24020
50,50573,2004-12-31,15381,9038,24419
50,50573,2005-12-31,15700,9183,24883
50,50573,2006-12-31,15998,9349,25347
50,50573,2007-12-31,16265,9532,25797
50,50573,2008-12-31,16523,9747,26270
50,50573,2009-12-31,16758,9967,26725
50,50573,2010-12-31,16995,10179,27174
50,50573,2011-12-31,17223,10391,27614
50,50573,2012-12-31,17416,10612,28028
50,50573,2013-12-31,17634,10813,28447
50,50573,2014-12-31,17825,11008,28833
50,50573,2015-12-31,18028,11223,29251
50,50573,2016-12-31,18227,11390,29617
50,50573,2017-12-31,18419,11597,30016
50,50573,2018-12-31,18575,11824,30399
50,50573,2019-12-31,18487,11814,30301
50,50573,2020-12-31,18486,11826,30312
50,50573,2021-12-31,18597,11966,30563
50,50573,2022-12-31,18700,12099,30799
50,50573,2023-12-31,18806,12222,31028
50,50573,2024-12-31,18918,12346,31264
50,50573,2025-12-31,19033,12458,31491
50,50573,2026-12-31,19142,12575,31717
50,50573,2027-12-31,19247,12675,31922
50,50573,2028-12-31,19362,12793,32155
50,50573,2029-12-31,19459,12901,32360
50,50573,2030-12-31,19563,13015,32578
50,50573,2031-12-31,19642,13101,32743
50,50573,2032-12-31,19750,13202,32952
50,50573,2033-12-31,19833,13307,33140
50,50573,2034-12-31,19900,13414,33314
50,50573,2035-12-31,19969,13511,33480
50,50577,1985-12-31,2346,5006,7352
50,50577,1986-12-31,2371,5006,7377
50,50577,1987-12-31,2400,5022,7422
50,50577,1988-12-31,2400,5057,7457
50,50577,1989-12-31,2423,5086,7509
50,50577,1990-12-31,2413,5229,7642
50,50577,1991-12-31,2500,5193,7693
50,50577,1992-12-31,2570,5156,7726
50,50577,1993-12-31,2607,5514,8121
50,50577,1994-12-31,2686,5462,8148
50,50577,1995-12-31,2736,5529,8265
50,50577,1996-12-31,2790,5602,8392
50,50577,1997-12-31,2849,5632,8481
50,50577,1998-12-31,2948,5616,8564
50,50577,1999-12-31,2998,5553,8551
50,50577,2000-12-31,3112,5462,8574
50,50577,2001-12-31,3186,5379,8565
50,50577,2002-12-31,3234,5308,8542
50,50577,2003-12-31,3371,5274,8645
50,50577,2004-12-31,3451,5293,8744
50,50577,2005-12-31,3498,5340,8838
50,50577,2006-12-31,3546,5406,8952
50,50577,2007-12-31,3606,5480,9086
50,50577,2008-12-31,3668,5556,9224
50,50577,2009-12-31,3727,5645,9372
50,50577,2010-12-31,3780,5737,9517
50,50577,2011-12-31,3817,5807,9624
50,50577,2012-12-31,3848,5884,9732
50,50577,2013-12-31,3864,5969,9833
50,50577,2014-12-31,3876,6037,9913
50,50577,2015-12-31,3908,6100,10008
50,50577,2016-12-31,3965,6196,10161
50,50577,2017-12-31,4029,6331,10360
50,50577,2018-12-31,4087,6336,10423
50,50577,2019-12-31,4040,6319,10359
50,50577,2020-12-31,4022,6332,10354
50,50577,2021-12-31,4033,6407,10440
50,50577,2022-12-31,4042,6478,10520
50,50577,2023-12-31,4055,6544,10599
50,50577,2024-12-31,4084,6614,10698
50,50577,2025-12-31,4106,6659,10765
50,50577,2026-12-31,4135,6726,10861
50,50577,2027-12-31,4158,6776,10934
50,50577,2028-12-31,4184,6827,11011
50,50577,2029-12-31,4208,6870,11078
50,50577,2030-12-31,4222,6917,11139
50,50577,2031-12-31,4248,6963,11211
50,50577,2032-12-31,4268,6997,11265
50,50577,2033-12-31,4278,7043,11321
50,50577,2034-12-31,4294,7074,11368
50,50577,2035-12-31,4307,7109,11416
50,50590,1985-12-31,3064,7952,11016
50,50590,1986-12-31,3105,9791,12896
50,50590,1987-12-31,3172,11633,14805
50,50590,1988-12-31,3214,13431,16645
50,50590,1989-12-31,3276,15230,18506
50,50590,1990-12-31,3303,9310,12613
50,50590,1991-12-31,3431,9104,12535
50,50590,1992-12-31,3558,8837,12395
50,50590,1993-12-31,3634,9301,12935
50,50590,1994-12-31,3777,9050,12827
50,50590,1995-12-31,3861,9016,12877
50,50590,1996-12-31,3983,8942,12925
50,50590,1997-12-31,4098,8817,12915
50,50590,1998-12-31,4248,8650,12898
50,50590,1999-12-31,4382,8365,12747
50,50590,2000-12-31,4538,8072,12610
50,50590,2001-12-31,4706,7802,12508
50,50590,2002-12-31,4865,7558,12423
50,50590,2003-12-31,5034,7386,12420
50,50590,2004-12-31,5140,7260,12400
50,50590,2005-12-31,5305,7177,12482
50,50590,2006-12-31,5408,7134,12542
50,50590,2007-12-31,5505,7092,12597
50,50590,2008-12-31,5617,7067,12684
50,50590,2009-12-31,5704,7040,12744
50,50590,2010-12-31,5797,7011,12808
50,50590,2011-12-31,5880,6974,12854
50,50590,2012-12-31,5951,6927,12878
50,50590,2013-12-31,6090,6892,12982
50,50590,2014-12-31,6177,6837,13014
50,50590,2015-12-31,6253,6762,13015
50,50590,2016-12-31,6310,6710,13020
50,50590,2017-12-31,6344,6689,13033
50,50590,2018-12-31,6439,6622,13061
50,50590,2019-12-31,6503,6415,12918
50,50590,2020-12-31,6561,6313,12874
50,50590,2021-12-31,6592,6388,12980
50,50590,2022-12-31,6622,6459,13081
50,50590,2023-12-31,6654,6524,13178
50,50590,2024-12-31,6697,6585,13282
50,50590,2025-12-31,6736,6633,13369
50,50590,2026-12-31,6775,6694,13469
50,50590,2027-12-31,6816,6754,13570
50,50590,2028-12-31,6852,6795,13647
50,50590,2029-12-31,6895,6847,13742
50,50590,2030-12-31,6923,6895,13818
50,50590,2031-12-31,6965,6924,13889
50,50590,2032-12-31,6986,6975,13961
50,50590,2033-12-31,7014,7018,14032
50,50590,2034-12-31,7037,7051,14088
50,50590,2035-12-31,7066,7089,14155
50,50606,1985-12-31,4349,3464,7813
50,50606,1986-12-31,4500,3495,7995
50,50606,1987-12-31,4631,3579,8210
50,50606,1988-12-31,4797,3660,8457
50,50606,1989-12-31,4970,3750,8720
50,50606,1990-12-31,5097,3928,9025
50,50606,1991-12-31,5349,3940,9289
50,50606,1992-12-31,5640,3941,9581
50,50606,1993-12-31,5830,4263,10093
50,50606,1994-12-31,6141,4260,10401
50,50606,1995-12-31,6368,4399,10767
50,50606,1996-12-31,6611,4498,11109
50,50606,1997-12-31,6872,4551,11423
50,50606,1998-12-31,7173,4544,11717
50,50606,1999-12-31,7466,4572,12038
50,50606,2000-12-31,7825,4552,12377
50,50606,2001-12-31,8156,4522,12678
50,50606,2002-12-31,8531,4506,13037
50,50606,2003-12-31,8794,4533,13327
50,50606,2004-12-31,9108,4578,13686
50,50606,2005-12-31,9364,4670,14034
50,50606,2006-12-31,9642,4755,14397
50,50606,2007-12-31,9891,4866,14757
50,50606,2008-12-31,10127,4967,15094
50,50606,2009-12-31,10368,5086,15454
50,50606,2010-12-31,10596,5173,15769
50,50606,2011-12-31,10783,5308,16091
50,50606,2012-12-31,11021,5421,16442
50,50606,2013-12-31,11223,5516,16739
50,50606,2014-12-31,11352,5606,16958
50,50606,2015-12-31,11617,5714,17331
50,50606,2016-12-31,11778,5870,17648
50,50606,2017-12-31,11929,5966,17895
50,50606,2018-12-31,12190,6078,18268
50,50606,2019-12-31,12315,6159,18474
50,50606,2020-12-31,12429,6229,18658
50,50606,2021-12-31,12509,6303,18812
50,50606,2022-12-31,12585,6373,18958
50,50606,2023-12-31,12662,6437,19099
50,50606,2024-12-31,12730,6494,19224
50,50606,2025-12-31,12823,6554,19377
50,50606,2026-12-31,12904,6588,19492
50,50606,2027-12-31,12971,6646,19617
50,50606,2028-12-31,13044,6704,19748
50,50606,2029-12-31,13108,6749,19857
50,50606,2030-12-31,13184,6795,19979
50,50606,2031-12-31,13246,6842,20088
50,50606,2032-12-31,13305,6880,20185
50,50606,2033-12-31,13358,6905,20263
50,50606,2034-12-31,13420,6934,20354
50,50606,2035-12-31,13469,6979,20448
50,50680,1985-12-31,934,2369,3303
50,50680,1986-12-31,1107,2480,3587
50,50680,1987-12-31,1247,2586,3833
50,50680,1988-12-31,1374,2687,4061
50,50680,1989-12-31,1521,2799,4320
50,50680,1990-12-31,1625,2968,4593
50,50680,1991-12-31,1781,3023,4804
50,50680,1992-12-31,1964,3103,5067
50,50680,1993-12-31,2113,3343,5456
50,50680,1994-12-31,2290,3432,5722
50,50680,1995-12-31,2443,3573,6016
50,50680,1996-12-31,2582,3705,6287
50,50680,1997-12-31,2748,3806,6554
50,50680,1998-12-31,2933,3881,6814
50,50680,1999-12-31,3125,3917,7042
50,50680,2000-12-31,3338,3938,7276
50,50680,2001-12-31,3548,3964,7512
50,50680,2002-12-31,3720,3993,7713
50,50680,2003-12-31,3962,4027,7989
50,50680,2004-12-31,4138,4115,8253
50,50680,2005-12-31,4300,4216,8516
50,50680,2006-12-31,4482,4347,8829
50,50680,2007-12-31,4651,4482,9133
50,50680,2008-12-31,4812,4608,9420
50,50680,2009-12-31,4960,4739,9699
50,50680,2010-12-31,5139,4883,10022
50,50680,2011-12-31,5257,5032,10289
50,50680,2012-12-31,5464,5171,10635
50,50680,2013-12-31,5649,5343,10992
50,50680,2014-12-31,5774,5492,11266
50,50680,2015-12-31,5936,5603,11539
50,50680,2016-12-31,6065,5737,11802
50,50680,2017-12-31,6167,5897,12064
50,50680,2018-12-31,6300,5996,12296
50,50680,2019-12-31,6463,6135,12598
50,50680,2020-12-31,6587,6288,12875
50,50680,2021-12-31,6620,6364,12984
50,50680,2022-12-31,6650,6434,13084
50,50680,2023-12-31,6682,6500,13182
50,50680,2024-12-31,6724,6570,13294
50,50680,2025-12-31,6756,6629,13385
50,50680,2026-12-31,6797,6691,13488
50,50680,2027-12-31,6846,6766,13612
50,50680,2028-12-31,6877,6813,13690
50,50680,2029-12-31,6915,6880,13795
50,50680,2030-12-31,6948,6934,13882
50,50680,2031-12-31,6984,6983,13967
50,50680,2032-12-31,7010,7056,14066
50,50680,2033-12-31,7044,7104,14148
50,50680,2034-12-31,7066,7167,14233
50,50680,2035-12-31,7092,7219,14311
50,50683,1985-12-31,1630,6135,7765
50,50683,1986-12-31,1703,6001,7704
50,50683,1987-12-31,1747,5903,7650
50,50683,1988-12-31,1810,5852,7662
50,50683,1989-12-31,1858,5811,7669
50,50683,1990-12-31,1878,5937,7815
50,50683,1991-12-31,1981,5803,7784
50,50683,1992-12-31,2096,5602,7698
50,50683,1993-12-31,2130,5967,8097
50,50683,1994-12-31,2259,5820,8079
50,50683,1995-12-31,2331,5843,8174
50,50683,1996-12-31,2430,5836,8266
50,50683,1997-12-31,2513,5738,8251
50,50683,1998-12-31,2635,5634,8269
50,50683,1999-12-31,2719,5497,8216
50,50683,2000-12-31,2874,5336,8210
50,50683,2001-12-31,2972,5172,8144
50,50683,2002-12-31,3069,5039,8108
50,50683,2003-12-31,3161,4928,8089
50,50683,2004-12-31,3277,4874,8151
50,50683,2005-12-31,3384,4851,8235
50,50683,2006-12-31,3474,4830,8304
50,50683,2007-12-31,3554,4840,8394
50,50683,2008-12-31,3644,4830,8474
50,50683,2009-12-31,3743,4822,8565
50,50683,2010-12-31,3810,4826,8636
50,50683,2011-12-31,3894,4840,8734
50,50683,2012-12-31,3958,4826,8784
50,50683,2013-12-31,4001,4815,8816
50,50683,2014-12-31,4067,4795,8862
50,50683,2015-12-31,4160,4815,8975
50,50683,2016-12-31,4232,4817,9049
50,50683,2017-12-31,4294,4817,9111
50,50683,2018-12-31,4357,4761,9118
50,50683,2019-12-31,4401,4547,8948
50,50683,2020-12-31,4442,4423,8865
50,50683,2021-12-31,4463,4475,8938
50,50683,2022-12-31,4482,4525,9007
50,50683,2023-12-31,4503,4571,9074
50,50683,2024-12-31,4536,4610,9146
50,50683,2025-12-31,4554,4658,9212
50,50683,2026-12-31,4585,4697,9282
50,50683,2027-12-31,4612,4730,9342
50,50683,2028-12-31,4634,4762,9396
50,50683,2029-12-31,4659,4799,9458
50,50683,2030-12-31,4679,4822,9501
50,50683,2031-12-31,4694,4854,9548
50,50683,2032-12-31,4732,4880,9612
50,50683,2033-12-31,4754,4896,9650
50,50683,2034-12-31,4772,4937,9709
50,50683,2035-12-31,4782,4963,9745
50,50686,1985-12-31,237,1218,1455
50,50686,1986-12-31,242,1188,1430
50,50686,1987-12-31,262,1178,1440
50,50686,1988-12-31,265,1191,1456
50,50686,1989-12-31,294,1195,1489
50,50686,1990-12-31,368,1120,1488
50,50686,1991-12-31,291,1117,1408
50,50686,1992-12-31,310,1098,1408
50,50686,1993-12-31,325,1096,1421
50,50686,1994-12-31,344,1085,1429
50,50686,1995-12-31,379,1071,1450
50,50686,1996-12-31,387,1042,1429
50,50686,1997-12-31,377,1043,1420
50,50686,1998-12-31,413,1017,1430
50,50686,1999-12-31,466,980,1446
50,50686,2000-12-31,464,960,1424
50,50686,2001-12-31,461,909,1370
50,50686,2002-12-31,482,876,1358
50,50686,2003-12-31,496,853,1349
50,50686,2004-12-31,507,846,1353
50,50686,2005-12-31,531,825,1356
50,50686,2006-12-31,534,808,1342
50,50686,2007-12-31,544,801,1345
50,50686,2008-12-31,557,775,1332
50,50686,2009-12-31,562,782,1344
50,50686,2010-12-31,594,775,1369
50,50686,2011-12-31,599,767,1366
50,50686,2012-12-31,604,754,1358
50,50686,2013-12-31,646,767,1413
50,50686,2014-12-31,655,723,1378
50,50686,2015-12-31,655,693,1348
50,50686,2016-12-31,657,667,1324
50,50686,2017-12-31,664,646,1310
50,50686,2018-12-31,672,635,1307
50,50686,2019-12-31,679,587,1266
50,50686,2020-12-31,686,557,1243
50,50686,2021-12-31,689,564,1253
50,50686,2022-12-31,693,570,1263
50,50686,2023-12-31,696,576,1272
50,50686,2024-12-31,688,572,1260
50,50686,2025-12-31,693,587,1280
50,50686,2026-12-31,703,592,1295
50,50686,2027-12-31,713,597,1310
50,50686,2028-12-31,720,608,1328
50,50686,2029-12-31,726,600,1326
50,50686,2030-12-31,733,604,1337
50,50686,2031-12-31,733,608,1341
50,50686,2032-12-31,735,610,1345
50,50686,2033-12-31,731,610,1341
50,50686,2034-12-31,733,609,1342
50,50686,2035-12-31,736,630,1366
50,50689,1985-12-31,11688,8115,19803
50,50689,1986-12-31,11695,8576,20271
50,50689,1987-12-31,11711,9059,20770
50,50689,1988-12-31,11783,9514,21297
50,50689,1989-12-31,11855,9982,21837
50,50689,1990-12-31,11829,3400,15229
50,50689,1991-12-31,12152,3486,15638
50,50689,1992-12-31,12482,3594,16076
50,50689,1993-12-31,12666,3918,16584
50,50689,1994-12-31,13045,4000,17045
50,50689,1995-12-31,13264,4185,17449
50,50689,1996-12-31,13495,4356,17851
50,50689,1997-12-31,13861,4470,18331
50,50689,1998-12-31,14196,4554,18750
50,50689,1999-12-31,14605,4627,19232
50,50689,2000-12-31,15030,4651,19681
50,50689,2001-12-31,15463,4688,20151
50,50689,2002-12-31,15915,4718,20633
50,50689,2003-12-31,16257,4793,21050
50,50689,2004-12-31,16591,4897,21488
50,50689,2005-12-31,16889,5015,21904
50,50689,2006-12-31,17173,5179,22352
50,50689,2007-12-31,17426,5344,22770
50,50689,2008-12-31,17659,5498,23157
50,50689,2009-12-31,17874,5675,23549
50,50689,2010-12-31,18067,5861,23928
50,50689,2011-12-31,18287,6023,24310
50,50689,2012-12-31,18465,6203,24668
50,50689,2013-12-31,18624,6382,25006
50,50689,2014-12-31,18808,6546,25354
50,50689,2015-12-31,18959,6710,25669
50,50689,2016-12-31,19182,6869,26051
50,50689,2017-12-31,19358,7073,26431
50,50689,2018-12-31,19458,7249,26707
50,50689,2019-12-31,19271,7300,26571
50,50689,2020-12-31,19199,7300,26499
50,50689,2021-12-31,19331,7387,26718
50,50689,2022-12-31,19457,7468,26925
50,50689,2023-12-31,19581,7544,27125
50,50689,2024-12-31,19704,7620,27324
50,50689,2025-12-31,19820,7695,27515
50,50689,2026-12-31,19937,7766,27703
50,50689,2027-12-31,20056,7824,27880
50,50689,2028-12-31,20165,7873,28038
50,50689,2029-12-31,20273,7942,28215
50,50689,2030-12-31,20373,8000,28373
50,50689,2031-12-31,20475,8059,28534
50,50689,2032-12-31,20558,8119,28677
50,50689,2033-12-31,20650,8180,28830
50,50689,2034-12-31,20729,8222,28951
50,50689,2035-12-31,20792,8262,29054
50,50711,1985-12-31,3923,14580,18503
50,50711,1986-12-31,3939,14344,18283
50,50711,1987-12-31,3980,14147,18127
50,50711,1988-12-31,4023,13959,17982
50,50711,1989-12-31,4066,13774,17840
50,50711,1990-12-31,4072,13981,18053
50,50711,1991-12-31,4205,13661,17866
50,50711,1992-12-31,4346,13287,17633
50,50711,1993-12-31,4422,14056,18478
50,50711,1994-12-31,4558,13639,18197
50,50711,1995-12-31,4661,13629,18290
50,50711,1996-12-31,4768,13576,18344
50,50711,1997-12-31,4903,13405,18308
50,50711,1998-12-31,5042,13147,18189
50,50711,1999-12-31,5188,12790,17978
50,50711,2000-12-31,5366,12356,17722
50,50711,2001-12-31,5545,11943,17488
50,50711,2002-12-31,5744,11612,17356
50,50711,2003-12-31,5884,11367,17251
50,50711,2004-12-31,6001,11183,17184
50,50711,2005-12-31,6154,11080,17234
50,50711,2006-12-31,6250,11024,17274
50,50711,2007-12-31,6357,10995,17352
50,50711,2008-12-31,6463,10970,17433
50,50711,2009-12-31,6557,10944,17501
50,50711,2010-12-31,6665,10924,17589
50,50711,2011-12-31,6729,10896,17625
50,50711,2012-12-31,6823,10852,17675
50,50711,2013-12-31,6880,10806,17686
50,50711,2014-12-31,6994,10740,17734
50,50711,2015-12-31,7104,10690,17794
50,50711,2016-12-31,7148,10614,17762
50,50711,2017-12-31,7163,10525,17688
50,50711,2018-12-31,7254,10524,17778
50,50711,2019-12-31,7357,9811,17168
50,50711,2020-12-31,7453,9337,16790
50,50711,2021-12-31,7481,9448,16929
50,50711,2022-12-31,7508,9552,17060
50,50711,2023-12-31,7537,9650,17187
50,50711,2024-12-31,7582,9754,17336
50,50711,2025-12-31,7636,9826,17462
50,50711,2026-12-31,7668,9911,17579
50,50711,2027-12-31,7713,10002,17715
50,50711,2028-12-31,7768,10075,17843
50,50711,2029-12-31,7809,10143,17952
50,50711,2030-12-31,7842,10197,18039
50,50711,2031-12-31,7883,10254,18137
50,50711,2032-12-31,7916,10304,18220
50,50711,2033-12-31,7946,10364,18310
50,50711,2034-12-31,7976,10408,18384
50,50711,2035-12-31,8004,10445,18449
52,52001,1985-12-31,234803,60769,295572
52,52001,1986-12-31,238910,58078,296988
52,52001,1987-12-31,242989,55493,298482
52,52001,1988-12-31,247062,52981,300043
52,52001,1989-12-31,250497,50865,301362
52,52001,1990-12-31,250973,49472,300445
52,52001,1991-12-31,252497,47907,300404
52,52001,1992-12-31,256031,46125,302156
52,52001,1993-12-31,255842,31474,287316
52,52001,1994-12-31,260088,37121,297209
52,52001,1995-12-31,263661,42777,306438
52,52001,1996-12-31,267128,48395,315523
52,52001,1997-12-31,270316,53958,324274
52,52001,1998-12-31,273479,59491,332970
52,52001,1999-12-31,275968,65082,341050
52,52001,2000-12-31,278870,65642,344512
52,52001,2001-12-31,283028,66679,349707
52,52001,2002-12-31,285413,67962,353375
52,52001,2003-12-31,287742,69221,356963
52,52001,2004-12-31,289984,70485,360469
52,52001,2005-12-31,292064,71752,363816
52,52001,2006-12-31,294330,73026,367356
52,52001,2007-12-31,296352,74230,370582
52,52001,2008-12-31,297947,75357,373304
52,52001,2009-12-31,299328,76432,375760
52,52001,2010-12-31,300606,77466,378072
52,52001,2011-12-31,301761,78484,380245
52,52001,2012-12-31,302882,79451,382333
52,52001,2013-12-31,303742,80345,384087
52,52001,2014-12-31,304475,81235,385710
52,52001,2015-12-31,305233,82155,387388
52,52001,2016-12-31,306109,83075,389184
52,52001,2017-12-31,306793,83934,390727
52,52001,2018-12-31,308095,84835,392930
52,52001,2019-12-31,306527,86221,392748
52,52001,2020-12-31,305360,87229,392589
52,52001,2021-12-31,305329,87238,392567
52,52001,2022-12-31,305733,87276,393009
52,52001,2023-12-31,306171,87305,393476
52,52001,2024-12-31,306822,87374,394196
52,52001,2025-12-31,307640,87457,395097
52,52001,2026-12-31,308582,87573,396155
52,52001,2027-12-31,309567,87738,397305
52,52001,2028-12-31,310623,87917,398540
52,52001,2029-12-31,311748,88119,399867
52,52001,2030-12-31,312931,88383,401314
52,52001,2031-12-31,314050,88632,402682
52,52001,2032-12-31,315076,88859,403935
52,52001,2033-12-31,316104,89083,405187
52,52001,2034-12-31,317020,89292,406312
52,52001,2035-12-31,317886,89484,407370
52,52019,1985-12-31,2682,14808,17490
52,52019,1986-12-31,2697,15563,18260
52,52019,1987-12-31,2716,16301,19017
52,52019,1988-12-31,2713,17015,19728
52,52019,1989-12-31,2743,17816,20559
52,52019,1990-12-31,2712,18888,21600
52,52019,1991-12-31,2720,19884,22604
52,52019,1992-12-31,2723,20801,23524
52,52019,1993-12-31,2704,9574,12278
52,52019,1994-12-31,2706,9416,12122
52,52019,1995-12-31,2731,9285,12016
52,52019,1996-12-31,2745,9136,11881
52,52019,1997-12-31,2759,9017,11776
52,52019,1998-12-31,2730,8895,11625
52,52019,1999-12-31,2739,8792,11531
52,52019,2000-12-31,2753,8670,11423
52,52019,2001-12-31,2761,8541,11302
52,52019,2002-12-31,2763,8461,11224
52,52019,2003-12-31,2771,8386,11157
52,52019,2004-12-31,2777,8315,11092
52,52019,2005-12-31,2772,8244,11016
52,52019,2006-12-31,2769,8152,10921
52,52019,2007-12-31,2784,8058,10842
52,52019,2008-12-31,2765,7981,10746
52,52019,2009-12-31,2762,7896,10658
52,52019,2010-12-31,2748,7797,10545
52,52019,2011-12-31,2753,7721,10474
52,52019,2012-12-31,2766,7589,10355
52,52019,2013-12-31,2770,7452,10222
52,52019,2014-12-31,2741,7363,10104
52,52019,2015-12-31,2663,7273,9936
52,52019,2016-12-31,2687,7120,9807
52,52019,2017-12-31,2740,7067,9807
52,52019,2018-12-31,2691,6951,9642
52,52019,2019-12-31,2686,6757,9443
52,52019,2020-12-31,2682,6638,9320
52,52019,2021-12-31,2681,6637,9318
52,52019,2022-12-31,2688,6640,9328
52,52019,2023-12-31,2697,6642,9339
52,52019,2024-12-31,2701,6648,9349
52,52019,2025-12-31,2713,6648,9361
52,52019,2026-12-31,2721,6670,9391
52,52019,2027-12-31,2733,6669,9402
52,52019,2028-12-31,2745,6682,9427
52,52019,2029-12-31,2749,6708,9457
52,52019,2030-12-31,2758,6705,9463
52,52019,2031-12-31,2764,6734,9498
52,52019,2032-12-31,2777,6758,9535
52,52019,2033-12-31,2785,6765,9550
52,52019,2034-12-31,2810,6775,9585
52,52019,2035-12-31,2799,6794,9593
52,52022,1985-12-31,1347,3987,5334
52,52022,1986-12-31,1347,3991,5338
52,52022,1987-12-31,1357,4028,5385
52,52022,1988-12-31,1411,4043,5454
52,52022,1989-12-31,1354,4063,5417
52,52022,1990-12-31,1370,4156,5526
52,52022,1991-12-31,1380,4248,5628
52,52022,1992-12-31,1408,4321,5729
52,52022,1993-12-31,1387,4491,5878
52,52022,1994-12-31,1400,4514,5914
52,52022,1995-12-31,1402,4571,5973
52,52022,1996-12-31,1422,4632,6054
52,52022,1997-12-31,1456,4666,6122
52,52022,1998-12-31,1467,4710,6177
52,52022,1999-12-31,1471,4775,6246
52,52022,2000-12-31,1501,4830,6331
52,52022,2001-12-31,1496,4865,6361
52,52022,2002-12-31,1505,4940,6445
52,52022,2003-12-31,1506,5013,6519
52,52022,2004-12-31,1526,5074,6600
52,52022,2005-12-31,1528,5150,6678
52,52022,2006-12-31,1537,5223,6760
52,52022,2007-12-31,1539,5306,6845
52,52022,2008-12-31,1555,5357,6912
52,52022,2009-12-31,1542,5401,6943
52,52022,2010-12-31,1550,5435,6985
52,52022,2011-12-31,1536,5510,7046
52,52022,2012-12-31,1508,5543,7051
52,52022,2013-12-31,1536,5594,7130
52,52022,2014-12-31,1556,5682,7238
52,52022,2015-12-31,1550,5694,7244
52,52022,2016-12-31,1543,5693,7236
52,52022,2017-12-31,1544,5811,7355
52,52022,2018-12-31,1549,5843,7392
52,52022,2019-12-31,1550,5825,7375
52,52022,2020-12-31,1552,5809,7361
52,52022,2021-12-31,1550,5809,7359
52,52022,2022-12-31,1556,5811,7367
52,52022,2023-12-31,1563,5813,7376
52,52022,2024-12-31,1559,5806,7365
52,52022,2025-12-31,1566,5816,7382
52,52022,2026-12-31,1571,5835,7406
52,52022,2027-12-31,1587,5838,7425
52,52022,2028-12-31,1590,5850,7440
52,52022,2029-12-31,1598,5856,7454
52,52022,2030-12-31,1593,5876,7469
52,52022,2031-12-31,1602,5893,7495
52,52022,2032-12-31,1603,5893,7496
52,52022,2033-12-31,1621,5925,7546
52,52022,2034-12-31,1614,5933,7547
52,52022,2035-12-31,1614,5939,7553
52,52036,1985-12-31,3364,7772,11136
52,52036,1986-12-31,3335,7642,10977
52,52036,1987-12-31,3322,7514,10836
52,52036,1988-12-31,3301,7399,10700
52,52036,1989-12-31,3281,7346,10627
52,52036,1990-12-31,3212,7369,10581
52,52036,1991-12-31,3158,7379,10537
52,52036,1992-12-31,3151,7351,10502
52,52036,1993-12-31,3085,7507,10592
52,52036,1994-12-31,3069,7422,10491
52,52036,1995-12-31,3043,7368,10411
52,52036,1996-12-31,2987,7319,10306
52,52036,1997-12-31,2952,7273,10225
52,52036,1998-12-31,2943,7224,10167
52,52036,1999-12-31,2903,7211,10114
52,52036,2000-12-31,2892,7168,10060
52,52036,2001-12-31,2852,7131,9983
52,52036,2002-12-31,2808,7122,9930
52,52036,2003-12-31,2766,7118,9884
52,52036,2004-12-31,2721,7108,9829
52,52036,2005-12-31,2685,7078,9763
52,52036,2006-12-31,2656,7126,9782
52,52036,2007-12-31,2622,7064,9686
52,52036,2008-12-31,2589,6998,9587
52,52036,2009-12-31,2541,6947,9488
52,52036,2010-12-31,2507,6896,9403
52,52036,2011-12-31,2482,6869,9351
52,52036,2012-12-31,2453,6880,9333
52,52036,2013-12-31,2376,6861,9237
52,52036,2014-12-31,2231,6821,9052
52,52036,2015-12-31,2230,6708,8938
52,52036,2016-12-31,2231,6618,8849
52,52036,2017-12-31,2123,6630,8753
52,52036,2018-12-31,2147,6654,8801
52,52036,2019-12-31,2115,6563,8678
52,52036,2020-12-31,2086,6517,8603
52,52036,2021-12-31,2085,6516,8601
52,52036,2022-12-31,2091,6519,8610
52,52036,2023-12-31,2100,6521,8621
52,52036,2024-12-31,2108,6516,8624
52,52036,2025-12-31,2115,6529,8644
52,52036,2026-12-31,2124,6521,8645
52,52036,2027-12-31,2134,6529,8663
52,52036,2028-12-31,2131,6543,8674
52,52036,2029-12-31,2150,6560,8710
52,52036,2030-12-31,2154,6580,8734
52,52036,2031-12-31,2157,6569,8726
52,52036,2032-12-31,2165,6601,8766
52,52036,2033-12-31,2170,6616,8786
52,52036,2034-12-31,2179,6626,8805
52,52036,2035-12-31,2196,6641,8837
52,52051,1985-12-31,847,12962,13809
52,52051,1986-12-31,875,12696,13571
52,52051,1987-12-31,883,12444,13327
52,52051,1988-12-31,899,12210,13109
52,52051,1989-12-31,920,12039,12959
52,52051,1990-12-31,937,6375,7312
52,52051,1991-12-31,932,6441,7373
52,52051,1992-12-31,953,6484,7437
52,52051,1993-12-31,932,6671,7603
52,52051,1994-12-31,967,6644,7611
52,52051,1995-12-31,991,6669,7660
52,52051,1996-12-31,989,6684,7673
52,52051,1997-12-31,1026,6672,7698
52,52051,1998-12-31,1036,6716,7752
52,52051,1999-12-31,1021,6735,7756
52,52051,2000-12-31,1048,6733,7781
52,52051,2001-12-31,1085,6753,7838
52,52051,2002-12-31,1061,6803,7864
52,52051,2003-12-31,1053,6841,7894
52,52051,2004-12-31,1050,6916,7966
52,52051,2005-12-31,1048,6965,8013
52,52051,2006-12-31,1083,7013,8096
52,52051,2007-12-31,1103,7053,8156
52,52051,2008-12-31,1112,7105,8217
52,52051,2009-12-31,1120,7136,8256
52,52051,2010-12-31,1108,7150,8258
52,52051,2011-12-31,1104,7170,8274
52,52051,2012-12-31,1120,7164,8284
52,52051,2013-12-31,1131,7182,8313
52,52051,2014-12-31,1134,7231,8365
52,52051,2015-12-31,1144,7258,8402
52,52051,2016-12-31,1150,7248,8398
52,52051,2017-12-31,1162,7237,8399
52,52051,2018-12-31,1172,7271,8443
52,52051,2019-12-31,1161,7270,8431
52,52051,2020-12-31,1151,7269,8420
52,52051,2021-12-31,1149,7269,8418
52,52051,2022-12-31,1156,7271,8427
52,52051,2023-12-31,1163,7274,8437
52,52051,2024-12-31,1166,7276,8442
52,52051,2025-12-31,1168,7292,8460
52,52051,2026-12-31,1170,7297,8467
52,52051,2027-12-31,1167,7313,8480
52,52051,2028-12-31,1174,7316,8490
52,52051,2029-12-31,1184,7347,8531
52,52051,2030-12-31,1191,7336,8527
52,52051,2031-12-31,1194,7382,8576
52,52051,2032-12-31,1200,7392,8592
52,52051,2033-12-31,1205,7418,8623
52,52051,2034-12-31,1211,7421,8632
52,52051,2035-12-31,1208,7438,8646
52,52079,1985-12-31,5277,16175,21452
52,52079,1986-12-31,5532,16883,22415
52,52079,1987-12-31,5809,17561,23370
52,52079,1988-12-31,6075,18261,24336
52,52079,1989-12-31,6315,19034,25349
52,52079,1990-12-31,6493,20087,26580
52,52079,1991-12-31,6683,21072,27755
52,52079,1992-12-31,6942,21978,28920
52,52079,1993-12-31,7090,23348,30438
52,52079,1994-12-31,7355,24079,31434
52,52079,1995-12-31,7621,24896,32517
52,52079,1996-12-31,7870,25688,33558
52,52079,1997-12-31,8121,26487,34608
52,52079,1998-12-31,8367,27277,35644
52,52079,1999-12-31,8593,28102,36695
52,52079,2000-12-31,8823,28864,37687
52,52079,2001-12-31,9098,29680,38778
52,52079,2002-12-31,9315,30601,39916
52,52079,2003-12-31,9528,31509,41037
52,52079,2004-12-31,9743,32423,42166
52,52079,2005-12-31,9941,33300,43241
52,52079,2006-12-31,10162,34239,44401
52,52079,2007-12-31,10352,35156,45508
52,52079,2008-12-31,10537,36009,46546
52,52079,2009-12-31,10705,36850,47555
52,52079,2010-12-31,10881,37655,48536
52,52079,2011-12-31,11050,38456,49506
52,52079,2012-12-31,11211,39238,50449
52,52079,2013-12-31,11359,39986,51345
52,52079,2014-12-31,11507,40714,52221
52,52079,2015-12-31,11651,41447,53098
52,52079,2016-12-31,11815,42169,53984
52,52079,2017-12-31,11970,42869,54839
52,52079,2018-12-31,12075,43558,55633
52,52079,2019-12-31,12217,43978,56195
52,52079,2020-12-31,12304,44222,56526
52,52079,2021-12-31,12297,44227,56524
52,52079,2022-12-31,12342,44244,56586
52,52079,2023-12-31,12393,44260,56653
52,52079,2024-12-31,12447,44334,56781
52,52079,2025-12-31,12500,44406,56906
52,52079,2026-12-31,12517,44492,57009
52,52079,2027-12-31,12567,44628,57195
52,52079,2028-12-31,12637,44763,57400
52,52079,2029-12-31,12670,44890,57560
52,52079,2030-12-31,12748,45069,57817
52,52079,2031-12-31,12799,45256,58055
52,52079,2032-12-31,12850,45413,58263
52,52079,2033-12-31,12887,45562,58449
52,52079,2034-12-31,12928,45732,58660
52,52079,2035-12-31,12973,45875,58848
52,52083,1985-12-31,1366,1394,2760
52,52083,1986-12-31,1461,1447,2908
52,52083,1987-12-31,1524,1473,2997
52,52083,1988-12-31,1617,1517,3134
52,52083,1989-12-31,1696,1545,3241
52,52083,1990-12-31,1726,1612,3338
52,52083,1991-12-31,1786,1694,3480
52,52083,1992-12-31,1852,1726,3578
52,52083,1993-12-31,1894,1842,3736
52,52083,1994-12-31,1972,1888,3860
52,52083,1995-12-31,2049,1928,3977
52,52083,1996-12-31,2112,1991,4103
52,52083,1997-12-31,2168,2033,4201
52,52083,1998-12-31,2238,2086,4324
52,52083,1999-12-31,2300,2131,4431
52,52083,2000-12-31,2357,2183,4540
52,52083,2001-12-31,2429,2240,4669
52,52083,2002-12-31,2505,2298,4803
52,52083,2003-12-31,2546,2333,4879
52,52083,2004-12-31,2622,2419,5041
52,52083,2005-12-31,2633,2447,5080
52,52083,2006-12-31,2733,2505,5238
52,52083,2007-12-31,2760,2561,5321
52,52083,2008-12-31,2806,2617,5423
52,52083,2009-12-31,2882,2661,5543
52,52083,2010-12-31,2939,2704,5643
52,52083,2011-12-31,2991,2731,5722
52,52083,2012-12-31,3044,2810,5854
52,52083,2013-12-31,3088,2830,5918
52,52083,2014-12-31,3132,2840,5972
52,52083,2015-12-31,3123,2877,6000
52,52083,2016-12-31,3184,3000,6184
52,52083,2017-12-31,3228,3048,6276
52,52083,2018-12-31,3262,3060,6322
52,52083,2019-12-31,3253,3058,6311
52,52083,2020-12-31,3245,3056,6301
52,52083,2021-12-31,3244,3056,6300
52,52083,2022-12-31,3249,3057,6306
52,52083,2023-12-31,3256,3058,6314
52,52083,2024-12-31,3268,3061,6329
52,52083,2025-12-31,3270,3048,6318
52,52083,2026-12-31,3288,3071,6359
52,52083,2027-12-31,3295,3063,6358
52,52083,2028-12-31,3310,3075,6385
52,52083,2029-12-31,3326,3094,6420
52,52083,2030-12-31,3335,3087,6422
52,52083,2031-12-31,3351,3087,6438
52,52083,2032-12-31,3347,3094,6441
52,52083,2033-12-31,3371,3108,6479
52,52083,2034-12-31,3371,3115,6486
52,52083,2035-12-31,3384,3123,6507
52,52110,1985-12-31,3222,17341,20563
52,52110,1986-12-31,3337,17128,20465
52,52110,1987-12-31,3459,16935,20394
52,52110,1988-12-31,3606,16753,20359
52,52110,1989-12-31,3727,16687,20414
52,52110,1990-12-31,3803,16832,20635
52,52110,1991-12-31,3908,16932,20840
52,52110,1992-12-31,4042,16969,21011
52,52110,1993-12-31,4118,17370,21488
52,52110,1994-12-31,4226,17292,21518
52,52110,1995-12-31,4376,17237,21613
52,52110,1996-12-31,4502,17218,21720
52,52110,1997-12-31,4619,17194,21813
52,52110,1998-12-31,4738,17143,21881
52,52110,1999-12-31,4858,17179,22037
52,52110,2000-12-31,4966,17136,22102
52,52110,2001-12-31,5093,17153,22246
52,52110,2002-12-31,5207,17214,22421
52,52110,2003-12-31,5316,17263,22579
52,52110,2004-12-31,5434,17319,22753
52,52110,2005-12-31,5521,17361,22882
52,52110,2006-12-31,5639,17408,23047
52,52110,2007-12-31,5708,17448,23156
52,52110,2008-12-31,5788,17447,23235
52,52110,2009-12-31,5958,17483,23441
52,52110,2010-12-31,5976,17477,23453
52,52110,2011-12-31,6079,17487,23566
52,52110,2012-12-31,6166,17470,23636
52,52110,2013-12-31,6238,17480,23718
52,52110,2014-12-31,6301,17456,23757
52,52110,2015-12-31,6372,17420,23792
52,52110,2016-12-31,6453,17399,23852
52,52110,2017-12-31,6501,17403,23904
52,52110,2018-12-31,6552,17356,23908
52,52110,2019-12-31,6575,17334,23909
52,52110,2020-12-31,6586,17324,23910
52,52110,2021-12-31,6586,17323,23909
52,52110,2022-12-31,6606,17329,23935
52,52110,2023-12-31,6629,17335,23964
52,52110,2024-12-31,6658,17346,24004
52,52110,2025-12-31,6673,17369,24042
52,52110,2026-12-31,6702,17390,24092
52,52110,2027-12-31,6729,17400,24129
52,52110,2028-12-31,6748,17431,24179
52,52110,2029-12-31,6774,17470,24244
52,52110,2030-12-31,6800,17524,24324
52,52110,2031-12-31,6824,17561,24385
52,52110,2032-12-31,6849,17605,24454
52,52110,2033-12-31,6862,17638,24500
52,52110,2034-12-31,6890,17682,24572
52,52110,2035-12-31,6907,17702,24609
52,52203,1985-12-31,639,8635,9274
52,52203,1986-12-31,693,8464,9157
52,52203,1987-12-31,704,8330,9034
52,52203,1988-12-31,734,8185,8919
52,52203,1989-12-31,763,8116,8879
52,52203,1990-12-31,715,8165,8880
52,52203,1991-12-31,728,8190,8918
52,52203,1992-12-31,739,8175,8914
52,52203,1993-12-31,741,8337,9078
52,52203,1994-12-31,762,8237,8999
52,52203,1995-12-31,789,8187,8976
52,52203,1996-12-31,826,8147,8973
52,52203,1997-12-31,849,8086,8935
52,52203,1998-12-31,860,8040,8900
52,52203,1999-12-31,851,7993,8844
52,52203,2000-12-31,883,7947,8830
52,52203,2001-12-31,912,7917,8829
52,52203,2002-12-31,896,7910,8806
52,52203,2003-12-31,928,7903,8831
52,52203,2004-12-31,923,7875,8798
52,52203,2005-12-31,942,7865,8807
52,52203,2006-12-31,955,7868,8823
52,52203,2007-12-31,960,7839,8799
52,52203,2008-12-31,959,7812,8771
52,52203,2009-12-31,981,7799,8780
52,52203,2010-12-31,968,7761,8729
52,52203,2011-12-31,969,7724,8693
52,52203,2012-12-31,985,7689,8674
52,52203,2013-12-31,1000,7633,8633
52,52203,2014-12-31,1082,7633,8715
52,52203,2015-12-31,1093,7586,8679
52,52203,2016-12-31,1086,7504,8590
52,52203,2017-12-31,1085,7445,8530
52,52203,2018-12-31,1089,7437,8526
52,52203,2019-12-31,1090,7313,8403
52,52203,2020-12-31,1092,7224,8316
52,52203,2021-12-31,1091,7223,8314
52,52203,2022-12-31,1097,7226,8323
52,52203,2023-12-31,1104,7229,8333
52,52203,2024-12-31,1105,7233,8338
52,52203,2025-12-31,1114,7235,8349
52,52203,2026-12-31,1114,7239,8353
52,52203,2027-12-31,1119,7252,8371
52,52203,2028-12-31,1117,7267,8384
52,52203,2029-12-31,1122,7273,8395
52,52203,2030-12-31,1130,7306,8436
52,52203,2031-12-31,1130,7311,8441
52,52203,2032-12-31,1135,7328,8463
52,52203,2033-12-31,1139,7354,8493
52,52203,2034-12-31,1141,7357,8498
52,52203,2035-12-31,1154,7393,8547
52,52207,1985-12-31,1803,9152,10955
52,52207,1986-12-31,1797,9132,10929
52,52207,1987-12-31,1827,9112,10939
52,52207,1988-12-31,1839,9062,10901
52,52207,1989-12-31,1892,9093,10985
52,52207,1990-12-31,1875,9277,11152
52,52207,1991-12-31,1855,9463,11318
52,52207,1992-12-31,1872,9509,11381
52,52207,1993-12-31,1908,9845,11753
52,52207,1994-12-31,1908,9871,11779
52,52207,1995-12-31,1935,9911,11846
52,52207,1996-12-31,1953,9967,11920
52,52207,1997-12-31,1973,10021,11994
52,52207,1998-12-31,1978,10089,12067
52,52207,1999-12-31,1977,10162,12139
52,52207,2000-12-31,1999,10229,12228
52,52207,2001-12-31,2055,10308,12363
52,52207,2002-12-31,2049,10419,12468
52,52207,2003-12-31,2057,10526,12583
52,52207,2004-12-31,2070,10637,12707
52,52207,2005-12-31,2084,10733,12817
52,52207,2006-12-31,2086,10832,12918
52,52207,2007-12-31,2105,10915,13020
52,52207,2008-12-31,2121,11008,13129
52,52207,2009-12-31,2138,11091,13229
52,52207,2010-12-31,2118,11142,13260
52,52207,2011-12-31,2095,11199,13294
52,52207,2012-12-31,2099,11268,13367
52,52207,2013-12-31,2091,11350,13441
52,52207,2014-12-31,2083,11409,13492
52,52207,2015-12-31,2095,11491,13586
52,52207,2016-12-31,2108,11568,13676
52,52207,2017-12-31,2123,11552,13675
52,52207,2018-12-31,2146,11638,13784
52,52207,2019-12-31,2142,11619,13761
52,52207,2020-12-31,2139,11599,13738
52,52207,2021-12-31,2137,11598,13735
52,52207,2022-12-31,2147,11603,13750
52,52207,2023-12-31,2159,11607,13766
52,52207,2024-12-31,2179,11609,13788
52,52207,2025-12-31,2178,11619,13797
52,52207,2026-12-31,2182,11623,13805
52,52207,2027-12-31,2199,11641,13840
52,52207,2028-12-31,2198,11662,13860
52,52207,2029-12-31,2208,11687,13895
52,52207,2030-12-31,2218,11704,13922
52,52207,2031-12-31,2224,11753,13977
52,52207,2032-12-31,2230,11772,14002
52,52207,2033-12-31,2234,11792,14026
52,52207,2034-12-31,2245,11813,14058
52,52207,2035-12-31,2247,11829,14076
52,52210,1985-12-31,1126,5248,6374
52,52210,1986-12-31,1114,5205,6319
52,52210,1987-12-31,1152,5143,6295
52,52210,1988-12-31,1161,5127,6288
52,52210,1989-12-31,1161,5130,6291
52,52210,1990-12-31,1181,5213,6394
52,52210,1991-12-31,1165,5274,6439
52,52210,1992-12-31,1215,5291,6506
52,52210,1993-12-31,1183,5450,6633
52,52210,1994-12-31,1257,5465,6722
52,52210,1995-12-31,1233,5446,6679
52,52210,1996-12-31,1241,5441,6682
52,52210,1997-12-31,1263,5453,6716
52,52210,1998-12-31,1246,5478,6724
52,52210,1999-12-31,1246,5491,6737
52,52210,2000-12-31,1236,5526,6762
52,52210,2001-12-31,1268,5528,6796
52,52210,2002-12-31,1270,5571,6841
52,52210,2003-12-31,1284,5612,6896
52,52210,2004-12-31,1288,5659,6947
52,52210,2005-12-31,1308,5690,6998
52,52210,2006-12-31,1287,5725,7012
52,52210,2007-12-31,1287,5773,7060
52,52210,2008-12-31,1284,5798,7082
52,52210,2009-12-31,1278,5822,7100
52,52210,2010-12-31,1314,5845,7159
52,52210,2011-12-31,1280,5815,7095
52,52210,2012-12-31,1264,5825,7089
52,52210,2013-12-31,1260,5861,7121
52,52210,2014-12-31,1283,5871,7154
52,52210,2015-12-31,1331,5895,7226
52,52210,2016-12-31,1325,5882,7207
52,52210,2017-12-31,1317,5921,7238
52,52210,2018-12-31,1310,5960,7270
52,52210,2019-12-31,1308,5944,7252
52,52210,2020-12-31,1306,5930,7236
52,52210,2021-12-31,1304,5930,7234
52,52210,2022-12-31,1310,5932,7242
52,52210,2023-12-31,1317,5934,7251
52,52210,2024-12-31,1320,5926,7246
52,52210,2025-12-31,1320,5940,7260
52,52210,2026-12-31,1326,5946,7272
52,52210,2027-12-31,1331,5949,7280
52,52210,2028-12-31,1337,5970,7307
52,52210,2029-12-31,1343,5980,7323
52,52210,2030-12-31,1337,6003,7340
52,52210,2031-12-31,1342,6005,7347
52,52210,2032-12-31,1358,6025,7383
52,52210,2033-12-31,1360,6032,7392
52,52210,2034-12-31,1359,6051,7410
52,52210,2035-12-31,1374,6055,7429
52,52215,1985-12-31,2014,9452,11466
52,52215,1986-12-31,2068,9427,11495
52,52215,1987-12-31,2073,9428,11501
52,52215,1988-12-31,2136,9410,11546
52,52215,1989-12-31,2191,9470,11661
52,52215,1990-12-31,2178,9663,11841
52,52215,1991-12-31,2225,9813,12038
52,52215,1992-12-31,2263,9914,12177
52,52215,1993-12-31,2297,10254,12551
52,52215,1994-12-31,2340,10302,12642
52,52215,1995-12-31,2389,10374,12763
52,52215,1996-12-31,2431,10437,12868
52,52215,1997-12-31,2461,10520,12981
52,52215,1998-12-31,2498,10591,13089
52,52215,1999-12-31,2535,10679,13214
52,52215,2000-12-31,2618,10749,13367
52,52215,2001-12-31,2616,10840,13456
52,52215,2002-12-31,2715,10969,13684
52,52215,2003-12-31,2726,11083,13809
52,52215,2004-12-31,2745,11205,13950
52,52215,2005-12-31,2777,11329,14106
52,52215,2006-12-31,2824,11454,14278
52,52215,2007-12-31,2848,11563,14411
52,52215,2008-12-31,2890,11670,14560
52,52215,2009-12-31,2884,11768,14652
52,52215,2010-12-31,2908,11841,14749
52,52215,2011-12-31,2910,11938,14848
52,52215,2012-12-31,2936,12015,14951
52,52215,2013-12-31,2990,12075,15065
52,52215,2014-12-31,3031,12158,15189
52,52215,2015-12-31,3044,12212,15256
52,52215,2016-12-31,3025,12324,15349
52,52215,2017-12-31,3052,12383,15435
52,52215,2018-12-31,3081,12435,15516
52,52215,2019-12-31,3076,12420,15496
52,52215,2020-12-31,3071,12406,15477
52,52215,2021-12-31,3069,12405,15474
52,52215,2022-12-31,3080,12410,15490
52,52215,2023-12-31,3095,12414,15509
52,52215,2024-12-31,3108,12441,15549
52,52215,2025-12-31,3118,12443,15561
52,52215,2026-12-31,3121,12457,15578
52,52215,2027-12-31,3134,12464,15598
52,52215,2028-12-31,3159,12503,15662
52,52215,2029-12-31,3151,12536,15687
52,52215,2030-12-31,3170,12573,15743
52,52215,2031-12-31,3181,12618,15799
52,52215,2032-12-31,3204,12640,15844
52,52215,2033-12-31,3203,12673,15876
52,52215,2034-12-31,3216,12695,15911
52,52215,2035-12-31,3224,12729,15953
52,52224,1985-12-31,1544,4177,5721
52,52224,1986-12-31,1621,4227,5848
52,52224,1987-12-31,1645,4230,5875
52,52224,1988-12-31,1664,4282,5946
52,52224,1989-12-31,1724,4301,6025
52,52224,1990-12-31,1758,4426,6184
52,52224,1991-12-31,1774,4534,6308
52,52224,1992-12-31,1829,4621,6450
52,52224,1993-12-31,1852,4788,6640
52,52224,1994-12-31,1909,4848,6757
52,52224,1995-12-31,1948,4901,6849
52,52224,1996-12-31,2011,4965,6976
52,52224,1997-12-31,2058,5014,7072
52,52224,1998-12-31,2095,5074,7169
52,52224,1999-12-31,2127,5163,7290
52,52224,2000-12-31,2185,5219,7404
52,52224,2001-12-31,2239,5287,7526
52,52224,2002-12-31,2284,5375,7659
52,52224,2003-12-31,2275,5465,7740
52,52224,2004-12-31,2288,5549,7837
52,52224,2005-12-31,2344,5642,7986
52,52224,2006-12-31,2379,5727,8106
52,52224,2007-12-31,2419,5817,8236
52,52224,2008-12-31,2399,5887,8286
52,52224,2009-12-31,2472,5963,8435
52,52224,2010-12-31,2537,6020,8557
52,52224,2011-12-31,2590,6067,8657
52,52224,2012-12-31,2629,6103,8732
52,52224,2013-12-31,2657,6178,8835
52,52224,2014-12-31,2678,6277,8955
52,52224,2015-12-31,2650,6316,8966
52,52224,2016-12-31,2660,6349,9009
52,52224,2017-12-31,2685,6457,9142
52,52224,2018-12-31,2708,6493,9201
52,52224,2019-12-31,2708,6491,9199
52,52224,2020-12-31,2707,6491,9198
52,52224,2021-12-31,2707,6491,9198
52,52224,2022-12-31,2715,6493,9208
52,52224,2023-12-31,2724,6495,9219
52,52224,2024-12-31,2732,6495,9227
52,52224,2025-12-31,2744,6496,9240
52,52224,2026-12-31,2761,6514,9275
52,52224,2027-12-31,2761,6545,9306
52,52224,2028-12-31,2763,6540,9303
52,52224,2029-12-31,2787,6546,9333
52,52224,2030-12-31,2787,6584,9371
52,52224,2031-12-31,2802,6594,9396
52,52224,2032-12-31,2801,6610,9411
52,52224,2033-12-31,2823,6637,9460
52,52224,2034-12-31,2835,6634,9469
52,52224,2035-12-31,2824,6658,9482
52,52227,1985-12-31,4245,9387,13632
52,52227,1986-12-31,4367,9961,14328
52,52227,1987-12-31,4476,10521,14997
52,52227,1988-12-31,4582,11061,15643
52,52227,1989-12-31,4687,11656,16343
52,52227,1990-12-31,4743,12431,17174
52,52227,1991-12-31,4810,13163,17973
52,52227,1992-12-31,4929,13815,18744
52,52227,1993-12-31,4966,14815,19781
52,52227,1994-12-31,5069,15401,20470
52,52227,1995-12-31,5157,15994,21151
52,52227,1996-12-31,5266,16612,21878
52,52227,1997-12-31,5386,17217,22603
52,52227,1998-12-31,5467,17822,23289
52,52227,1999-12-31,5558,18463,24021
52,52227,2000-12-31,5658,19055,24713
52,52227,2001-12-31,5781,19667,25448
52,52227,2002-12-31,5867,20361,26228
52,52227,2003-12-31,5936,21029,26965
52,52227,2004-12-31,6035,21714,27749
52,52227,2005-12-31,6115,22381,28496
52,52227,2006-12-31,6177,23064,29241
52,52227,2007-12-31,6261,23725,29986
52,52227,2008-12-31,6357,24367,30724
52,52227,2009-12-31,6408,24971,31379
52,52227,2010-12-31,6445,25572,32017
52,52227,2011-12-31,6504,26164,32668
52,52227,2012-12-31,6571,26761,33332
52,52227,2013-12-31,6622,27312,33934
52,52227,2014-12-31,6629,27865,34494
52,52227,2015-12-31,6675,28420,35095
52,52227,2016-12-31,6793,28969,35762
52,52227,2017-12-31,6740,29520,36260
52,52227,2018-12-31,6835,30029,36864
52,52227,2019-12-31,6824,30151,36975
52,52227,2020-12-31,6813,30220,37033
52,52227,2021-12-31,6809,30223,37032
52,52227,2022-12-31,6837,30235,37072
52,52227,2023-12-31,6870,30246,37116
52,52227,2024-12-31,6895,30264,37159
52,52227,2025-12-31,6909,30307,37216
52,52227,2026-12-31,6946,30350,37296
52,52227,2027-12-31,6970,30405,37375
52,52227,2028-12-31,6987,30476,37463
52,52227,2029-12-31,7021,30565,37586
52,52227,2030-12-31,7037,30651,37688
52,52227,2031-12-31,7082,30734,37816
52,52227,2032-12-31,7103,30828,37931
52,52227,2033-12-31,7129,30900,38029
52,52227,2034-12-31,7136,30984,38120
52,52227,2035-12-31,7170,31065,38235
52,52233,1985-12-31,703,6110,6813
52,52233,1986-12-31,696,5975,6671
52,52233,1987-12-31,747,5833,6580
52,52233,1988-12-31,791,5721,6512
52,52233,1989-12-31,836,5621,6457
52,52233,1990-12-31,844,5628,6472
52,52233,1991-12-31,881,5597,6478
52,52233,1992-12-31,882,5566,6448
52,52233,1993-12-31,896,5648,6544
52,52233,1994-12-31,970,5577,6547
52,52233,1995-12-31,975,5513,6488
52,52233,1996-12-31,1026,5433,6459
52,52233,1997-12-31,1052,5352,6404
52,52233,1998-12-31,1055,5320,6375
52,52233,1999-12-31,1112,5275,6387
52,52233,2000-12-31,1193,5229,6422
52,52233,2001-12-31,1194,5159,6353
52,52233,2002-12-31,1221,5121,6342
52,52233,2003-12-31,1255,5082,6337
52,52233,2004-12-31,1308,5037,6345
52,52233,2005-12-31,1315,4997,6312
52,52233,2006-12-31,1338,4954,6292
52,52233,2007-12-31,1378,4923,6301
52,52233,2008-12-31,1401,4891,6292
52,52233,2009-12-31,1418,4772,6190
52,52233,2010-12-31,1453,4738,6191
52,52233,2011-12-31,1460,4692,6152
52,52233,2012-12-31,1465,4654,6119
52,52233,2013-12-31,1466,4603,6069
52,52233,2014-12-31,1500,4543,6043
52,52233,2015-12-31,1560,4457,6017
52,52233,2016-12-31,1583,4368,5951
52,52233,2017-12-31,1593,4342,5935
52,52233,2018-12-31,1608,4340,5948
52,52233,2019-12-31,1621,4222,5843
52,52233,2020-12-31,1629,4139,5768
52,52233,2021-12-31,1628,4139,5767
52,52233,2022-12-31,1633,4140,5773
52,52233,2023-12-31,1638,4142,5780
52,52233,2024-12-31,1641,4139,5780
52,52233,2025-12-31,1638,4151,5789
52,52233,2026-12-31,1657,4153,5810
52,52233,2027-12-31,1660,4154,5814
52,52233,2028-12-31,1655,4169,5824
52,52233,2029-12-31,1660,4175,5835
52,52233,2030-12-31,1677,4190,5867
52,52233,2031-12-31,1676,4188,5864
52,52233,2032-12-31,1690,4200,5890
52,52233,2033-12-31,1693,4217,5910
52,52233,2034-12-31,1701,4223,5924
52,52233,2035-12-31,1709,4232,5941
52,52240,1985-12-31,0,0,0
52,52240,1986-12-31,0,0,0
52,52240,1987-12-31,0,0,0
52,52240,1988-12-31,0,0,0
52,52240,1989-12-31,0,0,0
52,52240,1990-12-31,0,0,0
52,52240,1991-12-31,0,0,0
52,52240,1992-12-31,0,0,0
52,52240,1993-12-31,3429,8323,11752
52,52240,1994-12-31,3510,8377,11887
52,52240,1995-12-31,3556,8496,12052
52,52240,1996-12-31,3608,8569,12177
52,52240,1997-12-31,3652,8669,12321
52,52240,1998-12-31,3700,8769,12469
52,52240,1999-12-31,3749,8883,12632
52,52240,2000-12-31,3807,8978,12785
52,52240,2001-12-31,3864,9086,12950
52,52240,2002-12-31,3902,9238,13140
52,52240,2003-12-31,3941,9419,13360
52,52240,2004-12-31,3988,9522,13510
52,52240,2005-12-31,4033,9658,13691
52,52240,2006-12-31,4067,9790,13857
52,52240,2007-12-31,4106,9923,14029
52,52240,2008-12-31,4114,10039,14153
52,52240,2009-12-31,4146,10148,14294
52,52240,2010-12-31,4187,10252,14439
52,52240,2011-12-31,4202,10361,14563
52,52240,2012-12-31,4221,10462,14683
52,52240,2013-12-31,4242,10581,14823
52,52240,2014-12-31,4279,10642,14921
52,52240,2015-12-31,4310,10750,15060
52,52240,2016-12-31,4330,10830,15160
52,52240,2017-12-31,4308,10898,15206
52,52240,2018-12-31,4332,11022,15354
52,52240,2019-12-31,4368,10960,15328
52,52240,2020-12-31,4415,10888,15303
52,52240,2021-12-31,4412,10887,15299
52,52240,2022-12-31,4425,10891,15316
52,52240,2023-12-31,4439,10895,15334
52,52240,2024-12-31,4451,10904,15355
52,52240,2025-12-31,4465,10907,15372
52,52240,2026-12-31,4479,10933,15412
52,52240,2027-12-31,4502,10956,15458
52,52240,2028-12-31,4504,10971,15475
52,52240,2029-12-31,4518,10975,15493
52,52240,2030-12-31,4555,11016,15571
52,52240,2031-12-31,4565,11063,15628
52,52240,2032-12-31,4566,11069,15635
52,52240,2033-12-31,4587,11092,15679
52,52240,2034-12-31,4609,11124,15733
52,52240,2035-12-31,4608,11142,15750
52,52250,1985-12-31,3097,20146,23243
52,52250,1986-12-31,3235,21764,24999
52,52250,1987-12-31,3403,23339,26742
52,52250,1988-12-31,3564,24852,28416
52,52250,1989-12-31,3708,18792,22500
52,52250,1990-12-31,3825,18827,22652
52,52250,1991-12-31,3931,18793,22724
52,52250,1992-12-31,4099,18672,22771
52,52250,1993-12-31,4183,18896,23079
52,52250,1994-12-31,4353,18651,23004
52,52250,1995-12-31,4508,18449,22957
52,52250,1996-12-31,4652,18262,22914
52,52250,1997-12-31,4805,18070,22875
52,52250,1998-12-31,4957,17896,22853
52,52250,1999-12-31,5092,17754,22846
52,52250,2000-12-31,5221,17567,22788
52,52250,2001-12-31,5407,17405,22812
52,52250,2002-12-31,5534,17308,22842
52,52250,2003-12-31,5679,17221,22900
52,52250,2004-12-31,5805,17128,22933
52,52250,2005-12-31,5918,17022,22940
52,52250,2006-12-31,6046,16950,22996
52,52250,2007-12-31,6173,16860,23033
52,52250,2008-12-31,6296,16748,23044
52,52250,2009-12-31,6386,16624,23010
52,52250,2010-12-31,6491,16485,22976
52,52250,2011-12-31,6598,16343,22941
52,52250,2012-12-31,6691,16208,22899
52,52250,2013-12-31,6807,16053,22860
52,52250,2014-12-31,6885,15900,22785
52,52250,2015-12-31,6996,15745,22741
52,52250,2016-12-31,7068,15560,22628
52,52250,2017-12-31,7168,15401,22569
52,52250,2018-12-31,7234,15271,22505
52,52250,2019-12-31,7306,15222,22528
52,52250,2020-12-31,7354,15196,22550
52,52250,2021-12-31,7354,15195,22549
52,52250,2022-12-31,7373,15201,22574
52,52250,2023-12-31,7395,15206,22601
52,52250,2024-12-31,7428,15223,22651
52,52250,2025-12-31,7452,15244,22696
52,52250,2026-12-31,7487,15290,22777
52,52250,2027-12-31,7511,15317,22828
52,52250,2028-12-31,7542,15363,22905
52,52250,2029-12-31,7571,15430,23001
52,52250,2030-12-31,7604,15480,23084
52,52250,2031-12-31,7638,15525,23163
52,52250,2032-12-31,7661,15588,23249
52,52250,2033-12-31,7687,15653,23340
52,52250,2034-12-31,7714,15699,23413
52,52250,2035-12-31,7746,15738,23484
52,52254,1985-12-31,0,0,0
52,52254,1986-12-31,0,0,0
52,52254,1987-12-31,0,0,0
52,52254,1988-12-31,0,0,0
52,52254,1989-12-31,0,0,0
52,52254,1990-12-31,0,0,0
52,52254,1991-12-31,0,0,0
52,52254,1992-12-31,0,0,0
52,52254,1993-12-31,0,0,0
52,52254,1994-12-31,0,0,0
52,52254,1995-12-31,0,0,0
52,52254,1996-12-31,0,0,0
52,52254,1997-12-31,0,0,0
52,52254,1998-12-31,0,0,0
52,52254,1999-12-31,964,8826,9790
52,52254,2000-12-31,956,8687,9643
52,52254,2001-12-31,995,8517,9512
52,52254,2002-12-31,1085,8391,9476
52,52254,2003-12-31,1080,8249,9329
52,52254,2004-12-31,1101,8126,9227
52,52254,2005-12-31,1114,7996,9110
52,52254,2006-12-31,1147,7875,9022
52,52254,2007-12-31,1148,7725,8873
52,52254,2008-12-31,1152,7586,8738
52,52254,2009-12-31,1184,7467,8651
52,52254,2010-12-31,1202,7312,8514
52,52254,2011-12-31,1218,7161,8379
52,52254,2012-12-31,1227,6990,8217
52,52254,2013-12-31,1246,6856,8102
52,52254,2014-12-31,1270,6715,7985
52,52254,2015-12-31,1289,6548,7837
52,52254,2016-12-31,1306,6339,7645
52,52254,2017-12-31,1318,6230,7548
52,52254,2018-12-31,1340,6106,7446
52,52254,2019-12-31,1349,6094,7443
52,52254,2020-12-31,1363,6079,7442
52,52254,2021-12-31,1364,6078,7442
52,52254,2022-12-31,1369,6081,7450
52,52254,2023-12-31,1376,6083,7459
52,52254,2024-12-31,1386,6069,7455
52,52254,2025-12-31,1389,6078,7467
52,52254,2026-12-31,1393,6088,7481
52,52254,2027-12-31,1400,6105,7505
52,52254,2028-12-31,1405,6092,7497
52,52254,2029-12-31,1407,6107,7514
52,52254,2030-12-31,1401,6131,7532
52,52254,2031-12-31,1409,6151,7560
52,52254,2032-12-31,1414,6166,7580
52,52254,2033-12-31,1422,6162,7584
52,52254,2034-12-31,1429,6180,7609
52,52254,2035-12-31,1430,6210,7640
52,52256,1985-12-31,1477,6825,8302
52,52256,1986-12-31,1510,6860,8370
52,52256,1987-12-31,1530,6885,8415
52,52256,1988-12-31,1536,6940,8476
52,52256,1989-12-31,1569,7011,8580
52,52256,1990-12-31,1539,7210,8749
52,52256,1991-12-31,1535,7369,8904
52,52256,1992-12-31,1573,7493,9066
52,52256,1993-12-31,1550,7793,9343
52,52256,1994-12-31,1581,7865,9446
52,52256,1995-12-31,1593,7947,9540
52,52256,1996-12-31,1608,8058,9666
52,52256,1997-12-31,1632,8148,9780
52,52256,1998-12-31,1631,8253,9884
52,52256,1999-12-31,1648,8363,10011
52,52256,2000-12-31,1651,8471,10122
52,52256,2001-12-31,1706,8568,10274
52,52256,2002-12-31,1656,8708,10364
52,52256,2003-12-31,1682,8846,10528
52,52256,2004-12-31,1694,8980,10674
52,52256,2005-12-31,1716,9114,10830
52,52256,2006-12-31,1722,9262,10984
52,52256,2007-12-31,1734,9385,11119
52,52256,2008-12-31,1752,9491,11243
52,52256,2009-12-31,1744,9623,11367
52,52256,2010-12-31,1736,9731,11467
52,52256,2011-12-31,1750,9866,11616
52,52256,2012-12-31,1763,9961,11724
52,52256,2013-12-31,1739,10052,11791
52,52256,2014-12-31,1734,10132,11866
52,52256,2015-12-31,1751,10229,11980
52,52256,2016-12-31,1736,10335,12071
52,52256,2017-12-31,1799,10410,12209
52,52256,2018-12-31,1781,10499,12280
52,52256,2019-12-31,1778,10391,12169
52,52256,2020-12-31,1775,10287,12062
52,52256,2021-12-31,1773,10286,12059
52,52256,2022-12-31,1782,10290,12072
52,52256,2023-12-31,1793,10294,12087
52,52256,2024-12-31,1800,10297,12097
52,52256,2025-12-31,1806,10315,12121
52,52256,2026-12-31,1813,10310,12123
52,52256,2027-12-31,1811,10335,12146
52,52256,2028-12-31,1826,10359,12185
52,52256,2029-12-31,1830,10382,12212
52,52256,2030-12-31,1831,10392,12223
52,52256,2031-12-31,1838,10419,12257
52,52256,2032-12-31,1853,10444,12297
52,52256,2033-12-31,1859,10465,12324
52,52256,2034-12-31,1858,10489,12347
52,52256,2035-12-31,1869,10492,12361
52,52258,1985-12-31,1227,9317,10544
52,52258,1986-12-31,1260,9319,10579
52,52258,1987-12-31,1284,9323,10607
52,52258,1988-12-31,1280,9330,10610
52,52258,1989-12-31,1286,9400,10686
52,52258,1990-12-31,1322,9606,10928
52,52258,1991-12-31,1306,9784,11090
52,52258,1992-12-31,1326,9902,11228
52,52258,1993-12-31,1347,10243,11590
52,52258,1994-12-31,1312,10305,11617
52,52258,1995-12-31,1337,10378,11715
52,52258,1996-12-31,1384,10462,11846
52,52258,1997-12-31,1398,10569,11967
52,52258,1998-12-31,1395,10645,12040
52,52258,1999-12-31,1424,10744,12168
52,52258,2000-12-31,1436,10827,12263
52,52258,2001-12-31,1466,10932,12398
52,52258,2002-12-31,1469,11073,12542
52,52258,2003-12-31,1480,11215,12695
52,52258,2004-12-31,1477,11355,12832
52,52258,2005-12-31,1507,11477,12984
52,52258,2006-12-31,1538,11620,13158
52,52258,2007-12-31,1549,11750,13299
52,52258,2008-12-31,1525,11865,13390
52,52258,2009-12-31,1538,11967,13505
52,52258,2010-12-31,1557,12064,13621
52,52258,2011-12-31,1566,12172,13738
52,52258,2012-12-31,1496,12271,13767
52,52258,2013-12-31,1474,12363,13837
52,52258,2014-12-31,1500,12426,13926
52,52258,2015-12-31,1528,12505,14033
52,52258,2016-12-31,1542,12612,14154
52,52258,2017-12-31,1563,12693,14256
52,52258,2018-12-31,1583,12759,14342
52,52258,2019-12-31,1575,12721,14296
52,52258,2020-12-31,1567,12694,14261
52,52258,2021-12-31,1565,12693,14258
52,52258,2022-12-31,1575,12698,14273
52,52258,2023-12-31,1588,12702,14290
52,52258,2024-12-31,1591,12710,14301
52,52258,2025-12-31,1596,12723,14319
52,52258,2026-12-31,1600,12738,14338
52,52258,2027-12-31,1606,12758,14364
52,52258,2028-12-31,1614,12774,14388
52,52258,2029-12-31,1622,12792,14414
52,52258,2030-12-31,1623,12827,14450
52,52258,2031-12-31,1632,12871,14503
52,52258,2032-12-31,1636,12914,14550
52,52258,2033-12-31,1638,12920,14558
52,52258,2034-12-31,1643,12951,14594
52,52258,2035-12-31,1654,12990,14644
52,52260,1985-12-31,4840,21542,26382
52,52260,1986-12-31,4847,21541,26388
52,52260,1987-12-31,4915,21552,26467
52,52260,1988-12-31,4968,21556,26524
52,52260,1989-12-31,5003,21685,26688
52,52260,1990-12-31,4981,22137,27118
52,52260,1991-12-31,4979,22518,27497
52,52260,1992-12-31,5016,22799,27815
52,52260,1993-12-31,4983,23585,28568
52,52260,1994-12-31,5024,23699,28723
52,52260,1995-12-31,5053,23875,28928
52,52260,1996-12-31,5100,24038,29138
52,52260,1997-12-31,5122,24228,29350
52,52260,1998-12-31,5155,24418,29573
52,52260,1999-12-31,5171,14203,19374
52,52260,2000-12-31,5199,13895,19094
52,52260,2001-12-31,5240,13598,18838
52,52260,2002-12-31,5259,13373,18632
52,52260,2003-12-31,5275,13149,18424
52,52260,2004-12-31,5285,12871,18156
52,52260,2005-12-31,5330,12610,17940
52,52260,2006-12-31,5303,12366,17669
52,52260,2007-12-31,5291,12103,17394
52,52260,2008-12-31,5318,11847,17165
52,52260,2009-12-31,5326,11561,16887
52,52260,2010-12-31,5337,11272,16609
52,52260,2011-12-31,5330,10986,16316
52,52260,2012-12-31,5326,10712,16038
52,52260,2013-12-31,5305,10430,15735
52,52260,2014-12-31,5307,10136,15443
52,52260,2015-12-31,5323,9887,15210
52,52260,2016-12-31,5314,9612,14926
52,52260,2017-12-31,5221,9267,14488
52,52260,2018-12-31,5251,9032,14283
52,52260,2019-12-31,5206,8780,13986
52,52260,2020-12-31,5166,8643,13809
52,52260,2021-12-31,5164,8642,13806
52,52260,2022-12-31,5175,8646,13821
52,52260,2023-12-31,5188,8649,13837
52,52260,2024-12-31,5201,8642,13843
52,52260,2025-12-31,5226,8650,13876
52,52260,2026-12-31,5240,8662,13902
52,52260,2027-12-31,5263,8682,13945
52,52260,2028-12-31,5268,8686,13954
52,52260,2029-12-31,5293,8715,14008
52,52260,2030-12-31,5312,8738,14050
52,52260,2031-12-31,5321,8743,14064
52,52260,2032-12-31,5346,8771,14117
52,52260,2033-12-31,5362,8792,14154
52,52260,2034-12-31,5378,8791,14169
52,52260,2035-12-31,5398,8812,14210
52,52287,1985-12-31,2101,5397,7498
52,52287,1986-12-31,2090,5275,7365
52,52287,1987-12-31,2128,5192,7320
52,52287,1988-12-31,2185,5095,7280
52,52287,1989-12-31,2217,5010,7227
52,52287,1990-12-31,2253,5027,7280
52,52287,1991-12-31,2290,5021,7311
52,52287,1992-12-31,2325,4989,7314
52,52287,1993-12-31,2346,5079,7425
52,52287,1994-12-31,2395,5001,7396
52,52287,1995-12-31,2434,4949,7383
52,52287,1996-12-31,2470,4885,7355
52,52287,1997-12-31,2516,4861,7377
52,52287,1998-12-31,2553,4811,7364
52,52287,1999-12-31,2591,4778,7369
52,52287,2000-12-31,2646,4716,7362
52,52287,2001-12-31,2667,4680,7347
52,52287,2002-12-31,2728,4653,7381
52,52287,2003-12-31,2772,4627,7399
52,52287,2004-12-31,2786,4603,7389
52,52287,2005-12-31,2826,4595,7421
52,52287,2006-12-31,2843,4573,7416
52,52287,2007-12-31,2874,4543,7417
52,52287,2008-12-31,2908,4537,7445
52,52287,2009-12-31,2916,4467,7383
52,52287,2010-12-31,2913,4408,7321
52,52287,2011-12-31,2972,4365,7337
52,52287,2012-12-31,3019,4349,7368
52,52287,2013-12-31,3047,4329,7376
52,52287,2014-12-31,3071,4252,7323
52,52287,2015-12-31,3036,4155,7191
52,52287,2016-12-31,3036,4130,7166
52,52287,2017-12-31,3054,4125,7179
52,52287,2018-12-31,3091,4131,7222
52,52287,2019-12-31,3086,4082,7168
52,52287,2020-12-31,3081,4054,7135
52,52287,2021-12-31,3079,4054,7133
52,52287,2022-12-31,3086,4055,7141
52,52287,2023-12-31,3093,4057,7150
52,52287,2024-12-31,3108,4057,7165
52,52287,2025-12-31,3111,4061,7172
52,52287,2026-12-31,3119,4056,7175
52,52287,2027-12-31,3133,4061,7194
52,52287,2028-12-31,3136,4078,7214
52,52287,2029-12-31,3148,4073,7221
52,52287,2030-12-31,3169,4088,7257
52,52287,2031-12-31,3176,4109,7285
52,52287,2032-12-31,3181,4120,7301
52,52287,2033-12-31,3193,4130,7323
52,52287,2034-12-31,3202,4144,7346
52,52287,2035-12-31,3204,4126,7330
52,52317,1985-12-31,3863,8622,12485
52,52317,1986-12-31,3850,8779,12629
52,52317,1987-12-31,3835,8930,12765
52,52317,1988-12-31,3848,9077,12925
52,52317,1989-12-31,3833,9284,13117
52,52317,1990-12-31,3807,9628,13435
52,52317,1991-12-31,3762,9931,13693
52,52317,1992-12-31,3738,10194,13932
52,52317,1993-12-31,3687,10686,14373
52,52317,1994-12-31,3688,10890,14578
52,52317,1995-12-31,3695,11088,14783
52,52317,1996-12-31,3664,11310,14974
52,52317,1997-12-31,3654,11524,15178
52,52317,1998-12-31,3664,11756,15420
52,52317,1999-12-31,3619,11986,15605
52,52317,2000-12-31,3599,12199,15798
52,52317,2001-12-31,3594,12430,16024
52,52317,2002-12-31,3571,12704,16275
52,52317,2003-12-31,3545,12991,16536
52,52317,2004-12-31,3517,13260,16777
52,52317,2005-12-31,3499,13521,17020
52,52317,2006-12-31,3476,13780,17256
52,52317,2007-12-31,3450,14055,17505
52,52317,2008-12-31,3410,14283,17693
52,52317,2009-12-31,3369,14509,17878
52,52317,2010-12-31,3329,14736,18065
52,52317,2011-12-31,3299,14964,18263
52,52317,2012-12-31,3287,15184,18471
52,52317,2013-12-31,3273,15390,18663
52,52317,2014-12-31,3256,15595,18851
52,52317,2015-12-31,3188,15796,18984
52,52317,2016-12-31,3074,16008,19082
52,52317,2017-12-31,3058,16239,19297
52,52317,2018-12-31,3071,16379,19450
52,52317,2019-12-31,3012,16375,19387
52,52317,2020-12-31,2965,16374,19339
52,52317,2021-12-31,2961,16373,19334
52,52317,2022-12-31,2977,16379,19356
52,52317,2023-12-31,2994,16385,19379
52,52317,2024-12-31,3009,16397,19406
52,52317,2025-12-31,3012,16411,19423
52,52317,2026-12-31,3024,16439,19463
52,52317,2027-12-31,3042,16457,19499
52,52317,2028-12-31,3043,16488,19531
52,52317,2029-12-31,3057,16539,19596
52,52317,2030-12-31,3065,16569,19634
52,52317,2031-12-31,3083,16594,19677
52,52317,2032-12-31,3091,16640,19731
52,52317,2033-12-31,3103,16675,19778
52,52317,2034-12-31,3107,16723,19830
52,52317,2035-12-31,3129,16738,19867
52,52320,1985-12-31,4074,10773,14847
52,52320,1986-12-31,4128,10522,14650
52,52320,1987-12-31,4141,10284,14425
52,52320,1988-12-31,4201,10055,14256
52,52320,1989-12-31,4214,9895,14109
52,52320,1990-12-31,4210,9898,14108
52,52320,1991-12-31,4185,9853,14038
52,52320,1992-12-31,4215,9759,13974
52,52320,1993-12-31,4192,9862,14054
52,52320,1994-12-31,4224,9708,13932
52,52320,1995-12-31,4232,9574,13806
52,52320,1996-12-31,4261,9425,13686
52,52320,1997-12-31,4296,9312,13608
52,52320,1998-12-31,4304,9181,13485
52,52320,1999-12-31,4327,9069,13396
52,52320,2000-12-31,4347,8938,13285
52,52320,2001-12-31,4372,8851,13223
52,52320,2002-12-31,4408,8770,13178
52,52320,2003-12-31,4418,8694,13112
52,52320,2004-12-31,4433,8614,13047
52,52320,2005-12-31,4429,8529,12958
52,52320,2006-12-31,4436,8458,12894
52,52320,2007-12-31,4435,8360,12795
52,52320,2008-12-31,4448,8256,12704
52,52320,2009-12-31,4456,8174,12630
52,52320,2010-12-31,4450,8080,12530
52,52320,2011-12-31,4441,7977,12418
52,52320,2012-12-31,4397,7865,12262
52,52320,2013-12-31,4426,7716,12142
52,52320,2014-12-31,4464,7602,12066
52,52320,2015-12-31,4444,7544,11988
52,52320,2016-12-31,4384,7332,11716
52,52320,2017-12-31,4333,7240,11573
52,52320,2018-12-31,4378,7204,11582
52,52320,2019-12-31,4350,7072,11422
52,52320,2020-12-31,4322,7003,11325
52,52320,2021-12-31,4320,7002,11322
52,52320,2022-12-31,4330,7005,11335
52,52320,2023-12-31,4340,7008,11348
52,52320,2024-12-31,4350,7018,11368
52,52320,2025-12-31,4367,7019,11386
52,52320,2026-12-31,4369,7022,11391
52,52320,2027-12-31,4389,7034,11423
52,52320,2028-12-31,4399,7045,11444
52,52320,2029-12-31,4419,7042,11461
52,52320,2030-12-31,4436,7068,11504
52,52320,2031-12-31,4442,7091,11533
52,52320,2032-12-31,4480,7098,11578
52,52320,2033-12-31,4477,7131,11608
52,52320,2034-12-31,4492,7128,11620
52,52320,2035-12-31,4514,7157,11671
52,52323,1985-12-31,2000,3634,5634
52,52323,1986-12-31,2045,3570,5615
52,52323,1987-12-31,2079,3543,5622
52,52323,1988-12-31,2121,3534,5655
52,52323,1989-12-31,2181,3534,5715
52,52323,1990-12-31,2190,3581,5771
52,52323,1991-12-31,2194,3613,5807
52,52323,1992-12-31,2227,3626,5853
52,52323,1993-12-31,2281,3739,6020
52,52323,1994-12-31,2319,3709,6028
52,52323,1995-12-31,2362,3732,6094
52,52323,1996-12-31,2393,3726,6119
52,52323,1997-12-31,2440,3752,6192
52,52323,1998-12-31,2489,3755,6244
52,52323,1999-12-31,2531,3770,6301
52,52323,2000-12-31,2554,3781,6335
52,52323,2001-12-31,2587,3810,6397
52,52323,2002-12-31,2641,3818,6459
52,52323,2003-12-31,2666,3819,6485
52,52323,2004-12-31,2693,3841,6534
52,52323,2005-12-31,2697,3911,6608
52,52323,2006-12-31,2759,3958,6717
52,52323,2007-12-31,2776,3981,6757
52,52323,2008-12-31,2787,4013,6800
52,52323,2009-12-31,2822,4034,6856
52,52323,2010-12-31,2858,4055,6913
52,52323,2011-12-31,2844,4057,6901
52,52323,2012-12-31,2897,4055,6952
52,52323,2013-12-31,2925,4043,6968
52,52323,2014-12-31,2950,4003,6953
52,52323,2015-12-31,2944,4008,6952
52,52323,2016-12-31,2931,4024,6955
52,52323,2017-12-31,2954,4038,6992
52,52323,2018-12-31,2994,4063,7057
52,52323,2019-12-31,2989,4060,7049
52,52323,2020-12-31,2984,4056,7040
52,52323,2021-12-31,2982,4056,7038
52,52323,2022-12-31,2989,4057,7046
52,52323,2023-12-31,2995,4059,7054
52,52323,2024-12-31,2998,4067,7065
52,52323,2025-12-31,3008,4065,7073
52,52323,2026-12-31,3023,4062,7085
52,52323,2027-12-31,3035,4056,7091
52,52323,2028-12-31,3043,4074,7117
52,52323,2029-12-31,3056,4094,7150
52,52323,2030-12-31,3059,4105,7164
52,52323,2031-12-31,3065,4115,7180
52,52323,2032-12-31,3077,4121,7198
52,52323,2033-12-31,3104,4122,7226
52,52323,2034-12-31,3104,4156,7260
52,52323,2035-12-31,3106,4153,7259
52,52352,1985-12-31,1502,6031,7533
52,52352,1986-12-31,1553,5926,7479
52,52352,1987-12-31,1609,5835,7444
52,52352,1988-12-31,1598,5762,7360
52,52352,1989-12-31,1588,5717,7305
52,52352,1990-12-31,1627,5750,7377
52,52352,1991-12-31,1645,5787,7432
52,52352,1992-12-31,1664,5771,7435
52,52352,1993-12-31,1692,5885,7577
52,52352,1994-12-31,1719,5854,7573
52,52352,1995-12-31,1739,5806,7545
52,52352,1996-12-31,1767,5806,7573
52,52352,1997-12-31,1784,5769,7553
52,52352,1998-12-31,1823,5742,7565
52,52352,1999-12-31,1844,5737,7581
52,52352,2000-12-31,1869,5717,7586
52,52352,2001-12-31,1904,5709,7613
52,52352,2002-12-31,1930,5709,7639
52,52352,2003-12-31,1941,5709,7650
52,52352,2004-12-31,1945,5725,7670
52,52352,2005-12-31,1970,5720,7690
52,52352,2006-12-31,1995,5726,7721
52,52352,2007-12-31,2000,5724,7724
52,52352,2008-12-31,2001,5698,7699
52,52352,2009-12-31,1998,5683,7681
52,52352,2010-12-31,2042,5688,7730
52,52352,2011-12-31,2062,5640,7702
52,52352,2012-12-31,2088,5647,7735
52,52352,2013-12-31,2103,5612,7715
52,52352,2014-12-31,2085,5630,7715
52,52352,2015-12-31,2077,5617,7694
52,52352,2016-12-31,2100,5532,7632
52,52352,2017-12-31,2111,5520,7631
52,52352,2018-12-31,2133,5529,7662
52,52352,2019-12-31,2129,5517,7646
52,52352,2020-12-31,2126,5506,7632
52,52352,2021-12-31,2124,5506,7630
52,52352,2022-12-31,2131,5508,7639
52,52352,2023-12-31,2138,5510,7648
52,52352,2024-12-31,2140,5507,7647
52,52352,2025-12-31,2151,5516,7667
52,52352,2026-12-31,2161,5522,7683
52,52352,2027-12-31,2173,5545,7718
52,52352,2028-12-31,2173,5536,7709
52,52352,2029-12-31,2181,5548,7729
52,52352,2030-12-31,2194,5565,7759
52,52352,2031-12-31,2195,5585,7780
52,52352,2032-12-31,2203,5600,7803
52,52352,2033-12-31,2215,5616,7831
52,52352,2034-12-31,2214,5612,7826
52,52352,2035-12-31,2219,5627,7846
52,52354,1985-12-31,656,7692,8348
52,52354,1986-12-31,675,7575,8250
52,52354,1987-12-31,676,7436,8112
52,52354,1988-12-31,717,7331,8048
52,52354,1989-12-31,729,7274,8003
52,52354,1990-12-31,720,7292,8012
52,52354,1991-12-31,732,7316,8048
52,52354,1992-12-31,753,7297,8050
52,52354,1993-12-31,765,7439,8204
52,52354,1994-12-31,819,7375,8194
52,52354,1995-12-31,761,7325,8086
52,52354,1996-12-31,758,7271,8029
52,52354,1997-12-31,784,7223,8007
52,52354,1998-12-31,828,7167,7995
52,52354,1999-12-31,843,7143,7986
52,52354,2000-12-31,834,7091,7925
52,52354,2001-12-31,875,7081,7956
52,52354,2002-12-31,880,7075,7955
52,52354,2003-12-31,871,7064,7935
52,52354,2004-12-31,872,7051,7923
52,52354,2005-12-31,906,7045,7951
52,52354,2006-12-31,904,7037,7941
52,52354,2007-12-31,943,7020,7963
52,52354,2008-12-31,932,6994,7926
52,52354,2009-12-31,861,6954,7815
52,52354,2010-12-31,891,6975,7866
52,52354,2011-12-31,911,6909,7820
52,52354,2012-12-31,934,6841,7775
52,52354,2013-12-31,945,6785,7730
52,52354,2014-12-31,957,6758,7715
52,52354,2015-12-31,973,6694,7667
52,52354,2016-12-31,988,6624,7612
52,52354,2017-12-31,1007,6624,7631
52,52354,2018-12-31,1016,6641,7657
52,52354,2019-12-31,1011,6519,7530
52,52354,2020-12-31,1006,6440,7446
52,52354,2021-12-31,1005,6439,7444
52,52354,2022-12-31,1010,6442,7452
52,52354,2023-12-31,1017,6444,7461
52,52354,2024-12-31,1014,6435,7449
52,52354,2025-12-31,1017,6442,7459
52,52354,2026-12-31,1014,6452,7466
52,52354,2027-12-31,1030,6455,7485
52,52354,2028-12-31,1028,6468,7496
52,52354,2029-12-31,1028,6484,7512
52,52354,2030-12-31,1038,6491,7529
52,52354,2031-12-31,1039,6503,7542
52,52354,2032-12-31,1046,6517,7563
52,52354,2033-12-31,1049,6533,7582
52,52354,2034-12-31,1051,6550,7601
52,52354,2035-12-31,1052,6557,7609
52,52356,1985-12-31,53077,24837,77914
52,52356,1986-12-31,54280,24996,79276
52,52356,1987-12-31,55453,25173,80626
52,52356,1988-12-31,56626,25343,81969
52,52356,1989-12-31,57649,25657,83306
52,52356,1990-12-31,58020,26361,84381
52,52356,1991-12-31,58602,26973,85575
52,52356,1992-12-31,59653,27459,87112
52,52356,1993-12-31,59847,28576,88423
52,52356,1994-12-31,61068,28852,89920
52,52356,1995-12-31,62146,29223,91369
52,52356,1996-12-31,63192,29581,92773
52,52356,1997-12-31,64155,29948,94103
52,52356,1998-12-31,65120,30340,95460
52,52356,1999-12-31,65940,30772,96712
52,52356,2000-12-31,66838,31144,97982
52,52356,2001-12-31,68044,31551,99595
52,52356,2002-12-31,68830,32080,100910
52,52356,2003-12-31,69598,32598,102196
52,52356,2004-12-31,70347,33118,103465
52,52356,2005-12-31,71057,33629,104686
52,52356,2006-12-31,71795,34133,105928
52,52356,2007-12-31,72486,34613,107099
52,52356,2008-12-31,73075,35072,108147
52,52356,2009-12-31,73606,35505,109111
52,52356,2010-12-31,74100,35904,110004
52,52356,2011-12-31,74578,36312,110890
52,52356,2012-12-31,75037,36700,111737
52,52356,2013-12-31,75429,37056,112485
52,52356,2014-12-31,75789,37397,113186
52,52356,2015-12-31,76162,37772,113934
52,52356,2016-12-31,76552,38142,114694
52,52356,2017-12-31,76910,38438,115348
52,52356,2018-12-31,77343,38793,116136
52,52356,2019-12-31,77188,38804,115992
52,52356,2020-12-31,77042,38794,115836
52,52356,2021-12-31,77014,38796,115810
52,52356,2022-12-31,77123,38813,115936
52,52356,2023-12-31,77245,38829,116074
52,52356,2024-12-31,77433,38877,116310
52,52356,2025-12-31,77636,38915,116551
52,52356,2026-12-31,77879,38981,116860
52,52356,2027-12-31,78121,39052,117173
52,52356,2028-12-31,78387,39142,117529
52,52356,2029-12-31,78659,39226,117885
52,52356,2030-12-31,78972,39342,118314
52,52356,2031-12-31,79265,39466,118731
52,52356,2032-12-31,79530,39567,119097
52,52356,2033-12-31,79804,39676,119480
52,52356,2034-12-31,80042,39788,119830
52,52356,2035-12-31,80273,39865,120138
52,52378,1985-12-31,6143,13818,19961
52,52378,1986-12-31,6228,13562,19790
52,52378,1987-12-31,6332,13298,19630
52,52378,1988-12-31,6441,13060,19501
52,52378,1989-12-31,6541,12907,19448
52,52378,1990-12-31,6534,12944,19478
52,52378,1991-12-31,6573,12924,19497
52,52378,1992-12-31,6663,12865,19528
52,52378,1993-12-31,6658,13058,19716
52,52378,1994-12-31,6770,12889,19659
52,52378,1995-12-31,6862,12759,19621
52,52378,1996-12-31,6949,12637,19586
52,52378,1997-12-31,7047,12528,19575
52,52378,1998-12-31,7111,12406,19517
52,52378,1999-12-31,7181,12313,19494
52,52378,2000-12-31,7248,12206,19454
52,52378,2001-12-31,7374,12107,19481
52,52378,2002-12-31,7425,12054,19479
52,52378,2003-12-31,7488,12019,19507
52,52378,2004-12-31,7537,11960,19497
52,52378,2005-12-31,7600,11909,19509
52,52378,2006-12-31,7667,11835,19502
52,52378,2007-12-31,7705,11770,19475
52,52378,2008-12-31,7757,11716,19473
52,52378,2009-12-31,7805,11558,19363
52,52378,2010-12-31,7839,11514,19353
52,52378,2011-12-31,7853,11420,19273
52,52378,2012-12-31,7913,11307,19220
52,52378,2013-12-31,7880,11234,19114
52,52378,2014-12-31,7918,11102,19020
52,52378,2015-12-31,7936,11018,18954
52,52378,2016-12-31,8013,10964,18977
52,52378,2017-12-31,8002,10779,18781
52,52378,2018-12-31,8018,10736,18754
52,52378,2019-12-31,8005,10692,18697
52,52378,2020-12-31,7992,10651,18643
52,52378,2021-12-31,7989,10650,18639
52,52378,2022-12-31,8005,10654,18659
52,52378,2023-12-31,8023,10658,18681
52,52378,2024-12-31,8044,10667,18711
52,52378,2025-12-31,8060,10665,18725
52,52378,2026-12-31,8093,10678,18771
52,52378,2027-12-31,8111,10687,18798
52,52378,2028-12-31,8151,10697,18848
52,52378,2029-12-31,8178,10740,18918
52,52378,2030-12-31,8200,10756,18956
52,52378,2031-12-31,8233,10799,19032
52,52378,2032-12-31,8267,10829,19096
52,52378,2033-12-31,8296,10852,19148
52,52378,2034-12-31,8326,10862,19188
52,52378,2035-12-31,8336,10873,19209
52,52381,1985-12-31,1357,9867,11224
52,52381,1986-12-31,1381,9690,11071
52,52381,1987-12-31,1416,9527,10943
52,52381,1988-12-31,1474,9376,10850
52,52381,1989-12-31,1470,9272,10742
52,52381,1990-12-31,1437,9309,10746
52,52381,1991-12-31,1462,9325,10787
52,52381,1992-12-31,1454,9282,10736
52,52381,1993-12-31,1513,9442,10955
52,52381,1994-12-31,1543,9352,10895
52,52381,1995-12-31,1562,9257,10819
52,52381,1996-12-31,1553,9182,10735
52,52381,1997-12-31,1624,9119,10743
52,52381,1998-12-31,1660,9047,10707
52,52381,1999-12-31,1672,8997,10669
52,52381,2000-12-31,1695,8933,10628
52,52381,2001-12-31,1714,8878,10592
52,52381,2002-12-31,1742,8859,10601
52,52381,2003-12-31,1758,8842,10600
52,52381,2004-12-31,1771,8798,10569
52,52381,2005-12-31,1800,8789,10589
52,52381,2006-12-31,1822,8763,10585
52,52381,2007-12-31,1834,8724,10558
52,52381,2008-12-31,1864,8670,10534
52,52381,2009-12-31,1870,8636,10506
52,52381,2010-12-31,1887,8586,10473
52,52381,2011-12-31,1903,8534,10437
52,52381,2012-12-31,1931,8467,10398
52,52381,2013-12-31,1970,8449,10419
52,52381,2014-12-31,1938,8374,10312
52,52381,2015-12-31,1941,8314,10255
52,52381,2016-12-31,1950,8224,10174
52,52381,2017-12-31,1966,8121,10087
52,52381,2018-12-31,1980,8124,10104
52,52381,2019-12-31,1982,8003,9985
52,52381,2020-12-31,1982,7929,9911
52,52381,2021-12-31,1981,7928,9909
52,52381,2022-12-31,1989,7931,9920
52,52381,2023-12-31,1997,7934,9931
52,52381,2024-12-31,1999,7936,9935
52,52381,2025-12-31,2006,7929,9935
52,52381,2026-12-31,2020,7947,9967
52,52381,2027-12-31,2023,7957,9980
52,52381,2028-12-31,2028,7981,10009
52,52381,2029-12-31,2048,7995,10043
52,52381,2030-12-31,2049,8009,10058
52,52381,2031-12-31,2055,8032,10087
52,52381,2032-12-31,2074,8028,10102
52,52381,2033-12-31,2070,8052,10122
52,52381,2034-12-31,2066,8083,10149
52,52381,2035-12-31,2080,8098,10178
52,52385,1985-12-31,0,0,0
52,52385,1986-12-31,0,0,0
52,52385,1987-12-31,0,0,0
52,52385,1988-12-31,0,0,0
52,52385,1989-12-31,0,0,0
52,52385,1990-12-31,2111,5029,7140
52,52385,1991-12-31,2158,5003,7161
52,52385,1992-12-31,2223,4903,7126
52,52385,1993-12-31,2243,4987,7230
52,52385,1994-12-31,2280,4911,7191
52,52385,1995-12-31,2321,4805,7126
52,52385,1996-12-31,2382,4723,7105
52,52385,1997-12-31,2434,4651,7085
52,52385,1998-12-31,2462,4555,7017
52,52385,1999-12-31,2522,4508,7030
52,52385,2000-12-31,2552,4414,6966
52,52385,2001-12-31,2630,4348,6978
52,52385,2002-12-31,2660,4332,6992
52,52385,2003-12-31,2713,4220,6933
52,52385,2004-12-31,2739,4213,6952
52,52385,2005-12-31,2780,4149,6929
52,52385,2006-12-31,2824,4107,6931
52,52385,2007-12-31,2850,4021,6871
52,52385,2008-12-31,2878,3974,6852
52,52385,2009-12-31,2905,3893,6798
52,52385,2010-12-31,2928,3840,6768
52,52385,2011-12-31,2993,3805,6798
52,52385,2012-12-31,2965,3737,6702
52,52385,2013-12-31,3030,3674,6704
52,52385,2014-12-31,3088,3545,6633
52,52385,2015-12-31,3113,3486,6599
52,52385,2016-12-31,3113,3439,6552
52,52385,2017-12-31,3121,3396,6517
52,52385,2018-12-31,3156,3336,6492
52,52385,2019-12-31,3152,3329,6481
52,52385,2020-12-31,3148,3322,6470
52,52385,2021-12-31,3147,3322,6469
52,52385,2022-12-31,3153,3323,6476
52,52385,2023-12-31,3159,3324,6483
52,52385,2024-12-31,3168,3328,6496
52,52385,2025-12-31,3182,3329,6511
52,52385,2026-12-31,3188,3336,6524
52,52385,2027-12-31,3198,3346,6544
52,52385,2028-12-31,3212,3344,6556
52,52385,2029-12-31,3216,3353,6569
52,52385,2030-12-31,3232,3370,6602
52,52385,2031-12-31,3244,3383,6627
52,52385,2032-12-31,3249,3372,6621
52,52385,2033-12-31,3269,3393,6662
52,52385,2034-12-31,3290,3400,6690
52,52385,2035-12-31,3296,3407,6703
52,52390,1985-12-31,0,0,0
52,52390,1986-12-31,0,0,0
52,52390,1987-12-31,0,0,0
52,52390,1988-12-31,0,0,0
52,52390,1989-12-31,1199,6878,8077
52,52390,1990-12-31,1222,6868,8090
52,52390,1991-12-31,1301,6787,8088
52,52390,1992-12-31,1366,6711,8077
52,52390,1993-12-31,1444,6759,8203
52,52390,1994-12-31,1492,6622,8114
52,52390,1995-12-31,1569,6501,8070
52,52390,1996-12-31,1627,6402,8029
52,52390,1997-12-31,1730,6303,8033
52,52390,1998-12-31,1783,6192,7975
52,52390,1999-12-31,1845,6112,7957
52,52390,2000-12-31,1930,6008,7938
52,52390,2001-12-31,2002,5875,7877
52,52390,2002-12-31,2070,5813,7883
52,52390,2003-12-31,2137,5749,7886
52,52390,2004-12-31,2190,5669,7859
52,52390,2005-12-31,2257,5594,7851
52,52390,2006-12-31,2311,5513,7824
52,52390,2007-12-31,2371,5449,7820
52,52390,2008-12-31,2431,5363,7794
52,52390,2009-12-31,2485,5280,7765
52,52390,2010-12-31,2545,5205,7750
52,52390,2011-12-31,2594,5143,7737
52,52390,2012-12-31,2625,5037,7662
52,52390,2013-12-31,2675,4905,7580
52,52390,2014-12-31,2739,4827,7566
52,52390,2015-12-31,2793,4744,7537
52,52390,2016-12-31,2856,4652,7508
52,52390,2017-12-31,2875,4533,7408
52,52390,2018-12-31,2928,4483,7411
52,52390,2019-12-31,2915,4526,7441
52,52390,2020-12-31,2906,4554,7460
52,52390,2021-12-31,2905,4555,7460
52,52390,2022-12-31,2912,4556,7468
52,52390,2023-12-31,2919,4558,7477
52,52390,2024-12-31,2926,4566,7492
52,52390,2025-12-31,2935,4580,7515
52,52390,2026-12-31,2949,4578,7527
52,52390,2027-12-31,2957,4602,7559
52,52390,2028-12-31,2967,4618,7585
52,52390,2029-12-31,2975,4623,7598
52,52390,2030-12-31,2985,4636,7621
52,52390,2031-12-31,3003,4648,7651
52,52390,2032-12-31,3009,4680,7689
52,52390,2033-12-31,3020,4676,7696
52,52390,2034-12-31,3029,4709,7738
52,52390,2035-12-31,3035,4718,7753
52,52399,1985-12-31,8449,14273,22722
52,52399,1986-12-31,8650,14247,22897
52,52399,1987-12-31,8856,14255,23111
52,52399,1988-12-31,9053,14251,23304
52,52399,1989-12-31,9240,14326,23566
52,52399,1990-12-31,9320,14625,23945
52,52399,1991-12-31,9437,14874,24311
52,52399,1992-12-31,9612,15053,24665
52,52399,1993-12-31,9657,15582,25239
52,52399,1994-12-31,9879,15648,25527
52,52399,1995-12-31,10059,15755,25814
52,52399,1996-12-31,10227,15869,26096
52,52399,1997-12-31,10404,15984,26388
52,52399,1998-12-31,10587,16100,26687
52,52399,1999-12-31,10691,16248,26939
52,52399,2000-12-31,10862,16382,27244
52,52399,2001-12-31,11083,16515,27598
52,52399,2002-12-31,11225,16720,27945
52,52399,2003-12-31,11355,16922,28277
52,52399,2004-12-31,11480,17122,28602
52,52399,2005-12-31,11618,17297,28915
52,52399,2006-12-31,11763,17474,29237
52,52399,2007-12-31,11889,17656,29545
52,52399,2008-12-31,11983,17831,29814
52,52399,2009-12-31,12084,17984,30068
52,52399,2010-12-31,12182,18115,30297
52,52399,2011-12-31,12270,18251,30521
52,52399,2012-12-31,12354,18395,30749
52,52399,2013-12-31,12447,18502,30949
52,52399,2014-12-31,12510,18623,31133
52,52399,2015-12-31,12583,18758,31341
52,52399,2016-12-31,12634,18822,31456
52,52399,2017-12-31,12801,18984,31785
52,52399,2018-12-31,12793,19065,31858
52,52399,2019-12-31,12740,19063,31803
52,52399,2020-12-31,12688,19063,31751
52,52399,2021-12-31,12681,19063,31744
52,52399,2022-12-31,12708,19070,31778
52,52399,2023-12-31,12740,19076,31816
52,52399,2024-12-31,12772,19069,31841
52,52399,2025-12-31,12819,19094,31913
52,52399,2026-12-31,12852,19115,31967
52,52399,2027-12-31,12905,19147,32052
52,52399,2028-12-31,12945,19189,32134
52,52399,2029-12-31,13000,19221,32221
52,52399,2030-12-31,13048,19265,32313
52,52399,2031-12-31,13086,19313,32399
52,52399,2032-12-31,13122,19367,32489
52,52399,2033-12-31,13169,19422,32591
52,52399,2034-12-31,13222,19472,32694
52,52399,2035-12-31,13251,19509,32760
52,52405,1985-12-31,1734,8201,9935
52,52405,1986-12-31,1808,8066,9874
52,52405,1987-12-31,1833,7885,9718
52,52405,1988-12-31,1896,7764,9660
52,52405,1989-12-31,1960,7693,9653
52,52405,1990-12-31,1928,7723,9651
52,52405,1991-12-31,1979,7725,9704
52,52405,1992-12-31,2038,7669,9707
52,52405,1993-12-31,2070,7848,9918
52,52405,1994-12-31,2098,7762,9860
52,52405,1995-12-31,2170,7694,9864
52,52405,1996-12-31,2216,7636,9852
52,52405,1997-12-31,2256,7574,9830
52,52405,1998-12-31,2312,7525,9837
52,52405,1999-12-31,2349,7483,9832
52,52405,2000-12-31,2400,7423,9823
52,52405,2001-12-31,2439,7372,9811
52,52405,2002-12-31,2492,7350,9842
52,52405,2003-12-31,2527,7342,9869
52,52405,2004-12-31,2565,7311,9876
52,52405,2005-12-31,2602,7298,9900
52,52405,2006-12-31,2638,7293,9931
52,52405,2007-12-31,2682,7267,9949
52,52405,2008-12-31,2720,7218,9938
52,52405,2009-12-31,2738,7200,9938
52,52405,2010-12-31,2774,7157,9931
52,52405,2011-12-31,2804,7119,9923
52,52405,2012-12-31,2819,7067,9886
52,52405,2013-12-31,2860,7026,9886
52,52405,2014-12-31,2884,6969,9853
52,52405,2015-12-31,2901,6976,9877
52,52405,2016-12-31,2899,6897,9796
52,52405,2017-12-31,2962,6814,9776
52,52405,2018-12-31,2967,6801,9768
52,52405,2019-12-31,2978,6675,9653
52,52405,2020-12-31,2989,6582,9571
52,52405,2021-12-31,2988,6581,9569
52,52405,2022-12-31,2995,6584,9579
52,52405,2023-12-31,3005,6586,9591
52,52405,2024-12-31,3012,6594,9606
52,52405,2025-12-31,3024,6597,9621
52,52405,2026-12-31,3034,6615,9649
52,52405,2027-12-31,3040,6623,9663
52,52405,2028-12-31,3048,6632,9680
52,52405,2029-12-31,3068,6659,9727
52,52405,2030-12-31,3069,6672,9741
52,52405,2031-12-31,3094,6695,9789
52,52405,2032-12-31,3103,6693,9796
52,52405,2033-12-31,3100,6730,9830
52,52405,2034-12-31,3123,6724,9847
52,52405,2035-12-31,3128,6747,9875
52,52411,1985-12-31,1914,11938,13852
52,52411,1986-12-31,1946,11663,13609
52,52411,1987-12-31,1969,11404,13373
52,52411,1988-12-31,1978,11158,13136
52,52411,1989-12-31,2012,10973,12985
52,52411,1990-12-31,2013,10969,12982
52,52411,1991-12-31,2021,10916,12937
52,52411,1992-12-31,2050,10813,12863
52,52411,1993-12-31,2000,10953,12953
52,52411,1994-12-31,2032,10771,12803
52,52411,1995-12-31,2027,10621,12648
52,52411,1996-12-31,2093,10471,12564
52,52411,1997-12-31,2113,10329,12442
52,52411,1998-12-31,2123,10195,12318
52,52411,1999-12-31,2129,10077,12206
52,52411,2000-12-31,2127,9940,12067
52,52411,2001-12-31,2157,9824,11981
52,52411,2002-12-31,2165,9746,11911
52,52411,2003-12-31,2171,9648,11819
52,52411,2004-12-31,2174,9565,11739
52,52411,2005-12-31,2197,9479,11676
52,52411,2006-12-31,2198,9406,11604
52,52411,2007-12-31,2207,9298,11505
52,52411,2008-12-31,2213,9190,11403
52,52411,2009-12-31,2227,9069,11296
52,52411,2010-12-31,2255,8954,11209
52,52411,2011-12-31,2279,8836,11115
52,52411,2012-12-31,2294,8722,11016
52,52411,2013-12-31,2266,8602,10868
52,52411,2014-12-31,2227,8497,10724
52,52411,2015-12-31,2198,8351,10549
52,52411,2016-12-31,2209,8255,10464
52,52411,2017-12-31,2217,8088,10305
52,52411,2018-12-31,2230,8006,10236
52,52411,2019-12-31,2205,7893,10098
52,52411,2020-12-31,2188,7824,10012
52,52411,2021-12-31,2187,7823,10010
52,52411,2022-12-31,2195,7826,10021
52,52411,2023-12-31,2204,7829,10033
52,52411,2024-12-31,2211,7846,10057
52,52411,2025-12-31,2211,7845,10056
52,52411,2026-12-31,2224,7853,10077
52,52411,2027-12-31,2227,7850,10077
52,52411,2028-12-31,2244,7864,10108
52,52411,2029-12-31,2248,7890,10138
52,52411,2030-12-31,2255,7902,10157
52,52411,2031-12-31,2260,7917,10177
52,52411,2032-12-31,2275,7950,10225
52,52411,2033-12-31,2268,7959,10227
52,52411,2034-12-31,2281,7962,10243
52,52411,2035-12-31,2288,7992,10280
52,52418,1985-12-31,2792,11793,14585
52,52418,1986-12-31,2874,12733,15607
52,52418,1987-12-31,2950,13685,16635
52,52418,1988-12-31,3023,14601,17624
52,52418,1989-12-31,3079,15567,18646
52,52418,1990-12-31,3123,8825,11948
52,52418,1991-12-31,3160,8740,11900
52,52418,1992-12-31,3227,8609,11836
52,52418,1993-12-31,3231,8653,11884
52,52418,1994-12-31,3340,8462,11802
52,52418,1995-12-31,3393,8291,11684
52,52418,1996-12-31,3453,8130,11583
52,52418,1997-12-31,3511,7972,11483
52,52418,1998-12-31,3555,7806,11361
52,52418,1999-12-31,3615,7662,11277
52,52418,2000-12-31,3682,7500,11182
52,52418,2001-12-31,3745,7362,11107
52,52418,2002-12-31,3791,7244,11035
52,52418,2003-12-31,3855,7118,10973
52,52418,2004-12-31,3910,7003,10913
52,52418,2005-12-31,3947,6882,10829
52,52418,2006-12-31,3983,6781,10764
52,52418,2007-12-31,4061,6668,10729
52,52418,2008-12-31,4087,6536,10623
52,52418,2009-12-31,4110,6400,10510
52,52418,2010-12-31,4152,6274,10426
52,52418,2011-12-31,4186,6127,10313
52,52418,2012-12-31,4222,5959,10181
52,52418,2013-12-31,4242,5841,10083
52,52418,2014-12-31,4292,5760,10052
52,52418,2015-12-31,4335,5544,9879
52,52418,2016-12-31,4362,5376,9738
52,52418,2017-12-31,4357,5255,9612
52,52418,2018-12-31,4376,5171,9547
52,52418,2019-12-31,4369,5007,9376
52,52418,2020-12-31,4362,4906,9268
52,52418,2021-12-31,4360,4906,9266
52,52418,2022-12-31,4368,4908,9276
52,52418,2023-12-31,4378,4909,9287
52,52418,2024-12-31,4396,4905,9301
52,52418,2025-12-31,4408,4914,9322
52,52418,2026-12-31,4415,4918,9333
52,52418,2027-12-31,4437,4932,9369
52,52418,2028-12-31,4440,4942,9382
52,52418,2029-12-31,4459,4933,9392
52,52418,2030-12-31,4475,4954,9429
52,52418,2031-12-31,4497,4955,9452
52,52418,2032-12-31,4510,4975,9485
52,52418,2033-12-31,4524,4978,9502
52,52418,2034-12-31,4534,4999,9533
52,52418,2035-12-31,4549,4998,9547
52,52427,1985-12-31,1097,3559,4656
52,52427,1986-12-31,1272,3973,5245
52,52427,1987-12-31,1514,4393,5907
52,52427,1988-12-31,1745,4768,6513
52,52427,1989-12-31,1964,5190,7154
52,52427,1990-12-31,2148,5677,7825
52,52427,1991-12-31,2306,6143,8449
52,52427,1992-12-31,2543,6598,9141
52,52427,1993-12-31,2712,7168,9880
52,52427,1994-12-31,2934,7568,10502
52,52427,1995-12-31,3138,7980,11118
52,52427,1996-12-31,3353,8398,11751
52,52427,1997-12-31,3583,8815,12398
52,52427,1998-12-31,3800,9216,13016
52,52427,1999-12-31,3985,9640,13625
52,52427,2000-12-31,4192,10030,14222
52,52427,2001-12-31,4422,10443,14865
52,52427,2002-12-31,4623,10870,15493
52,52427,2003-12-31,4814,11298,16112
52,52427,2004-12-31,5067,11759,16826
52,52427,2005-12-31,5212,12210,17422
52,52427,2006-12-31,5404,12655,18059
52,52427,2007-12-31,5572,13119,18691
52,52427,2008-12-31,5759,13544,19303
52,52427,2009-12-31,5923,13960,19883
52,52427,2010-12-31,6123,14371,20494
52,52427,2011-12-31,6282,14767,21049
52,52427,2012-12-31,6436,15162,21598
52,52427,2013-12-31,6589,15541,22130
52,52427,2014-12-31,6733,15922,22655
52,52427,2015-12-31,6906,16294,23200
52,52427,2016-12-31,7028,16670,23698
52,52427,2017-12-31,7209,17029,24238
52,52427,2018-12-31,7325,17380,24705
52,52427,2019-12-31,7475,17739,25214
52,52427,2020-12-31,7568,17975,25543
52,52427,2021-12-31,7565,17977,25542
52,52427,2022-12-31,7586,17984,25570
52,52427,2023-12-31,7611,17990,25601
52,52427,2024-12-31,7642,18025,25667
52,52427,2025-12-31,7668,18058,25726
52,52427,2026-12-31,7704,18084,25788
52,52427,2027-12-31,7728,18149,25877
52,52427,2028-12-31,7763,18190,25953
52,52427,2029-12-31,7781,18252,26033
52,52427,2030-12-31,7817,18330,26147
52,52427,2031-12-31,7858,18393,26251
52,52427,2032-12-31,7890,18454,26344
52,52427,2033-12-31,7922,18532,26454
52,52427,2034-12-31,7958,18598,26556
52,52427,2035-12-31,7979,18647,26626
52,52435,1985-12-31,1015,5396,6411
52,52435,1986-12-31,1015,5416,6431
52,52435,1987-12-31,1039,5416,6455
52,52435,1988-12-31,1054,5432,6486
52,52435,1989-12-31,1019,5493,6512
52,52435,1990-12-31,1017,5636,6653
52,52435,1991-12-31,1045,5727,6772
52,52435,1992-12-31,1067,5812,6879
52,52435,1993-12-31,1051,6029,7080
52,52435,1994-12-31,1078,6071,7149
52,52435,1995-12-31,1101,6131,7232
52,52435,1996-12-31,1066,6195,7261
52,52435,1997-12-31,1104,6256,7360
52,52435,1998-12-31,1139,6302,7441
52,52435,1999-12-31,1136,6371,7507
52,52435,2000-12-31,1123,6427,7550
52,52435,2001-12-31,1162,6526,7688
52,52435,2002-12-31,1126,6607,7733
52,52435,2003-12-31,1152,6711,7863
52,52435,2004-12-31,1144,6790,7934
52,52435,2005-12-31,1156,6885,8041
52,52435,2006-12-31,1185,6974,8159
52,52435,2007-12-31,1194,7064,8258
52,52435,2008-12-31,1185,7142,8327
52,52435,2009-12-31,1198,7204,8402
52,52435,2010-12-31,1216,7282,8498
52,52435,2011-12-31,1204,7376,8580
52,52435,2012-12-31,1167,7402,8569
52,52435,2013-12-31,1166,7451,8617
52,52435,2014-12-31,1224,7504,8728
52,52435,2015-12-31,1219,7612,8831
52,52435,2016-12-31,1223,7655,8878
52,52435,2017-12-31,1216,7722,8938
52,52435,2018-12-31,1218,7758,8976
52,52435,2019-12-31,1223,7737,8960
52,52435,2020-12-31,1229,7717,8946
52,52435,2021-12-31,1228,7716,8944
52,52435,2022-12-31,1235,7719,8954
52,52435,2023-12-31,1242,7722,8964
52,52435,2024-12-31,1245,7723,8968
52,52435,2025-12-31,1249,7730,8979
52,52435,2026-12-31,1250,7741,8991
52,52435,2027-12-31,1251,7760,9011
52,52435,2028-12-31,1254,7784,9038
52,52435,2029-12-31,1257,7789,9046
52,52435,2030-12-31,1263,7801,9064
52,52435,2031-12-31,1282,7830,9112
52,52435,2032-12-31,1281,7861,9142
52,52435,2033-12-31,1281,7871,9152
52,52435,2034-12-31,1277,7893,9170
52,52435,2035-12-31,1286,7920,9206
52,52473,1985-12-31,1850,3651,5501
52,52473,1986-12-31,1994,3689,5683
52,52473,1987-12-31,2140,3743,5883
52,52473,1988-12-31,2277,3782,6059
52,52473,1989-12-31,2426,3843,6269
52,52473,1990-12-31,2503,3979,6482
52,52473,1991-12-31,2625,4094,6719
52,52473,1992-12-31,2756,4179,6935
52,52473,1993-12-31,2863,4350,7213
52,52473,1994-12-31,3005,4410,7415
52,52473,1995-12-31,3138,4482,7620
52,52473,1996-12-31,3269,4563,7832
52,52473,1997-12-31,3403,4629,8032
52,52473,1998-12-31,3543,4706,8249
52,52473,1999-12-31,3676,4766,8442
52,52473,2000-12-31,3841,4846,8687
52,52473,2001-12-31,3985,4921,8906
52,52473,2002-12-31,4103,5034,9137
52,52473,2003-12-31,4220,5129,9349
52,52473,2004-12-31,4335,5221,9556
52,52473,2005-12-31,4427,5316,9743
52,52473,2006-12-31,4568,5408,9976
52,52473,2007-12-31,4656,5494,10150
52,52473,2008-12-31,4785,5578,10363
52,52473,2009-12-31,4909,5662,10571
52,52473,2010-12-31,4999,5749,10748
52,52473,2011-12-31,5072,5831,10903
52,52473,2012-12-31,5169,5899,11068
52,52473,2013-12-31,5254,5955,11209
52,52473,2014-12-31,5349,6024,11373
52,52473,2015-12-31,5422,6117,11539
52,52473,2016-12-31,5534,6178,11712
52,52473,2017-12-31,5597,6235,11832
52,52473,2018-12-31,5677,6307,11984
52,52473,2019-12-31,5773,6510,12283
52,52473,2020-12-31,5835,6747,12582
52,52473,2021-12-31,5834,6748,12582
52,52473,2022-12-31,5845,6750,12595
52,52473,2023-12-31,5857,6753,12610
52,52473,2024-12-31,5865,6756,12621
52,52473,2025-12-31,5878,6761,12639
52,52473,2026-12-31,5904,6792,12696
52,52473,2027-12-31,5919,6809,12728
52,52473,2028-12-31,5944,6817,12761
52,52473,2029-12-31,5968,6847,12815
52,52473,2030-12-31,5996,6862,12858
52,52473,2031-12-31,6004,6885,12889
52,52473,2032-12-31,6038,6894,12932
52,52473,2033-12-31,6052,6917,12969
52,52473,2034-12-31,6069,6924,12993
52,52473,2035-12-31,6102,6946,13048
52,52480,1985-12-31,0,0,0
52,52480,1986-12-31,0,0,0
52,52480,1987-12-31,0,0,0
52,52480,1988-12-31,0,0,0
52,52480,1989-12-31,0,0,0
52,52480,1990-12-31,0,0,0
52,52480,1991-12-31,0,0,0
52,52480,1992-12-31,0,0,0
52,52480,1993-12-31,0,0,0
52,52480,1994-12-31,0,0,0
52,52480,1995-12-31,0,0,0
52,52480,1996-12-31,0,0,0
52,52480,1997-12-31,0,0,0
52,52480,1998-12-31,0,0,0
52,52480,1999-12-31,0,0,0
52,52480,2000-12-31,3120,1708,4828
52,52480,2001-12-31,3122,1739,4861
52,52480,2002-12-31,3095,1693,4788
52,52480,2003-12-31,3068,1696,4764
52,52480,2004-12-31,3048,1720,4768
52,52480,2005-12-31,3024,1701,4725
52,52480,2006-12-31,3024,1702,4726
52,52480,2007-12-31,2987,1724,4711
52,52480,2008-12-31,3009,1698,4707
52,52480,2009-12-31,2943,1705,4648
52,52480,2010-12-31,2889,1680,4569
52,52480,2011-12-31,2855,1671,4526
52,52480,2012-12-31,2832,1696,4528
52,52480,2013-12-31,2792,1718,4510
52,52480,2014-12-31,2739,1712,4451
52,52480,2015-12-31,2700,1652,4352
52,52480,2016-12-31,2651,1670,4321
52,52480,2017-12-31,2649,1690,4339
52,52480,2018-12-31,2653,1711,4364
52,52480,2019-12-31,2646,1709,4355
52,52480,2020-12-31,2639,1707,4346
52,52480,2021-12-31,2638,1707,4345
52,52480,2022-12-31,2642,1708,4350
52,52480,2023-12-31,2647,1708,4355
52,52480,2024-12-31,2648,1708,4356
52,52480,2025-12-31,2656,1708,4364
52,52480,2026-12-31,2665,1711,4376
52,52480,2027-12-31,2674,1710,4384
52,52480,2028-12-31,2681,1720,4401
52,52480,2029-12-31,2691,1720,4411
52,52480,2030-12-31,2697,1714,4411
52,52480,2031-12-31,2713,1735,4448
52,52480,2032-12-31,2715,1734,4449
52,52480,2033-12-31,2731,1733,4464
52,52480,2034-12-31,2737,1743,4480
52,52480,2035-12-31,2744,1745,4489
52,52490,1985-12-31,3823,12883,16706
52,52490,1986-12-31,4096,16510,20606
52,52490,1987-12-31,4356,20037,24393
52,52490,1988-12-31,4629,23465,28094
52,52490,1989-12-31,4871,23903,28774
52,52490,1990-12-31,5051,23762,28813
52,52490,1991-12-31,5271,23534,28805
52,52490,1992-12-31,5545,23200,28745
52,52490,1993-12-31,5699,23310,29009
52,52490,1994-12-31,5975,22825,28800
52,52490,1995-12-31,6197,22389,28586
52,52490,1996-12-31,6474,21964,28438
52,52490,1997-12-31,6713,21558,28271
52,52490,1998-12-31,6960,21159,28119
52,52490,1999-12-31,7198,20791,27989
52,52490,2000-12-31,7434,20379,27813
52,52490,2001-12-31,7707,20013,27720
52,52490,2002-12-31,7913,19718,27631
52,52490,2003-12-31,8138,19431,27569
52,52490,2004-12-31,8363,19138,27501
52,52490,2005-12-31,8565,18831,27396
52,52490,2006-12-31,8787,18566,27353
52,52490,2007-12-31,8951,18278,27229
52,52490,2008-12-31,9190,17955,27145
52,52490,2009-12-31,9393,17627,27020
52,52490,2010-12-31,9556,17294,26850
52,52490,2011-12-31,9746,16957,26703
52,52490,2012-12-31,9914,16619,26533
52,52490,2013-12-31,10079,16251,26330
52,52490,2014-12-31,10223,15872,26095
52,52490,2015-12-31,10411,15542,25953
52,52490,2016-12-31,10584,15196,25780
52,52490,2017-12-31,10729,14827,25556
52,52490,2018-12-31,10859,14499,25358
52,52490,2019-12-31,10842,14440,25282
52,52490,2020-12-31,10826,14384,25210
52,52490,2021-12-31,10821,14383,25204
52,52490,2022-12-31,10844,14388,25232
52,52490,2023-12-31,10869,14393,25262
52,52490,2024-12-31,10912,14416,25328
52,52490,2025-12-31,10946,14438,25384
52,52490,2026-12-31,10974,14470,25444
52,52490,2027-12-31,11023,14501,25524
52,52490,2028-12-31,11073,14544,25617
52,52490,2029-12-31,11113,14582,25695
52,52490,2030-12-31,11162,14639,25801
52,52490,2031-12-31,11199,14671,25870
52,52490,2032-12-31,11255,14739,25994
52,52490,2033-12-31,11291,14752,26043
52,52490,2034-12-31,11340,14791,26131
52,52490,2035-12-31,11375,14828,26203
52,52506,1985-12-31,1438,5297,6735
52,52506,1986-12-31,1463,5211,6674
52,52506,1987-12-31,1506,5137,6643
52,52506,1988-12-31,1535,5081,6616
52,52506,1989-12-31,1574,5050,6624
52,52506,1990-12-31,1525,5100,6625
52,52506,1991-12-31,1547,5138,6685
52,52506,1992-12-31,1578,5110,6688
52,52506,1993-12-31,1609,5270,6879
52,52506,1994-12-31,1601,5227,6828
52,52506,1995-12-31,1641,5221,6862
52,52506,1996-12-31,1669,5198,6867
52,52506,1997-12-31,1687,5193,6880
52,52506,1998-12-31,1705,5158,6863
52,52506,1999-12-31,1735,5162,6897
52,52506,2000-12-31,1746,5167,6913
52,52506,2001-12-31,1761,5155,6916
52,52506,2002-12-31,1789,5150,6939
52,52506,2003-12-31,1815,5183,6998
52,52506,2004-12-31,1837,5188,7025
52,52506,2005-12-31,1857,5201,7058
52,52506,2006-12-31,1857,5211,7068
52,52506,2007-12-31,1869,5217,7086
52,52506,2008-12-31,1898,5207,7105
52,52506,2009-12-31,1908,5193,7101
52,52506,2010-12-31,1916,5189,7105
52,52506,2011-12-31,1921,5195,7116
52,52506,2012-12-31,1902,5204,7106
52,52506,2013-12-31,1903,5196,7099
52,52506,2014-12-31,1898,5186,7084
52,52506,2015-12-31,1954,5097,7051
52,52506,2016-12-31,1951,5169,7120
52,52506,2017-12-31,1952,5147,7099
52,52506,2018-12-31,1965,5140,7105
52,52506,2019-12-31,1962,5077,7039
52,52506,2020-12-31,1959,5034,6993
52,52506,2021-12-31,1957,5034,6991
52,52506,2022-12-31,1963,5036,6999
52,52506,2023-12-31,1970,5037,7007
52,52506,2024-12-31,1978,5032,7010
52,52506,2025-12-31,1985,5039,7024
52,52506,2026-12-31,1991,5040,7031
52,52506,2027-12-31,1990,5050,7040
52,52506,2028-12-31,2002,5059,7061
52,52506,2029-12-31,2011,5073,7084
52,52506,2030-12-31,2023,5090,7113
52,52506,2031-12-31,2029,5092,7121
52,52506,2032-12-31,2041,5103,7144
52,52506,2033-12-31,2046,5116,7162
52,52506,2034-12-31,2044,5126,7170
52,52506,2035-12-31,2045,5130,7175
52,52520,1985-12-31,2978,4530,7508
52,52520,1986-12-31,3077,4587,7664
52,52520,1987-12-31,3185,4671,7856
52,52520,1988-12-31,3282,4773,8055
52,52520,1989-12-31,3378,4862,8240
52,52520,1990-12-31,3428,5035,8463
52,52520,1991-12-31,3495,5238,8733
52,52520,1992-12-31,3612,5375,8987
52,52520,1993-12-31,3631,5649,9280
52,52520,1994-12-31,3751,5723,9474
52,52520,1995-12-31,3852,5848,9700
52,52520,1996-12-31,3949,5970,9919
52,52520,1997-12-31,4041,6079,10120
52,52520,1998-12-31,4123,6199,10322
52,52520,1999-12-31,4206,6335,10541
52,52520,2000-12-31,4293,6471,10764
52,52520,2001-12-31,4398,6583,10981
52,52520,2002-12-31,4465,6745,11210
52,52520,2003-12-31,4547,6889,11436
52,52520,2004-12-31,4626,7032,11658
52,52520,2005-12-31,4703,7178,11881
52,52520,2006-12-31,4774,7325,12099
52,52520,2007-12-31,4845,7463,12308
52,52520,2008-12-31,4909,7602,12511
52,52520,2009-12-31,4966,7748,12714
52,52520,2010-12-31,5034,7881,12915
52,52520,2011-12-31,5093,7989,13082
52,52520,2012-12-31,5137,8097,13234
52,52520,2013-12-31,5192,8233,13425
52,52520,2014-12-31,5246,8357,13603
52,52520,2015-12-31,5308,8451,13759
52,52520,2016-12-31,5351,8540,13891
52,52520,2017-12-31,5385,8675,14060
52,52520,2018-12-31,5423,8770,14193
52,52520,2019-12-31,5446,8730,14176
52,52520,2020-12-31,5463,8695,14158
52,52520,2021-12-31,5461,8694,14155
52,52520,2022-12-31,5472,8698,14170
52,52520,2023-12-31,5486,8701,14187
52,52520,2024-12-31,5511,8701,14212
52,52520,2025-12-31,5530,8732,14262
52,52520,2026-12-31,5548,8746,14294
52,52520,2027-12-31,5559,8756,14315
52,52520,2028-12-31,5593,8768,14361
52,52520,2029-12-31,5604,8816,14420
52,52520,2030-12-31,5628,8822,14450
52,52520,2031-12-31,5666,8845,14511
52,52520,2032-12-31,5684,8893,14577
52,52520,2033-12-31,5685,8895,14580
52,52520,2034-12-31,5718,8924,14642
52,52520,2035-12-31,5738,8961,14699
52,52540,1985-12-31,1311,7225,8536
52,52540,1986-12-31,1345,7142,8487
52,52540,1987-12-31,1401,7061,8462
52,52540,1988-12-31,1447,6987,8434
52,52540,1989-12-31,1509,6961,8470
52,52540,1990-12-31,1511,7024,8535
52,52540,1991-12-31,1563,7084,8647
52,52540,1992-12-31,1616,7104,8720
52,52540,1993-12-31,1649,7268,8917
52,52540,1994-12-31,1687,7210,8897
52,52540,1995-12-31,1751,7198,8949
52,52540,1996-12-31,1782,7190,8972
52,52540,1997-12-31,1838,7185,9023
52,52540,1998-12-31,1938,7181,9119
52,52540,1999-12-31,1978,7175,9153
52,52540,2000-12-31,2035,7166,9201
52,52540,2001-12-31,2044,7161,9205
52,52540,2002-12-31,2099,7186,9285
52,52540,2003-12-31,2167,7209,9376
52,52540,2004-12-31,2195,7228,9423
52,52540,2005-12-31,2243,7244,9487
52,52540,2006-12-31,2253,7278,9531
52,52540,2007-12-31,2294,7304,9598
52,52540,2008-12-31,2332,7315,9647
52,52540,2009-12-31,2354,7315,9669
52,52540,2010-12-31,2377,7336,9713
52,52540,2011-12-31,2411,7337,9748
52,52540,2012-12-31,2443,7336,9779
52,52540,2013-12-31,2468,7331,9799
52,52540,2014-12-31,2484,7314,9798
52,52540,2015-12-31,2508,7339,9847
52,52540,2016-12-31,2558,7342,9900
52,52540,2017-12-31,2581,7294,9875
52,52540,2018-12-31,2596,7301,9897
52,52540,2019-12-31,2603,7224,9827
52,52540,2020-12-31,2605,7174,9779
52,52540,2021-12-31,2604,7173,9777
52,52540,2022-12-31,2611,7176,9787
52,52540,2023-12-31,2620,7179,9799
52,52540,2024-12-31,2634,7194,9828
52,52540,2025-12-31,2640,7186,9826
52,52540,2026-12-31,2648,7196,9844
52,52540,2027-12-31,2647,7203,9850
52,52540,2028-12-31,2676,7239,9915
52,52540,2029-12-31,2688,7224,9912
52,52540,2030-12-31,2681,7259,9940
52,52540,2031-12-31,2696,7291,9987
52,52540,2032-12-31,2712,7294,10006
52,52540,2033-12-31,2714,7316,10030
52,52540,2034-12-31,2721,7327,10048
52,52540,2035-12-31,2731,7342,10073
52,52560,1985-12-31,1761,11712,13473
52,52560,1986-12-31,1763,11462,13225
52,52560,1987-12-31,1807,11226,13033
52,52560,1988-12-31,1801,10992,12793
52,52560,1989-12-31,1825,10842,12667
52,52560,1990-12-31,1845,10840,12685
52,52560,1991-12-31,1856,10799,12655
52,52560,1992-12-31,1884,10718,12602
52,52560,1993-12-31,1834,10846,12680
52,52560,1994-12-31,1883,10687,12570
52,52560,1995-12-31,1921,10540,12461
52,52560,1996-12-31,1920,10417,12337
52,52560,1997-12-31,1937,10307,12244
52,52560,1998-12-31,1951,10187,12138
52,52560,1999-12-31,1958,10077,12035
52,52560,2000-12-31,1968,9971,11939
52,52560,2001-12-31,2010,9862,11872
52,52560,2002-12-31,2043,9807,11850
52,52560,2003-12-31,2067,9735,11802
52,52560,2004-12-31,2070,9671,11741
52,52560,2005-12-31,2081,9595,11676
52,52560,2006-12-31,2094,9516,11610
52,52560,2007-12-31,2108,9440,11548
52,52560,2008-12-31,2117,9344,11461
52,52560,2009-12-31,2131,9236,11367
52,52560,2010-12-31,2139,9141,11280
52,52560,2011-12-31,2140,9056,11196
52,52560,2012-12-31,2140,8950,11090
52,52560,2013-12-31,2125,8834,10959
52,52560,2014-12-31,2066,8755,10821
52,52560,2015-12-31,2064,8625,10689
52,52560,2016-12-31,2073,8522,10595
52,52560,2017-12-31,2084,8366,10450
52,52560,2018-12-31,2097,8317,10414
52,52560,2019-12-31,2093,8104,10197
52,52560,2020-12-31,2090,7968,10058
52,52560,2021-12-31,2089,7967,10056
52,52560,2022-12-31,2097,7970,10067
52,52560,2023-12-31,2106,7973,10079
52,52560,2024-12-31,2104,7981,10085
52,52560,2025-12-31,2118,7992,10110
52,52560,2026-12-31,2123,8010,10133
52,52560,2027-12-31,2125,8010,10135
52,52560,2028-12-31,2137,8023,10160
52,52560,2029-12-31,2148,8044,10192
52,52560,2030-12-31,2159,8072,10231
52,52560,2031-12-31,2167,8082,10249
52,52560,2032-12-31,2170,8114,10284
52,52560,2033-12-31,2182,8143,10325
52,52560,2034-12-31,2177,8159,10336
52,52560,2035-12-31,2187,8161,10348
52,52565,1985-12-31,0,0,0
52,52565,1986-12-31,0,0,0
52,52565,1987-12-31,0,0,0
52,52565,1988-12-31,0,0,0
52,52565,1989-12-31,0,0,0
52,52565,1990-12-31,0,0,0
52,52565,1991-12-31,0,0,0
52,52565,1992-12-31,0,0,0
52,52565,1993-12-31,2156,8321,10477
52,52565,1994-12-31,2153,8083,10236
52,52565,1995-12-31,2129,7876,10005
52,52565,1996-12-31,2105,7670,9775
52,52565,1997-12-31,2087,7501,9588
52,52565,1998-12-31,2063,7295,9358
52,52565,1999-12-31,2040,7116,9156
52,52565,2000-12-31,2003,6924,8927
52,52565,2001-12-31,2007,6749,8756
52,52565,2002-12-31,1942,6601,8543
52,52565,2003-12-31,1930,6449,8379
52,52565,2004-12-31,1905,6305,8210
52,52565,2005-12-31,1883,6155,8038
52,52565,2006-12-31,1818,6009,7827
52,52565,2007-12-31,1841,5860,7701
52,52565,2008-12-31,1796,5704,7500
52,52565,2009-12-31,1780,5546,7326
52,52565,2010-12-31,1741,5370,7111
52,52565,2011-12-31,1715,5235,6950
52,52565,2012-12-31,1672,5029,6701
52,52565,2013-12-31,1633,4857,6490
52,52565,2014-12-31,1611,4706,6317
52,52565,2015-12-31,1559,4501,6060
52,52565,2016-12-31,1566,4341,5907
52,52565,2017-12-31,1545,4217,5762
52,52565,2018-12-31,1501,4071,5572
52,52565,2019-12-31,1498,4064,5562
52,52565,2020-12-31,1496,4057,5553
52,52565,2021-12-31,1495,4057,5552
52,52565,2022-12-31,1500,4058,5558
52,52565,2023-12-31,1504,4060,5564
52,52565,2024-12-31,1503,4064,5567
52,52565,2025-12-31,1505,4063,5568
52,52565,2026-12-31,1507,4064,5571
52,52565,2027-12-31,1520,4086,5606
52,52565,2028-12-31,1523,4083,5606
52,52565,2029-12-31,1531,4097,5628
52,52565,2030-12-31,1527,4102,5629
52,52565,2031-12-31,1534,4115,5649
52,52565,2032-12-31,1556,4119,5675
52,52565,2033-12-31,1554,4129,5683
52,52565,2034-12-31,1564,4134,5698
52,52565,2035-12-31,1564,4148,5712
52,52573,1985-12-31,2433,7453,9886
52,52573,1986-12-31,2448,7287,9735
52,52573,1987-12-31,2512,7138,9650
52,52573,1988-12-31,2591,6983,9574
52,52573,1989-12-31,2652,6884,9536
52,52573,1990-12-31,2665,6877,9542
52,52573,1991-12-31,2661,6853,9514
52,52573,1992-12-31,2730,6785,9515
52,52573,1993-12-31,2667,6877,9544
52,52573,1994-12-31,2728,6755,9483
52,52573,1995-12-31,2816,6664,9480
52,52573,1996-12-31,2849,6582,9431
52,52573,1997-12-31,2887,6502,9389
52,52573,1998-12-31,2920,6418,9338
52,52573,1999-12-31,2954,6354,9308
52,52573,2000-12-31,2998,6272,9270
52,52573,2001-12-31,3040,6211,9251
52,52573,2002-12-31,3081,6154,9235
52,52573,2003-12-31,3110,6128,9238
52,52573,2004-12-31,3156,6066,9222
52,52573,2005-12-31,3188,6005,9193
52,52573,2006-12-31,3218,5950,9168
52,52573,2007-12-31,3258,5903,9161
52,52573,2008-12-31,3300,5833,9133
52,52573,2009-12-31,3262,5754,9016
52,52573,2010-12-31,3298,5692,8990
52,52573,2011-12-31,3358,5581,8939
52,52573,2012-12-31,3398,5552,8950
52,52573,2013-12-31,3425,5495,8920
52,52573,2014-12-31,3451,5416,8867
52,52573,2015-12-31,3469,5304,8773
52,52573,2016-12-31,3419,5212,8631
52,52573,2017-12-31,3418,5136,8554
52,52573,2018-12-31,3451,5130,8581
52,52573,2019-12-31,3445,5005,8450
52,52573,2020-12-31,3440,4925,8365
52,52573,2021-12-31,3438,4925,8363
52,52573,2022-12-31,3445,4927,8372
52,52573,2023-12-31,3454,4928,8382
52,52573,2024-12-31,3465,4921,8386
52,52573,2025-12-31,3480,4935,8415
52,52573,2026-12-31,3494,4932,8426
52,52573,2027-12-31,3490,4945,8435
52,52573,2028-12-31,3512,4944,8456
52,52573,2029-12-31,3513,4969,8482
52,52573,2030-12-31,3533,4974,8507
52,52573,2031-12-31,3546,4984,8530
52,52573,2032-12-31,3557,4998,8555
52,52573,2033-12-31,3574,5013,8587
52,52573,2034-12-31,3589,5015,8604
52,52573,2035-12-31,3594,5037,8631
52,52585,1985-12-31,4277,12313,16590
52,52585,1986-12-31,4400,12130,16530
52,52585,1987-12-31,4438,11967,16405
52,52585,1988-12-31,4501,11811,16312
52,52585,1989-12-31,4639,11742,16381
52,52585,1990-12-31,4659,11802,16461
52,52585,1991-12-31,4691,11841,16532
52,52585,1992-12-31,4781,11830,16611
52,52585,1993-12-31,4792,12085,16877
52,52585,1994-12-31,4890,11989,16879
52,52585,1995-12-31,4980,11922,16902
52,52585,1996-12-31,5060,11871,16931
52,52585,1997-12-31,5140,11813,16953
52,52585,1998-12-31,5223,11765,16988
52,52585,1999-12-31,5280,11743,17023
52,52585,2000-12-31,5377,11689,17066
52,52585,2001-12-31,5466,11661,17127
52,52585,2002-12-31,5526,11673,17199
52,52585,2003-12-31,5583,11682,17265
52,52585,2004-12-31,5634,11685,17319
52,52585,2005-12-31,5672,11686,17358
52,52585,2006-12-31,5714,11683,17397
52,52585,2007-12-31,5810,11683,17493
52,52585,2008-12-31,5859,11666,17525
52,52585,2009-12-31,5962,11633,17595
52,52585,2010-12-31,5920,11623,17543
52,52585,2011-12-31,5957,11584,17541
52,52585,2012-12-31,6014,11527,17541
52,52585,2013-12-31,6040,11522,17562
52,52585,2014-12-31,6046,11438,17484
52,52585,2015-12-31,6140,11417,17557
52,52585,2016-12-31,6225,11468,17693
52,52585,2017-12-31,6144,11319,17463
52,52585,2018-12-31,6192,11299,17491
52,52585,2019-12-31,6182,11152,17334
52,52585,2020-12-31,6172,11047,17219
52,52585,2021-12-31,6169,11046,17215
52,52585,2022-12-31,6184,11050,17234
52,52585,2023-12-31,6200,11054,17254
52,52585,2024-12-31,6215,11054,17269
52,52585,2025-12-31,6239,11063,17302
52,52585,2026-12-31,6250,11073,17323
52,52585,2027-12-31,6282,11085,17367
52,52585,2028-12-31,6299,11116,17415
52,52585,2029-12-31,6319,11143,17462
52,52585,2030-12-31,6337,11171,17508
52,52585,2031-12-31,6365,11207,17572
52,52585,2032-12-31,6389,11231,17620
52,52585,2033-12-31,6405,11253,17658
52,52585,2034-12-31,6411,11288,17699
52,52585,2035-12-31,6442,11299,17741
52,52612,1985-12-31,1508,5513,7021
52,52612,1986-12-31,1560,5820,7380
52,52612,1987-12-31,1591,6146,7737
52,52612,1988-12-31,1645,6458,8103
52,52612,1989-12-31,1693,6797,8490
52,52612,1990-12-31,1721,7229,8950
52,52612,1991-12-31,1726,7646,9372
52,52612,1992-12-31,1748,8036,9784
52,52612,1993-12-31,1770,8600,10370
52,52612,1994-12-31,1824,8924,10748
52,52612,1995-12-31,1869,9266,11135
52,52612,1996-12-31,1905,9603,11508
52,52612,1997-12-31,1925,9948,11873
52,52612,1998-12-31,1949,10289,12238
52,52612,1999-12-31,1988,10645,12633
52,52612,2000-12-31,2028,10973,13001
52,52612,2001-12-31,2077,11321,13398
52,52612,2002-12-31,2096,11718,13814
52,52612,2003-12-31,2104,12097,14201
52,52612,2004-12-31,2127,12476,14603
52,52612,2005-12-31,2141,12870,15011
52,52612,2006-12-31,2201,13262,15463
52,52612,2007-12-31,2215,13641,15856
52,52612,2008-12-31,2212,13990,16202
52,52612,2009-12-31,2231,14349,16580
52,52612,2010-12-31,2254,14707,16961
52,52612,2011-12-31,2281,15039,17320
52,52612,2012-12-31,2308,15383,17691
52,52612,2013-12-31,2324,15699,18023
52,52612,2014-12-31,2372,16003,18375
52,52612,2015-12-31,2375,16304,18679
52,52612,2016-12-31,2371,16632,19003
52,52612,2017-12-31,2379,16937,19316
52,52612,2018-12-31,2399,17232,19631
52,52612,2019-12-31,2395,17490,19885
52,52612,2020-12-31,2392,17665,20057
52,52612,2021-12-31,2389,17667,20056
52,52612,2022-12-31,2404,17674,20078
52,52612,2023-12-31,2422,17680,20102
52,52612,2024-12-31,2429,17697,20126
52,52612,2025-12-31,2437,17747,20184
52,52612,2026-12-31,2448,17771,20219
52,52612,2027-12-31,2458,17818,20276
52,52612,2028-12-31,2458,17855,20313
52,52612,2029-12-31,2479,17916,20395
52,52612,2030-12-31,2488,17992,20480
52,52612,2031-12-31,2490,18030,20520
52,52612,2032-12-31,2491,18104,20595
52,52612,2033-12-31,2509,18159,20668
52,52612,2034-12-31,2517,18209,20726
52,52612,2035-12-31,2526,18271,20797
52,52621,1985-12-31,775,9154,9929
52,52621,1986-12-31,797,9057,9854
52,52621,1987-12-31,905,8957,9862
52,52621,1988-12-31,1016,8845,9861
52,52621,1989-12-31,1121,8792,9913
52,52621,1990-12-31,1157,8888,10045
52,52621,1991-12-31,1268,8935,10203
52,52621,1992-12-31,1378,8967,10345
52,52621,1993-12-31,1450,9179,10629
52,52621,1994-12-31,1530,9140,10670
52,52621,1995-12-31,1648,9114,10762
52,52621,1996-12-31,1701,9100,10801
52,52621,1997-12-31,1849,9090,10939
52,52621,1998-12-31,1897,9074,10971
52,52621,1999-12-31,1982,9093,11075
52,52621,2000-12-31,2051,9062,11113
52,52621,2001-12-31,2141,9067,11208
52,52621,2002-12-31,2263,9101,11364
52,52621,2003-12-31,2342,9135,11477
52,52621,2004-12-31,2441,9169,11610
52,52621,2005-12-31,2493,9193,11686
52,52621,2006-12-31,2575,9230,11805
52,52621,2007-12-31,2686,9264,11950
52,52621,2008-12-31,2726,9277,12003
52,52621,2009-12-31,2802,9294,12096
52,52621,2010-12-31,2865,9301,12166
52,52621,2011-12-31,2934,9305,12239
52,52621,2012-12-31,2998,9316,12314
52,52621,2013-12-31,3053,9300,12353
52,52621,2014-12-31,3153,9297,12450
52,52621,2015-12-31,3242,9294,12536
52,52621,2016-12-31,3314,9301,12615
52,52621,2017-12-31,3333,9291,12624
52,52621,2018-12-31,3389,9278,12667
52,52621,2019-12-31,3387,9294,12681
52,52621,2020-12-31,3384,9310,12694
52,52621,2021-12-31,3382,9311,12693
52,52621,2022-12-31,3393,9315,12708
52,52621,2023-12-31,3405,9318,12723
52,52621,2024-12-31,3420,9328,12748
52,52621,2025-12-31,3433,9336,12769
52,52621,2026-12-31,3443,9358,12801
52,52621,2027-12-31,3449,9386,12835
52,52621,2028-12-31,3466,9415,12881
52,52621,2029-12-31,3475,9436,12911
52,52621,2030-12-31,3485,9469,12954
52,52621,2031-12-31,3509,9503,13012
52,52621,2032-12-31,3531,9540,13071
52,52621,2033-12-31,3518,9566,13084
52,52621,2034-12-31,3551,9601,13152
52,52621,2035-12-31,3551,9623,13174
52,52678,1985-12-31,7930,42392,50322
52,52678,1986-12-31,8035,41153,49188
52,52678,1987-12-31,8130,39967,48097
52,52678,1988-12-31,8241,38823,47064
52,52678,1989-12-31,8326,37935,46261
52,52678,1990-12-31,8318,37610,45928
52,52678,1991-12-31,8333,37153,45486
52,52678,1992-12-31,8418,36519,44937
52,52678,1993-12-31,8401,36655,45056
52,52678,1994-12-31,8511,35765,44276
52,52678,1995-12-31,8581,34935,43516
52,52678,1996-12-31,8678,34171,42849
52,52678,1997-12-31,8756,33405,42161
52,52678,1998-12-31,8828,32650,41478
52,52678,1999-12-31,8888,31972,40860
52,52678,2000-12-31,8953,31259,40212
52,52678,2001-12-31,9059,30564,39623
52,52678,2002-12-31,9107,30009,39116
52,52678,2003-12-31,9165,29420,38585
52,52678,2004-12-31,9219,28850,38069
52,52678,2005-12-31,9256,28265,37521
52,52678,2006-12-31,9294,27694,36988
52,52678,2007-12-31,9350,27089,36439
52,52678,2008-12-31,9359,26454,35813
52,52678,2009-12-31,9388,25824,35212
52,52678,2010-12-31,9385,25175,34560
52,52678,2011-12-31,9438,24530,33968
52,52678,2012-12-31,9434,23875,33309
52,52678,2013-12-31,9444,23195,32639
52,52678,2014-12-31,9453,22531,31984
52,52678,2015-12-31,9461,21891,31352
52,52678,2016-12-31,9481,21244,30725
52,52678,2017-12-31,9520,20621,30141
52,52678,2018-12-31,9462,19952,29414
52,52678,2019-12-31,9446,18934,28380
52,52678,2020-12-31,9431,18311,27742
52,52678,2021-12-31,9426,18309,27735
52,52678,2022-12-31,9449,18317,27766
52,52678,2023-12-31,9476,18323,27799
52,52678,2024-12-31,9501,18331,27832
52,52678,2025-12-31,9527,18346,27873
52,52678,2026-12-31,9572,18376,27948
52,52678,2027-12-31,9601,18381,27982
52,52678,2028-12-31,9639,18419,28058
52,52678,2029-12-31,9663,18461,28124
52,52678,2030-12-31,9714,18505,28219
52,52678,2031-12-31,9731,18553,28284
52,52678,2032-12-31,9774,18596,28370
52,52678,2033-12-31,9813,18632,28445
52,52678,2034-12-31,9834,18673,28507
52,52678,2035-12-31,9876,18715,28591
52,52683,1985-12-31,8422,22474,30896
52,52683,1986-12-31,8532,21819,30351
52,52683,1987-12-31,8665,21196,29861
52,52683,1988-12-31,8781,20592,29373
52,52683,1989-12-31,8865,20120,28985
52,52683,1990-12-31,8817,19950,28767
52,52683,1991-12-31,8857,19705,28562
52,52683,1992-12-31,8975,19364,28339
52,52683,1993-12-31,8936,19468,28404
52,52683,1994-12-31,9027,18994,28021
52,52683,1995-12-31,9149,18556,27705
52,52683,1996-12-31,9250,18150,27400
52,52683,1997-12-31,9328,17742,27070
52,52683,1998-12-31,9404,17353,26757
52,52683,1999-12-31,9483,17016,26499
52,52683,2000-12-31,9546,16621,26167
52,52683,2001-12-31,9649,16270,25919
52,52683,2002-12-31,9726,15981,25707
52,52683,2003-12-31,9781,15653,25434
52,52683,2004-12-31,9826,15370,25196
52,52683,2005-12-31,9884,15063,24947
52,52683,2006-12-31,9937,14727,24664
52,52683,2007-12-31,9966,14410,24376
52,52683,2008-12-31,10007,14095,24102
52,52683,2009-12-31,10009,13744,23753
52,52683,2010-12-31,10037,13390,23427
52,52683,2011-12-31,10070,13074,23144
52,52683,2012-12-31,10074,12716,22790
52,52683,2013-12-31,10074,12378,22452
52,52683,2014-12-31,10128,12008,22136
52,52683,2015-12-31,10087,11686,21773
52,52683,2016-12-31,10129,11371,21500
52,52683,2017-12-31,10187,10959,21146
52,52683,2018-12-31,10112,10661,20773
52,52683,2019-12-31,10093,10091,20184
52,52683,2020-12-31,10075,9695,19770
52,52683,2021-12-31,10071,9694,19765
52,52683,2022-12-31,10089,9698,19787
52,52683,2023-12-31,10110,9701,19811
52,52683,2024-12-31,10126,9691,19817
52,52683,2025-12-31,10162,9712,19874
52,52683,2026-12-31,10188,9698,19886
52,52683,2027-12-31,10216,9725,19941
52,52683,2028-12-31,10265,9738,20003
52,52683,2029-12-31,10303,9777,20080
52,52683,2030-12-31,10349,9798,20147
52,52683,2031-12-31,10380,9814,20194
52,52683,2032-12-31,10420,9836,20256
52,52683,2033-12-31,10431,9868,20299
52,52683,2034-12-31,10483,9878,20361
52,52683,2035-12-31,10490,9889,20379
52,52685,1985-12-31,0,0,0
52,52685,1986-12-31,0,0,0
52,52685,1987-12-31,0,0,0
52,52685,1988-12-31,0,0,0
52,52685,1989-12-31,0,0,0
52,52685,1990-12-31,0,0,0
52,52685,1991-12-31,0,0,0
52,52685,1992-12-31,0,0,0
52,52685,1993-12-31,2179,7682,9861
52,52685,1994-12-31,2273,7588,9861
52,52685,1995-12-31,2317,7533,9850
52,52685,1996-12-31,2317,7464,9781
52,52685,1997-12-31,2331,7410,9741
52,52685,1998-12-31,2368,7350,9718
52,52685,1999-12-31,2403,7314,9717
52,52685,2000-12-31,2408,7269,9677
52,52685,2001-12-31,2433,7215,9648
52,52685,2002-12-31,2463,7188,9651
52,52685,2003-12-31,2463,7178,9641
52,52685,2004-12-31,2486,7156,9642
52,52685,2005-12-31,2499,7136,9635
52,52685,2006-12-31,2509,7116,9625
52,52685,2007-12-31,2540,7076,9616
52,52685,2008-12-31,2514,7040,9554
52,52685,2009-12-31,2531,7009,9540
52,52685,2010-12-31,2569,6968,9537
52,52685,2011-12-31,2565,6930,9495
52,52685,2012-12-31,2594,6886,9480
52,52685,2013-12-31,2599,6812,9411
52,52685,2014-12-31,2566,6786,9352
52,52685,2015-12-31,2591,6746,9337
52,52685,2016-12-31,2591,6685,9276
52,52685,2017-12-31,2588,6641,9229
52,52685,2018-12-31,2595,6607,9202
52,52685,2019-12-31,2591,6595,9186
52,52685,2020-12-31,2587,6584,9171
52,52685,2021-12-31,2586,6583,9169
52,52685,2022-12-31,2593,6586,9179
52,52685,2023-12-31,2602,6588,9190
52,52685,2024-12-31,2609,6602,9211
52,52685,2025-12-31,2612,6594,9206
52,52685,2026-12-31,2622,6604,9226
52,52685,2027-12-31,2634,6610,9244
52,52685,2028-12-31,2643,6634,9277
52,52685,2029-12-31,2649,6638,9287
52,52685,2030-12-31,2649,6655,9304
52,52685,2031-12-31,2680,6683,9363
52,52685,2032-12-31,2681,6693,9374
52,52685,2033-12-31,2681,6707,9388
52,52685,2034-12-31,2691,6724,9415
52,52685,2035-12-31,2700,6728,9428
52,52687,1985-12-31,1359,13875,15234
52,52687,1986-12-31,1374,13795,15169
52,52687,1987-12-31,1452,13722,15174
52,52687,1988-12-31,1503,13660,15163
52,52687,1989-12-31,1524,13658,15182
52,52687,1990-12-31,1543,13871,15414
52,52687,1991-12-31,1576,14020,15596
52,52687,1992-12-31,1614,14119,15733
52,52687,1993-12-31,1616,14544,16160
52,52687,1994-12-31,1668,14538,16206
52,52687,1995-12-31,1653,14572,16225
52,52687,1996-12-31,1746,14619,16365
52,52687,1997-12-31,1777,14674,16451
52,52687,1998-12-31,1778,14715,16493
52,52687,1999-12-31,1787,14798,16585
52,52687,2000-12-31,1847,14848,16695
52,52687,2001-12-31,1861,14919,16780
52,52687,2002-12-31,1887,15044,16931
52,52687,2003-12-31,1914,15176,17090
52,52687,2004-12-31,1936,15289,17225
52,52687,2005-12-31,1965,15395,17360
52,52687,2006-12-31,1991,15515,17506
52,52687,2007-12-31,2016,15617,17633
52,52687,2008-12-31,2044,15718,17762
52,52687,2009-12-31,2050,15783,17833
52,52687,2010-12-31,2078,15850,17928
52,52687,2011-12-31,2095,15928,18023
52,52687,2012-12-31,2109,15997,18106
52,52687,2013-12-31,2095,16043,18138
52,52687,2014-12-31,2070,16068,18138
52,52687,2015-12-31,2120,16150,18270
52,52687,2016-12-31,2170,16226,18396
52,52687,2017-12-31,2172,16288,18460
52,52687,2018-12-31,2180,16293,18473
52,52687,2019-12-31,2182,16253,18435
52,52687,2020-12-31,2183,16216,18399
52,52687,2021-12-31,2180,16215,18395
52,52687,2022-12-31,2194,16221,18415
52,52687,2023-12-31,2210,16227,18437
52,52687,2024-12-31,2214,16225,18439
52,52687,2025-12-31,2219,16232,18451
52,52687,2026-12-31,2223,16268,18491
52,52687,2027-12-31,2241,16288,18529
52,52687,2028-12-31,2244,16325,18569
52,52687,2029-12-31,2246,16356,18602
52,52687,2030-12-31,2252,16394,18646
52,52687,2031-12-31,2264,16449,18713
52,52687,2032-12-31,2274,16473,18747
52,52687,2033-12-31,2280,16505,18785
52,52687,2034-12-31,2283,16531,18814
52,52687,2035-12-31,2293,16575,18868
52,52693,1985-12-31,4669,15246,19915
52,52693,1986-12-31,4701,14938,19639
52,52693,1987-12-31,4681,14661,19342
52,52693,1988-12-31,4666,14339,19005
52,52693,1989-12-31,4663,14142,18805
52,52693,1990-12-31,4618,14196,18814
52,52693,1991-12-31,4588,14156,18744
52,52693,1992-12-31,4576,14071,18647
52,52693,1993-12-31,4529,14287,18816
52,52693,1994-12-31,4534,14089,18623
52,52693,1995-12-31,4542,13939,18481
52,52693,1996-12-31,4540,13795,18335
52,52693,1997-12-31,4538,13616,18154
52,52693,1998-12-31,4525,13480,18005
52,52693,1999-12-31,4500,13355,17855
52,52693,2000-12-31,4498,13209,17707
52,52693,2001-12-31,4508,13096,17604
52,52693,2002-12-31,4488,13029,17517
52,52693,2003-12-31,4470,12961,17431
52,52693,2004-12-31,4468,12882,17350
52,52693,2005-12-31,4448,12805,17253
52,52693,2006-12-31,4425,12724,17149
52,52693,2007-12-31,4397,12634,17031
52,52693,2008-12-31,4406,12526,16932
52,52693,2009-12-31,4348,12417,16765
52,52693,2010-12-31,4324,12307,16631
52,52693,2011-12-31,4260,12188,16448
52,52693,2012-12-31,4222,12062,16284
52,52693,2013-12-31,4231,11951,16182
52,52693,2014-12-31,4232,11817,16049
52,52693,2015-12-31,4211,11702,15913
52,52693,2016-12-31,4083,11618,15701
52,52693,2017-12-31,4025,11436,15461
52,52693,2018-12-31,4051,11338,15389
52,52693,2019-12-31,3985,11049,15034
52,52693,2020-12-31,3931,10862,14793
52,52693,2021-12-31,3928,10861,14789
52,52693,2022-12-31,3941,10865,14806
52,52693,2023-12-31,3954,10869,14823
52,52693,2024-12-31,3973,10879,14852
52,52693,2025-12-31,3984,10889,14873
52,52693,2026-12-31,3994,10901,14895
52,52693,2027-12-31,4008,10909,14917
52,52693,2028-12-31,4026,10935,14961
52,52693,2029-12-31,4034,10959,14993
52,52693,2030-12-31,4052,10977,15029
52,52693,2031-12-31,4068,11022,15090
52,52693,2032-12-31,4090,11049,15139
52,52693,2033-12-31,4105,11074,15179
52,52693,2034-12-31,4111,11084,15195
52,52693,2035-12-31,4121,11116,15237
52,52694,1985-12-31,0,0,0
52,52694,1986-12-31,0,0,0
52,52694,1987-12-31,0,0,0
52,52694,1988-12-31,0,0,0
52,52694,1989-12-31,0,0,0
52,52694,1990-12-31,930,4492,5422
52,52694,1991-12-31,941,4578,5519
52,52694,1992-12-31,953,4653,5606
52,52694,1993-12-31,912,4801,5713
52,52694,1994-12-31,921,4831,5752
52,52694,1995-12-31,936,4873,5809
52,52694,1996-12-31,886,4913,5799
52,52694,1997-12-31,880,4949,5829
52,52694,1998-12-31,918,4994,5912
52,52694,1999-12-31,928,5037,5965
52,52694,2000-12-31,921,5094,6015
52,52694,2001-12-31,915,5144,6059
52,52694,2002-12-31,928,5213,6141
52,52694,2003-12-31,909,5265,6174
52,52694,2004-12-31,874,5347,6221
52,52694,2005-12-31,892,5390,6282
52,52694,2006-12-31,889,5472,6361
52,52694,2007-12-31,856,5533,6389
52,52694,2008-12-31,865,5596,6461
52,52694,2009-12-31,878,5628,6506
52,52694,2010-12-31,870,5685,6555
52,52694,2011-12-31,860,5684,6544
52,52694,2012-12-31,827,5723,6550
52,52694,2013-12-31,833,5786,6619
52,52694,2014-12-31,809,5838,6647
52,52694,2015-12-31,822,5874,6696
52,52694,2016-12-31,825,5882,6707
52,52694,2017-12-31,839,5976,6815
52,52694,2018-12-31,849,5994,6843
52,52694,2019-12-31,836,5995,6831
52,52694,2020-12-31,823,5997,6820
52,52694,2021-12-31,820,5998,6818
52,52694,2022-12-31,826,6000,6826
52,52694,2023-12-31,832,6002,6834
52,52694,2024-12-31,822,6003,6825
52,52694,2025-12-31,827,6013,6840
52,52694,2026-12-31,826,6012,6838
52,52694,2027-12-31,832,6027,6859
52,52694,2028-12-31,843,6038,6881
52,52694,2029-12-31,855,6058,6913
52,52694,2030-12-31,848,6076,6924
52,52694,2031-12-31,853,6083,6936
52,52694,2032-12-31,854,6091,6945
52,52694,2033-12-31,855,6122,6977
52,52694,2034-12-31,859,6148,7007
52,52694,2035-12-31,861,6143,7004
52,52696,1985-12-31,1615,6592,8207
52,52696,1986-12-31,1691,6610,8301
52,52696,1987-12-31,1772,6638,8410
52,52696,1988-12-31,1840,6667,8507
52,52696,1989-12-31,1911,6737,8648
52,52696,1990-12-31,1959,6901,8860
52,52696,1991-12-31,2018,7060,9078
52,52696,1992-12-31,2090,7176,9266
52,52696,1993-12-31,2136,7431,9567
52,52696,1994-12-31,2213,7493,9706
52,52696,1995-12-31,2270,7578,9848
52,52696,1996-12-31,2356,7659,10015
52,52696,1997-12-31,2421,7741,10162
52,52696,1998-12-31,2499,7831,10330
52,52696,1999-12-31,2575,7925,10500
52,52696,2000-12-31,2633,8003,10636
52,52696,2001-12-31,2750,8093,10843
52,52696,2002-12-31,2776,8228,11004
52,52696,2003-12-31,2854,8347,11201
52,52696,2004-12-31,2909,8463,11372
52,52696,2005-12-31,2974,8577,11551
52,52696,2006-12-31,3045,8717,11762
52,52696,2007-12-31,3082,8851,11933
52,52696,2008-12-31,3148,8952,12100
52,52696,2009-12-31,3248,9040,12288
52,52696,2010-12-31,3281,9126,12407
52,52696,2011-12-31,3330,9236,12566
52,52696,2012-12-31,3369,9320,12689
52,52696,2013-12-31,3389,9400,12789
52,52696,2014-12-31,3453,9476,12929
52,52696,2015-12-31,3499,9584,13083
52,52696,2016-12-31,3532,9686,13218
52,52696,2017-12-31,3569,9749,13318
52,52696,2018-12-31,3608,9819,13427
52,52696,2019-12-31,3576,9755,13331
52,52696,2020-12-31,3545,9697,13242
52,52696,2021-12-31,3543,9696,13239
52,52696,2022-12-31,3553,9700,13253
52,52696,2023-12-31,3566,9703,13269
52,52696,2024-12-31,3582,9717,13299
52,52696,2025-12-31,3596,9731,13327
52,52696,2026-12-31,3597,9748,13345
52,52696,2027-12-31,3627,9766,13393
52,52696,2028-12-31,3630,9790,13420
52,52696,2029-12-31,3647,9824,13471
52,52696,2030-12-31,3659,9856,13515
52,52696,2031-12-31,3685,9873,13558
52,52696,2032-12-31,3679,9925,13604
52,52696,2033-12-31,3699,9947,13646
52,52696,2034-12-31,3705,9976,13681
52,52696,2035-12-31,3727,10011,13738
52,52699,1985-12-31,1180,7085,8265
52,52699,1986-12-31,1174,7070,8244
52,52699,1987-12-31,1191,7052,8243
52,52699,1988-12-31,1211,7048,8259
52,52699,1989-12-31,1209,7084,8293
52,52699,1990-12-31,1213,7213,8426
52,52699,1991-12-31,1218,7362,8580
52,52699,1992-12-31,1235,7409,8644
52,52699,1993-12-31,1260,7666,8926
52,52699,1994-12-31,1271,7686,8957
52,52699,1995-12-31,1282,7745,9027
52,52699,1996-12-31,1310,7787,9097
52,52699,1997-12-31,1310,7851,9161
52,52699,1998-12-31,1331,7899,9230
52,52699,1999-12-31,1352,7970,9322
52,52699,2000-12-31,1390,8013,9403
52,52699,2001-12-31,1436,8079,9515
52,52699,2002-12-31,1452,8179,9631
52,52699,2003-12-31,1441,8262,9703
52,52699,2004-12-31,1469,8346,9815
52,52699,2005-12-31,1480,8450,9930
52,52699,2006-12-31,1503,8539,10042
52,52699,2007-12-31,1513,8613,10126
52,52699,2008-12-31,1515,8687,10202
52,52699,2009-12-31,1526,8778,10304
52,52699,2010-12-31,1485,8848,10333
52,52699,2011-12-31,1484,8899,10383
52,52699,2012-12-31,1488,8966,10454
52,52699,2013-12-31,1486,9018,10504
52,52699,2014-12-31,1470,9042,10512
52,52699,2015-12-31,1490,9096,10586
52,52699,2016-12-31,1511,9178,10689
52,52699,2017-12-31,1540,9202,10742
52,52699,2018-12-31,1529,9267,10796
52,52699,2019-12-31,1526,9413,10939
52,52699,2020-12-31,1524,9550,11074
52,52699,2021-12-31,1523,9551,11074
52,52699,2022-12-31,1531,9555,11086
52,52699,2023-12-31,1541,9558,11099
52,52699,2024-12-31,1543,9556,11099
52,52699,2025-12-31,1553,9564,11117
52,52699,2026-12-31,1556,9578,11134
52,52699,2027-12-31,1561,9606,11167
52,52699,2028-12-31,1560,9624,11184
52,52699,2029-12-31,1568,9648,11216
52,52699,2030-12-31,1566,9667,11233
52,52699,2031-12-31,1573,9696,11269
52,52699,2032-12-31,1584,9716,11300
52,52699,2033-12-31,1599,9752,11351
52,52699,2034-12-31,1605,9777,11382
52,52699,2035-12-31,1608,9782,11390
52,52720,1985-12-31,1780,5417,7197
52,52720,1986-12-31,1779,5355,7134
52,52720,1987-12-31,1770,5307,7077
52,52720,1988-12-31,1762,5281,7043
52,52720,1989-12-31,1771,5266,7037
52,52720,1990-12-31,1748,5338,7086
52,52720,1991-12-31,1729,5394,7123
52,52720,1992-12-31,1718,5410,7128
52,52720,1993-12-31,1683,5556,7239
52,52720,1994-12-31,1694,5544,7238
52,52720,1995-12-31,1689,5535,7224
52,52720,1996-12-31,1695,5545,7240
52,52720,1997-12-31,1678,5555,7233
52,52720,1998-12-31,1679,5554,7233
52,52720,1999-12-31,1657,5579,7236
52,52720,2000-12-31,1669,5586,7255
52,52720,2001-12-31,1674,5598,7272
52,52720,2002-12-31,1710,5630,7340
52,52720,2003-12-31,1660,5674,7334
52,52720,2004-12-31,1646,5699,7345
52,52720,2005-12-31,1669,5742,7411
52,52720,2006-12-31,1626,5767,7393
52,52720,2007-12-31,1604,5798,7402
52,52720,2008-12-31,1583,5815,7398
52,52720,2009-12-31,1560,5826,7386
52,52720,2010-12-31,1536,5844,7380
52,52720,2011-12-31,1501,5824,7325
52,52720,2012-12-31,1448,5863,7311
52,52720,2013-12-31,1429,5867,7296
52,52720,2014-12-31,1427,5877,7304
52,52720,2015-12-31,1431,5922,7353
52,52720,2016-12-31,1427,5883,7310
52,52720,2017-12-31,1428,5889,7317
52,52720,2018-12-31,1436,5910,7346
52,52720,2019-12-31,1411,5866,7277
52,52720,2020-12-31,1395,5837,7232
52,52720,2021-12-31,1393,5837,7230
52,52720,2022-12-31,1399,5839,7238
52,52720,2023-12-31,1406,5841,7247
52,52720,2024-12-31,1410,5845,7255
52,52720,2025-12-31,1412,5844,7256
52,52720,2026-12-31,1407,5867,7274
52,52720,2027-12-31,1431,5868,7299
52,52720,2028-12-31,1435,5878,7313
52,52720,2029-12-31,1444,5880,7324
52,52720,2030-12-31,1440,5905,7345
52,52720,2031-12-31,1443,5916,7359
52,52720,2032-12-31,1457,5935,7392
52,52720,2033-12-31,1462,5950,7412
52,52720,2034-12-31,1463,5954,7417
52,52720,2035-12-31,1457,5976,7433
52,52786,1985-12-31,3189,15444,18633
52,52786,1986-12-31,3226,15196,18422
52,52786,1987-12-31,3259,14977,18236
52,52786,1988-12-31,3330,14781,18111
52,52786,1989-12-31,3364,14656,18020
52,52786,1990-12-31,3365,14736,18101
52,52786,1991-12-31,3395,14783,18178
52,52786,1992-12-31,3433,14756,18189
52,52786,1993-12-31,3435,15073,18508
52,52786,1994-12-31,3489,14931,18420
52,52786,1995-12-31,3511,14834,18345
52,52786,1996-12-31,3555,14763,18318
52,52786,1997-12-31,3591,14687,18278
52,52786,1998-12-31,3627,14619,18246
52,52786,1999-12-31,3676,14573,18249
52,52786,2000-12-31,3694,14515,18209
52,52786,2001-12-31,3750,14449,18199
52,52786,2002-12-31,3767,14436,18203
52,52786,2003-12-31,3799,14471,18270
52,52786,2004-12-31,3827,14462,18289
52,52786,2005-12-31,3851,14446,18297
52,52786,2006-12-31,3888,14446,18334
52,52786,2007-12-31,3881,14417,18298
52,52786,2008-12-31,3890,14388,18278
52,52786,2009-12-31,3930,14365,18295
52,52786,2010-12-31,3963,14311,18274
52,52786,2011-12-31,3982,14314,18296
52,52786,2012-12-31,3992,14205,18197
52,52786,2013-12-31,4013,14106,18119
52,52786,2014-12-31,4038,14089,18127
52,52786,2015-12-31,4044,13997,18041
52,52786,2016-12-31,4006,13949,17955
52,52786,2017-12-31,3964,13893,17857
52,52786,2018-12-31,3999,13855,17854
52,52786,2019-12-31,3992,13874,17866
52,52786,2020-12-31,3986,13892,17878
52,52786,2021-12-31,3983,13894,17877
52,52786,2022-12-31,3998,13899,17897
52,52786,2023-12-31,4014,13904,17918
52,52786,2024-12-31,4028,13918,17946
52,52786,2025-12-31,4031,13926,17957
52,52786,2026-12-31,4049,13938,17987
52,52786,2027-12-31,4062,13954,18016
52,52786,2028-12-31,4078,13984,18062
52,52786,2029-12-31,4095,14002,18097
52,52786,2030-12-31,4103,14039,18142
52,52786,2031-12-31,4115,14076,18191
52,52786,2032-12-31,4129,14119,18248
52,52786,2033-12-31,4143,14143,18286
52,52786,2034-12-31,4161,14157,18318
52,52786,2035-12-31,4167,14178,18345
52,52788,1985-12-31,2396,9261,11657
52,52788,1986-12-31,2403,9205,11608
52,52788,1987-12-31,2411,9132,11543
52,52788,1988-12-31,2451,9087,11538
52,52788,1989-12-31,2478,9082,11560
52,52788,1990-12-31,2489,9231,11720
52,52788,1991-12-31,2524,9346,11870
52,52788,1992-12-31,2535,9409,11944
52,52788,1993-12-31,2505,9676,12181
52,52788,1994-12-31,2548,9679,12227
52,52788,1995-12-31,2578,9709,12287
52,52788,1996-12-31,2597,9715,12312
52,52788,1997-12-31,2618,9748,12366
52,52788,1998-12-31,2647,9782,12429
52,52788,1999-12-31,2665,9841,12506
52,52788,2000-12-31,2678,9860,12538
52,52788,2001-12-31,2689,9897,12586
52,52788,2002-12-31,2673,9970,12643
52,52788,2003-12-31,2736,10057,12793
52,52788,2004-12-31,2732,10132,12864
52,52788,2005-12-31,2729,10200,12929
52,52788,2006-12-31,2766,10268,13034
52,52788,2007-12-31,2743,10330,13073
52,52788,2008-12-31,2767,10398,13165
52,52788,2009-12-31,2744,10438,13182
52,52788,2010-12-31,2776,10491,13267
52,52788,2011-12-31,2791,10481,13272
52,52788,2012-12-31,2778,10561,13339
52,52788,2013-12-31,2742,10584,13326
52,52788,2014-12-31,2744,10599,13343
52,52788,2015-12-31,2720,10667,13387
52,52788,2016-12-31,2705,10725,13430
52,52788,2017-12-31,2733,10667,13400
52,52788,2018-12-31,2763,10744,13507
52,52788,2019-12-31,2758,10639,13397
52,52788,2020-12-31,2754,10567,13321
52,52788,2021-12-31,2752,10566,13318
52,52788,2022-12-31,2763,10570,13333
52,52788,2023-12-31,2774,10574,13348
52,52788,2024-12-31,2784,10570,13354
52,52788,2025-12-31,2787,10589,13376
52,52788,2026-12-31,2800,10598,13398
52,52788,2027-12-31,2804,10612,13416
52,52788,2028-12-31,2823,10636,13459
52,52788,2029-12-31,2835,10663,13498
52,52788,2030-12-31,2841,10673,13514
52,52788,2031-12-31,2848,10718,13566
52,52788,2032-12-31,2855,10733,13588
52,52788,2033-12-31,2871,10761,13632
52,52788,2034-12-31,2878,10787,13665
52,52788,2035-12-31,2876,10817,13693
52,52835,1985-12-31,52565,55388,107953
52,52835,1986-12-31,54050,58430,112480
52,52835,1987-12-31,55547,61398,116945
52,52835,1988-12-31,57043,64305,121348
52,52835,1989-12-31,58416,67522,125938
52,52835,1990-12-31,59062,71702,130764
52,52835,1991-12-31,59953,75692,135645
52,52835,1992-12-31,61327,79375,140702
52,52835,1993-12-31,61826,84705,146531
52,52835,1994-12-31,63369,87803,151172
52,52835,1995-12-31,64747,91093,155840
52,52835,1996-12-31,66108,94380,160488
52,52835,1997-12-31,67400,97644,165044
52,52835,1998-12-31,68680,100918,169598
52,52835,1999-12-31,69807,104330,174137
52,52835,2000-12-31,71051,107487,178538
52,52835,2001-12-31,72602,110784,183386
52,52835,2002-12-31,73688,114516,188204
52,52835,2003-12-31,74751,118212,192963
52,52835,2004-12-31,75791,121898,197689
52,52835,2005-12-31,76770,125515,202285
52,52835,2006-12-31,77806,129291,207097
52,52835,2007-12-31,78788,132960,211748
52,52835,2008-12-31,79637,136436,216073
52,52835,2009-12-31,80428,139834,220262
52,52835,2010-12-31,81193,143123,224316
52,52835,2011-12-31,81912,146375,228287
52,52835,2012-12-31,82614,149558,232172
52,52835,2013-12-31,83264,152580,235844
52,52835,2014-12-31,83855,155559,239414
52,52835,2015-12-31,84450,158550,243000
52,52835,2016-12-31,85085,161497,246582
52,52835,2017-12-31,85638,164345,249983
52,52835,2018-12-31,86320,167317,253637
52,52835,2019-12-31,86507,169276,255783
52,52835,2020-12-31,86614,170438,257052
52,52835,2021-12-31,86585,170457,257042
52,52835,2022-12-31,86802,170524,257326
52,52835,2023-12-31,87047,170584,257631
52,52835,2024-12-31,87331,170758,258089
52,52835,2025-12-31,87634,171040,258674
52,52835,2026-12-31,87922,171360,259282
52,52835,2027-12-31,88225,171753,259978
52,52835,2028-12-31,88556,172196,260752
52,52835,2029-12-31,88901,172723,261624
52,52835,2030-12-31,89262,173279,262541
52,52835,2031-12-31,89599,173886,263485
52,52835,2032-12-31,89930,174459,264389
52,52835,2033-12-31,90251,175000,265251
52,52835,2034-12-31,90553,175536,266089
52,52835,2035-12-31,90841,176024,266865
52,52838,1985-12-31,13489,28143,41632
52,52838,1986-12-31,13704,29008,42712
52,52838,1987-12-31,13924,29867,43791
52,52838,1988-12-31,14170,30698,44868
52,52838,1989-12-31,14335,31698,46033
52,52838,1990-12-31,14360,33162,47522
52,52838,1991-12-31,14442,34529,48971
52,52838,1992-12-31,14612,35727,50339
52,52838,1993-12-31,14565,23683,38248
52,52838,1994-12-31,14820,23749,38569
52,52838,1995-12-31,15032,23842,38874
52,52838,1996-12-31,15224,23943,39167
52,52838,1997-12-31,15377,24066,39443
52,52838,1998-12-31,15554,24171,39725
52,52838,1999-12-31,15665,24336,40001
52,52838,2000-12-31,15834,24453,40287
52,52838,2001-12-31,16044,24599,40643
52,52838,2002-12-31,16171,24850,41021
52,52838,2003-12-31,16289,25070,41359
52,52838,2004-12-31,16415,25304,41719
52,52838,2005-12-31,16529,25529,42058
52,52838,2006-12-31,16636,25747,42383
52,52838,2007-12-31,16737,25961,42698
52,52838,2008-12-31,16812,26143,42955
52,52838,2009-12-31,16895,26304,43199
52,52838,2010-12-31,16963,26462,43425
52,52838,2011-12-31,17019,26611,43630
52,52838,2012-12-31,17064,26740,43804
52,52838,2013-12-31,17124,26851,43975
52,52838,2014-12-31,17158,26967,44125
52,52838,2015-12-31,17212,27112,44324
52,52838,2016-12-31,17242,27218,44460
52,52838,2017-12-31,17324,27325,44649
52,52838,2018-12-31,17302,27427,44729
52,52838,2019-12-31,17259,27391,44650
52,52838,2020-12-31,17215,27360,44575
52,52838,2021-12-31,17207,27358,44565
52,52838,2022-12-31,17246,27368,44614
52,52838,2023-12-31,17289,27378,44667
52,52838,2024-12-31,17337,27420,44757
52,52838,2025-12-31,17391,27411,44802
52,52838,2026-12-31,17451,27460,44911
52,52838,2027-12-31,17502,27501,45003
52,52838,2028-12-31,17576,27550,45126
52,52838,2029-12-31,17635,27603,45238
52,52838,2030-12-31,17694,27691,45385
52,52838,2031-12-31,17757,27759,45516
52,52838,2032-12-31,17816,27837,45653
52,52838,2033-12-31,17878,27909,45787
52,52838,2034-12-31,17915,27968,45883
52,52838,2035-12-31,17977,28043,46020
52,52885,1985-12-31,1858,6926,8784
52,52885,1986-12-31,1842,6876,8718
52,52885,1987-12-31,1956,6788,8744
52,52885,1988-12-31,2004,6739,8743
52,52885,1989-12-31,2070,6745,8815
52,52885,1990-12-31,2109,6827,8936
52,52885,1991-12-31,2149,6896,9045
52,52885,1992-12-31,2215,6921,9136
52,52885,1993-12-31,2212,7117,9329
52,52885,1994-12-31,2276,7104,9380
52,52885,1995-12-31,2349,7130,9479
52,52885,1996-12-31,2412,7132,9544
52,52885,1997-12-31,2465,7135,9600
52,52885,1998-12-31,2520,7136,9656
52,52885,1999-12-31,2581,7164,9745
52,52885,2000-12-31,2637,7170,9807
52,52885,2001-12-31,2687,7176,9863
52,52885,2002-12-31,2739,7239,9978
52,52885,2003-12-31,2787,7283,10070
52,52885,2004-12-31,2826,7315,10141
52,52885,2005-12-31,2885,7357,10242
52,52885,2006-12-31,2921,7402,10323
52,52885,2007-12-31,2952,7432,10384
52,52885,2008-12-31,3005,7449,10454
52,52885,2009-12-31,3024,7489,10513
52,52885,2010-12-31,3093,7518,10611
52,52885,2011-12-31,3152,7542,10694
52,52885,2012-12-31,3203,7554,10757
52,52885,2013-12-31,3199,7537,10736
52,52885,2014-12-31,3253,7563,10816
52,52885,2015-12-31,3315,7585,10900
52,52885,2016-12-31,3284,7646,10930
52,52885,2017-12-31,3293,7594,10887
52,52885,2018-12-31,3326,7612,10938
52,52885,2019-12-31,3326,7620,10946
52,52885,2020-12-31,3324,7631,10955
52,52885,2021-12-31,3323,7632,10955
52,52885,2022-12-31,3332,7635,10967
52,52885,2023-12-31,3342,7638,10980
52,52885,2024-12-31,3350,7650,11000
52,52885,2025-12-31,3363,7658,11021
52,52885,2026-12-31,3367,7656,11023
52,52885,2027-12-31,3383,7674,11057
52,52885,2028-12-31,3394,7699,11093
52,52885,2029-12-31,3407,7716,11123
52,52885,2030-12-31,3422,7735,11157
52,52885,2031-12-31,3437,7754,11191
52,52885,2032-12-31,3447,7772,11219
52,52885,2033-12-31,3464,7780,11244
52,52885,2034-12-31,3473,7796,11269
52,52885,2035-12-31,3474,7804,11278
54,54001,1985-12-31,348481,24213,372694
54,54001,1986-12-31,360298,24936,385234
54,54001,1987-12-31,372932,25535,398467
54,54001,1988-12-31,386526,25992,412518
54,54001,1989-12-31,401080,26208,427288
54,54001,1990-12-31,416430,26349,442779
54,54001,1991-12-31,431263,26500,457763
54,54001,1992-12-31,443418,26991,470409
54,54001,1993-12-31,458080,21638,479718
54,54001,1994-12-31,471623,21660,493283
54,54001,1995-12-31,487280,21363,508643
54,54001,1996-12-31,502179,21101,523280
54,54001,1997-12-31,516100,20917,537017
54,54001,1998-12-31,528911,20803,549714
54,54001,1999-12-31,540801,20767,561568
54,54001,2000-12-31,551679,20775,572454
54,54001,2001-12-31,561675,20863,582538
54,54001,2002-12-31,570820,21003,591823
54,54001,2003-12-31,579418,21162,600580
54,54001,2004-12-31,587350,21390,608740
54,54001,2005-12-31,594886,21625,616511
54,54001,2006-12-31,602281,21903,624184
54,54001,2007-12-31,609232,22187,631419
54,54001,2008-12-31,615558,22477,638035
54,54001,2009-12-31,621436,22776,644212
54,54001,2010-12-31,626912,23078,649990
54,54001,2011-12-31,631814,23347,655161
54,54001,2012-12-31,636255,23631,659886
54,54001,2013-12-31,640509,23902,664411
54,54001,2014-12-31,644348,24159,668507
54,54001,2015-12-31,648331,24446,672777
54,54001,2016-12-31,655204,24826,680030
54,54001,2017-12-31,665332,25367,690699
54,54001,2018-12-31,685445,26270,711715
54,54001,2019-12-31,721436,27761,749197
54,54001,2020-12-31,748948,28158,777106
54,54001,2021-12-31,759395,28496,787891
54,54001,2022-12-31,763436,28550,791986
54,54001,2023-12-31,767000,28608,795608
54,54001,2024-12-31,770590,28714,799304
54,54001,2025-12-31,773978,28859,802837
54,54001,2026-12-31,777252,29074,806326
54,54001,2027-12-31,780462,29338,809800
54,54001,2028-12-31,783607,29664,813271
54,54001,2029-12-31,786667,30055,816722
54,54001,2030-12-31,789648,30522,820170
54,54001,2031-12-31,792544,31020,823564
54,54001,2032-12-31,795177,31525,826702
54,54001,2033-12-31,797574,32024,829598
54,54001,2034-12-31,799755,32535,832290
54,54001,2035-12-31,801763,33053,834816
54,54003,1985-12-31,7615,23590,31205
54,54003,1986-12-31,7901,25984,33885
54,54003,1987-12-31,8201,28207,36408
54,54003,1988-12-31,8522,30247,38769
54,54003,1989-12-31,8857,31924,40781
54,54003,1990-12-31,9224,33430,42654
54,54003,1991-12-31,9585,34877,44462
54,54003,1992-12-31,9882,36704,46586
54,54003,1993-12-31,10218,18334,28552
54,54003,1994-12-31,10568,18050,28618
54,54003,1995-12-31,10955,17562,28517
54,54003,1996-12-31,11288,17133,28421
54,54003,1997-12-31,11630,16762,28392
54,54003,1998-12-31,11937,16436,28373
54,54003,1999-12-31,12229,16190,28419
54,54003,2000-12-31,12501,15977,28478
54,54003,2001-12-31,12745,15837,28582
54,54003,2002-12-31,12971,15724,28695
54,54003,2003-12-31,13201,15639,28840
54,54003,2004-12-31,13404,15583,28987
54,54003,2005-12-31,13596,15545,29141
54,54003,2006-12-31,13774,15540,29314
54,54003,2007-12-31,13958,15528,29486
54,54003,2008-12-31,14131,15507,29638
54,54003,2009-12-31,14291,15507,29798
54,54003,2010-12-31,14427,15494,29921
54,54003,2011-12-31,14571,15482,30053
54,54003,2012-12-31,14695,15465,30160
54,54003,2013-12-31,14820,15433,30253
54,54003,2014-12-31,14872,15409,30281
54,54003,2015-12-31,14978,15380,30358
54,54003,2016-12-31,15141,15412,30553
54,54003,2017-12-31,15389,15534,30923
54,54003,2018-12-31,15896,15890,31786
54,54003,2019-12-31,16837,16166,33003
54,54003,2020-12-31,17580,16351,33931
54,54003,2021-12-31,17982,16413,34395
54,54003,2022-12-31,18146,16428,34574
54,54003,2023-12-31,18273,16459,34732
54,54003,2024-12-31,18374,16510,34884
54,54003,2025-12-31,18462,16591,35053
54,54003,2026-12-31,18537,16691,35228
54,54003,2027-12-31,18616,16836,35452
54,54003,2028-12-31,18689,16995,35684
54,54003,2029-12-31,18758,17230,35988
54,54003,2030-12-31,18851,17483,36334
54,54003,2031-12-31,18901,17764,36665
54,54003,2032-12-31,18984,18069,37053
54,54003,2033-12-31,19022,18372,37394
54,54003,2034-12-31,19082,18667,37749
54,54003,2035-12-31,19130,18961,38091
54,54051,1985-12-31,1858,9616,11474
54,54051,1986-12-31,1844,9439,11283
54,54051,1987-12-31,1863,9242,11105
54,54051,1988-12-31,1931,9005,10936
54,54051,1989-12-31,1992,8702,10694
54,54051,1990-12-31,2057,8411,10468
54,54051,1991-12-31,2074,8119,10193
54,54051,1992-12-31,2086,7962,10048
54,54051,1993-12-31,2079,8700,10779
54,54051,1994-12-31,2116,8524,10640
54,54051,1995-12-31,2149,8310,10459
54,54051,1996-12-31,2183,8088,10271
54,54051,1997-12-31,2189,7907,10096
54,54051,1998-12-31,2209,7730,9939
54,54051,1999-12-31,2217,7620,9837
54,54051,2000-12-31,2222,7531,9753
54,54051,2001-12-31,2229,7450,9679
54,54051,2002-12-31,2225,7389,9614
54,54051,2003-12-31,2236,7347,9583
54,54051,2004-12-31,2243,7323,9566
54,54051,2005-12-31,2267,7303,9570
54,54051,2006-12-31,2236,7283,9519
54,54051,2007-12-31,2228,7282,9510
54,54051,2008-12-31,2242,7267,9509
54,54051,2009-12-31,2240,7268,9508
54,54051,2010-12-31,2226,7250,9476
54,54051,2011-12-31,2246,7227,9473
54,54051,2012-12-31,2172,7227,9399
54,54051,2013-12-31,2151,7216,9367
54,54051,2014-12-31,2141,7177,9318
54,54051,2015-12-31,2131,7190,9321
54,54051,2016-12-31,2146,7178,9324
54,54051,2017-12-31,2150,7235,9385
54,54051,2018-12-31,2207,7398,9605
54,54051,2019-12-31,2279,7581,9860
54,54051,2020-12-31,2336,7720,10056
54,54051,2021-12-31,2445,7749,10194
54,54051,2022-12-31,2490,7756,10246
54,54051,2023-12-31,2522,7771,10293
54,54051,2024-12-31,2535,7798,10333
54,54051,2025-12-31,2542,7830,10372
54,54051,2026-12-31,2551,7863,10414
54,54051,2027-12-31,2566,7938,10504
54,54051,2028-12-31,2566,8024,10590
54,54051,2029-12-31,2594,8118,10712
54,54051,2030-12-31,2591,8261,10852
54,54051,2031-12-31,2597,8389,10986
54,54051,2032-12-31,2606,8534,11140
54,54051,2033-12-31,2615,8647,11262
54,54051,2034-12-31,2628,8799,11427
54,54051,2035-12-31,2644,8928,11572
54,54099,1985-12-31,1852,4096,5948
54,54099,1986-12-31,1852,4106,5958
54,54099,1987-12-31,1885,4032,5917
54,54099,1988-12-31,1956,3979,5935
54,54099,1989-12-31,2046,3952,5998
54,54099,1990-12-31,2130,3857,5987
54,54099,1991-12-31,2191,3788,5979
54,54099,1992-12-31,2241,3767,6008
54,54099,1993-12-31,2281,4175,6456
54,54099,1994-12-31,2364,4194,6558
54,54099,1995-12-31,2418,4083,6501
54,54099,1996-12-31,2478,4047,6525
54,54099,1997-12-31,2505,4004,6509
54,54099,1998-12-31,2556,3983,6539
54,54099,1999-12-31,2597,3973,6570
54,54099,2000-12-31,2613,3986,6599
54,54099,2001-12-31,2654,3992,6646
54,54099,2002-12-31,2667,4015,6682
54,54099,2003-12-31,2672,4070,6742
54,54099,2004-12-31,2689,4100,6789
54,54099,2005-12-31,2714,4147,6861
54,54099,2006-12-31,2768,4178,6946
54,54099,2007-12-31,2807,4246,7053
54,54099,2008-12-31,2829,4314,7143
54,54099,2009-12-31,2843,4390,7233
54,54099,2010-12-31,2874,4451,7325
54,54099,2011-12-31,2881,4505,7386
54,54099,2012-12-31,2861,4548,7409
54,54099,2013-12-31,2822,4588,7410
54,54099,2014-12-31,2848,4643,7491
54,54099,2015-12-31,2882,4691,7573
54,54099,2016-12-31,2903,4789,7692
54,54099,2017-12-31,2922,4908,7830
54,54099,2018-12-31,3038,5067,8105
54,54099,2019-12-31,3165,5364,8529
54,54099,2020-12-31,3257,5588,8845
54,54099,2021-12-31,3358,5610,8968
54,54099,2022-12-31,3399,5615,9014
54,54099,2023-12-31,3430,5626,9056
54,54099,2024-12-31,3442,5634,9076
54,54099,2025-12-31,3468,5664,9132
54,54099,2026-12-31,3478,5699,9177
54,54099,2027-12-31,3490,5749,9239
54,54099,2028-12-31,3511,5823,9334
54,54099,2029-12-31,3516,5891,9407
54,54099,2030-12-31,3526,5980,9506
54,54099,2031-12-31,3550,6086,9636
54,54099,2032-12-31,3554,6176,9730
54,54099,2033-12-31,3572,6274,9846
54,54099,2034-12-31,3582,6368,9950
54,54099,2035-12-31,3575,6477,10052
54,54109,1985-12-31,331,5087,5418
54,54109,1986-12-31,335,5033,5368
54,54109,1987-12-31,342,4977,5319
54,54109,1988-12-31,359,4913,5272
54,54109,1989-12-31,375,4812,5187
54,54109,1990-12-31,393,4704,5097
54,54109,1991-12-31,410,4611,5021
54,54109,1992-12-31,423,4565,4988
54,54109,1993-12-31,427,5038,5465
54,54109,1994-12-31,418,5043,5461
54,54109,1995-12-31,407,4953,5360
54,54109,1996-12-31,420,4854,5274
54,54109,1997-12-31,429,4810,5239
54,54109,1998-12-31,442,4763,5205
54,54109,1999-12-31,457,4747,5204
54,54109,2000-12-31,456,4733,5189
54,54109,2001-12-31,464,4741,5205
54,54109,2002-12-31,463,4764,5227
54,54109,2003-12-31,457,4794,5251
54,54109,2004-12-31,459,4839,5298
54,54109,2005-12-31,454,4865,5319
54,54109,2006-12-31,467,4909,5376
54,54109,2007-12-31,456,4972,5428
54,54109,2008-12-31,473,5024,5497
54,54109,2009-12-31,465,5065,5530
54,54109,2010-12-31,486,5134,5620
54,54109,2011-12-31,515,5174,5689
54,54109,2012-12-31,508,5229,5737
54,54109,2013-12-31,498,5275,5773
54,54109,2014-12-31,487,5318,5805
54,54109,2015-12-31,482,5380,5862
54,54109,2016-12-31,477,5455,5932
54,54109,2017-12-31,484,5561,6045
54,54109,2018-12-31,502,5746,6248
54,54109,2019-12-31,522,5950,6472
54,54109,2020-12-31,538,6076,6614
54,54109,2021-12-31,605,6099,6704
54,54109,2022-12-31,634,6105,6739
54,54109,2023-12-31,654,6116,6770
54,54109,2024-12-31,660,6136,6796
54,54109,2025-12-31,662,6165,6827
54,54109,2026-12-31,661,6201,6862
54,54109,2027-12-31,661,6260,6921
54,54109,2028-12-31,658,6329,6987
54,54109,2029-12-31,660,6400,7060
54,54109,2030-12-31,660,6513,7173
54,54109,2031-12-31,667,6613,7280
54,54109,2032-12-31,678,6719,7397
54,54109,2033-12-31,680,6826,7506
54,54109,2034-12-31,679,6936,7615
54,54109,2035-12-31,685,7037,7722
54,54125,1985-12-31,655,3053,3708
54,54125,1986-12-31,642,2992,3634
54,54125,1987-12-31,652,2885,3537
54,54125,1988-12-31,675,2784,3459
54,54125,1989-12-31,679,2740,3419
54,54125,1990-12-31,664,2590,3254
54,54125,1991-12-31,687,2511,3198
54,54125,1992-12-31,702,2435,3137
54,54125,1993-12-31,743,2647,3390
54,54125,1994-12-31,774,2603,3377
54,54125,1995-12-31,778,2510,3288
54,54125,1996-12-31,796,2407,3203
54,54125,1997-12-31,809,2334,3143
54,54125,1998-12-31,817,2288,3105
54,54125,1999-12-31,825,2234,3059
54,54125,2000-12-31,835,2188,3023
54,54125,2001-12-31,873,2143,3016
54,54125,2002-12-31,877,2125,3002
54,54125,2003-12-31,867,2112,2979
54,54125,2004-12-31,873,2074,2947
54,54125,2005-12-31,872,2057,2929
54,54125,2006-12-31,865,2045,2910
54,54125,2007-12-31,865,2020,2885
54,54125,2008-12-31,857,1997,2854
54,54125,2009-12-31,843,2003,2846
54,54125,2010-12-31,839,1982,2821
54,54125,2011-12-31,848,1953,2801
54,54125,2012-12-31,853,1934,2787
54,54125,2013-12-31,858,1902,2760
54,54125,2014-12-31,866,1875,2741
54,54125,2015-12-31,870,1834,2704
54,54125,2016-12-31,877,1828,2705
54,54125,2017-12-31,895,1900,2795
54,54125,2018-12-31,913,1868,2781
54,54125,2019-12-31,955,1900,2855
54,54125,2020-12-31,988,1926,2914
54,54125,2021-12-31,1021,1933,2954
54,54125,2022-12-31,1034,1935,2969
54,54125,2023-12-31,1044,1939,2983
54,54125,2024-12-31,1054,1946,3000
54,54125,2025-12-31,1047,1952,2999
54,54125,2026-12-31,1059,1965,3024
54,54125,2027-12-31,1063,1983,3046
54,54125,2028-12-31,1066,1995,3061
54,54125,2029-12-31,1075,2026,3101
54,54125,2030-12-31,1076,2062,3138
54,54125,2031-12-31,1084,2091,3175
54,54125,2032-12-31,1082,2132,3214
54,54125,2033-12-31,1083,2160,3243
54,54125,2034-12-31,1085,2189,3274
54,54125,2035-12-31,1085,2225,3310
54,54128,1985-12-31,1444,16838,18282
54,54128,1986-12-31,1443,17827,19270
54,54128,1987-12-31,1473,18717,20190
54,54128,1988-12-31,1508,19477,20985
54,54128,1989-12-31,1519,20044,21563
54,54128,1990-12-31,1545,20530,22075
54,54128,1991-12-31,1563,21011,22574
54,54128,1992-12-31,1581,21737,23318
54,54128,1993-12-31,1626,10812,12438
54,54128,1994-12-31,1637,10603,12240
54,54128,1995-12-31,1635,10331,11966
54,54128,1996-12-31,1687,10061,11748
54,54128,1997-12-31,1694,9825,11519
54,54128,1998-12-31,1716,9638,11354
54,54128,1999-12-31,1741,9485,11226
54,54128,2000-12-31,1734,9370,11104
54,54128,2001-12-31,1762,9275,11037
54,54128,2002-12-31,1765,9216,10981
54,54128,2003-12-31,1760,9156,10916
54,54128,2004-12-31,1770,9114,10884
54,54128,2005-12-31,1781,9089,10870
54,54128,2006-12-31,1773,9089,10862
54,54128,2007-12-31,1769,9068,10837
54,54128,2008-12-31,1767,9063,10830
54,54128,2009-12-31,1751,9052,10803
54,54128,2010-12-31,1698,9030,10728
54,54128,2011-12-31,1662,9023,10685
54,54128,2012-12-31,1665,9006,10671
54,54128,2013-12-31,1673,8990,10663
54,54128,2014-12-31,1696,8964,10660
54,54128,2015-12-31,1694,8937,10631
54,54128,2016-12-31,1702,8972,10674
54,54128,2017-12-31,1721,9035,10756
54,54128,2018-12-31,1772,9223,10995
54,54128,2019-12-31,1826,9270,11096
54,54128,2020-12-31,1867,9331,11198
54,54128,2021-12-31,1985,9366,11351
54,54128,2022-12-31,2035,9375,11410
54,54128,2023-12-31,2069,9393,11462
54,54128,2024-12-31,2074,9428,11502
54,54128,2025-12-31,2089,9458,11547
54,54128,2026-12-31,2099,9529,11628
54,54128,2027-12-31,2102,9602,11704
54,54128,2028-12-31,2112,9711,11823
54,54128,2029-12-31,2118,9838,11956
54,54128,2030-12-31,2127,9978,12105
54,54128,2031-12-31,2137,10131,12268
54,54128,2032-12-31,2137,10305,12442
54,54128,2033-12-31,2150,10465,12615
54,54128,2034-12-31,2162,10638,12800
54,54128,2035-12-31,2170,10798,12968
54,54172,1985-12-31,6273,5301,11574
54,54172,1986-12-31,6450,5292,11742
54,54172,1987-12-31,6622,5235,11857
54,54172,1988-12-31,6852,5151,12003
54,54172,1989-12-31,7062,5055,12117
54,54172,1990-12-31,7286,4950,12236
54,54172,1991-12-31,7518,4821,12339
54,54172,1992-12-31,7703,4783,12486
54,54172,1993-12-31,7917,5326,13243
54,54172,1994-12-31,8122,5311,13433
54,54172,1995-12-31,8358,5189,13547
54,54172,1996-12-31,8580,5129,13709
54,54172,1997-12-31,8773,5086,13859
54,54172,1998-12-31,8965,5046,14011
54,54172,1999-12-31,9143,4993,14136
54,54172,2000-12-31,9302,4998,14300
54,54172,2001-12-31,9436,5026,14462
54,54172,2002-12-31,9575,5039,14614
54,54172,2003-12-31,9687,5075,14762
54,54172,2004-12-31,9785,5117,14902
54,54172,2005-12-31,9884,5180,15064
54,54172,2006-12-31,9981,5241,15222
54,54172,2007-12-31,10078,5298,15376
54,54172,2008-12-31,10155,5351,15506
54,54172,2009-12-31,10241,5418,15659
54,54172,2010-12-31,10297,5469,15766
54,54172,2011-12-31,10383,5522,15905
54,54172,2012-12-31,10442,5585,16027
54,54172,2013-12-31,10487,5653,16140
54,54172,2014-12-31,10480,5707,16187
54,54172,2015-12-31,10507,5763,16270
54,54172,2016-12-31,10588,5854,16442
54,54172,2017-12-31,10732,5977,16709
54,54172,2018-12-31,11083,6180,17263
54,54172,2019-12-31,11679,6497,18176
54,54172,2020-12-31,12133,6725,18858
54,54172,2021-12-31,12368,6752,19120
54,54172,2022-12-31,12461,6758,19219
54,54172,2023-12-31,12536,6771,19307
54,54172,2024-12-31,12594,6790,19384
54,54172,2025-12-31,12644,6816,19460
54,54172,2026-12-31,12697,6872,19569
54,54172,2027-12-31,12760,6929,19689
54,54172,2028-12-31,12799,7004,19803
54,54172,2029-12-31,12851,7098,19949
54,54172,2030-12-31,12908,7193,20101
54,54172,2031-12-31,12952,7329,20281
54,54172,2032-12-31,12988,7430,20418
54,54172,2033-12-31,13033,7574,20607
54,54172,2034-12-31,13072,7690,20762
54,54172,2035-12-31,13093,7807,20900
54,54174,1985-12-31,2555,8412,10967
54,54174,1986-12-31,2620,8301,10921
54,54174,1987-12-31,2679,8128,10807
54,54174,1988-12-31,2808,7954,10762
54,54174,1989-12-31,2894,7718,10612
54,54174,1990-12-31,2959,7458,10417
54,54174,1991-12-31,3030,7227,10257
54,54174,1992-12-31,3090,7110,10200
54,54174,1993-12-31,3165,7797,10962
54,54174,1994-12-31,3236,7676,10912
54,54174,1995-12-31,3320,7476,10796
54,54174,1996-12-31,3413,7312,10725
54,54174,1997-12-31,3512,7170,10682
54,54174,1998-12-31,3589,7057,10646
54,54174,1999-12-31,3642,6975,10617
54,54174,2000-12-31,3707,6905,10612
54,54174,2001-12-31,3759,6859,10618
54,54174,2002-12-31,3791,6825,10616
54,54174,2003-12-31,3805,6807,10612
54,54174,2004-12-31,3850,6802,10652
54,54174,2005-12-31,3885,6806,10691
54,54174,2006-12-31,3932,6816,10748
54,54174,2007-12-31,3968,6833,10801
54,54174,2008-12-31,4005,6849,10854
54,54174,2009-12-31,4047,6862,10909
54,54174,2010-12-31,4087,6874,10961
54,54174,2011-12-31,4105,6892,10997
54,54174,2012-12-31,4130,6915,11045
54,54174,2013-12-31,4071,6905,10976
54,54174,2014-12-31,4059,6916,10975
54,54174,2015-12-31,4126,6947,11073
54,54174,2016-12-31,4130,6963,11093
54,54174,2017-12-31,4172,7046,11218
54,54174,2018-12-31,4331,7233,11564
54,54174,2019-12-31,4528,7514,12042
54,54174,2020-12-31,4677,7717,12394
54,54174,2021-12-31,4816,7748,12564
54,54174,2022-12-31,4874,7755,12629
54,54174,2023-12-31,4917,7770,12687
54,54174,2024-12-31,4934,7798,12732
54,54174,2025-12-31,4962,7840,12802
54,54174,2026-12-31,4978,7899,12877
54,54174,2027-12-31,4995,7956,12951
54,54174,2028-12-31,5027,8043,13070
54,54174,2029-12-31,5046,8147,13193
54,54174,2030-12-31,5053,8262,13315
54,54174,2031-12-31,5086,8406,13492
54,54174,2032-12-31,5097,8549,13646
54,54174,2033-12-31,5112,8674,13786
54,54174,2034-12-31,5133,8801,13934
54,54174,2035-12-31,5139,8948,14087
54,54206,1985-12-31,6559,12335,18894
54,54206,1986-12-31,6624,12179,18803
54,54206,1987-12-31,6702,11968,18670
54,54206,1988-12-31,6763,11682,18445
54,54206,1989-12-31,6860,11363,18223
54,54206,1990-12-31,6961,10998,17959
54,54206,1991-12-31,7068,10684,17752
54,54206,1992-12-31,7120,10524,17644
54,54206,1993-12-31,7180,11507,18687
54,54206,1994-12-31,7274,11341,18615
54,54206,1995-12-31,7386,11108,18494
54,54206,1996-12-31,7411,10854,18265
54,54206,1997-12-31,7509,10655,18164
54,54206,1998-12-31,7563,10495,18058
54,54206,1999-12-31,7601,10386,17987
54,54206,2000-12-31,7621,10290,17911
54,54206,2001-12-31,7634,10229,17863
54,54206,2002-12-31,7637,10209,17846
54,54206,2003-12-31,7637,10188,17825
54,54206,2004-12-31,7615,10197,17812
54,54206,2005-12-31,7613,10222,17835
54,54206,2006-12-31,7600,10252,17852
54,54206,2007-12-31,7567,10288,17855
54,54206,2008-12-31,7542,10328,17870
54,54206,2009-12-31,7502,10368,17870
54,54206,2010-12-31,7496,10409,17905
54,54206,2011-12-31,7447,10445,17892
54,54206,2012-12-31,7398,10465,17863
54,54206,2013-12-31,7382,10495,17877
54,54206,2014-12-31,7293,10516,17809
54,54206,2015-12-31,7228,10546,17774
54,54206,2016-12-31,7228,10626,17854
54,54206,2017-12-31,7254,10745,17999
54,54206,2018-12-31,7417,11046,18463
54,54206,2019-12-31,7648,11483,19131
54,54206,2020-12-31,7833,11814,19647
54,54206,2021-12-31,8055,11861,19916
54,54206,2022-12-31,8147,11872,20019
54,54206,2023-12-31,8216,11895,20111
54,54206,2024-12-31,8254,11933,20187
54,54206,2025-12-31,8289,11987,20276
54,54206,2026-12-31,8325,12067,20392
54,54206,2027-12-31,8363,12169,20532
54,54206,2028-12-31,8395,12295,20690
54,54206,2029-12-31,8432,12462,20894
54,54206,2030-12-31,8457,12656,21113
54,54206,2031-12-31,8487,12858,21345
54,54206,2032-12-31,8509,13074,21583
54,54206,2033-12-31,8555,13291,21846
54,54206,2034-12-31,8575,13491,22066
54,54206,2035-12-31,8585,13711,22296
54,54223,1985-12-31,1319,8799,10118
54,54223,1986-12-31,1332,8614,9946
54,54223,1987-12-31,1337,8447,9784
54,54223,1988-12-31,1337,8233,9570
54,54223,1989-12-31,1360,7965,9325
54,54223,1990-12-31,1432,7670,9102
54,54223,1991-12-31,1407,7407,8814
54,54223,1992-12-31,1444,7246,8690
54,54223,1993-12-31,1478,7946,9424
54,54223,1994-12-31,1443,7771,9214
54,54223,1995-12-31,1458,7533,8991
54,54223,1996-12-31,1453,7339,8792
54,54223,1997-12-31,1463,7174,8637
54,54223,1998-12-31,1476,7019,8495
54,54223,1999-12-31,1492,6908,8400
54,54223,2000-12-31,1528,6814,8342
54,54223,2001-12-31,1524,6740,8264
54,54223,2002-12-31,1507,6656,8163
54,54223,2003-12-31,1507,6664,8171
54,54223,2004-12-31,1509,6605,8114
54,54223,2005-12-31,1509,6582,8091
54,54223,2006-12-31,1510,6584,8094
54,54223,2007-12-31,1520,6558,8078
54,54223,2008-12-31,1502,6533,8035
54,54223,2009-12-31,1474,6534,8008
54,54223,2010-12-31,1442,6526,7968
54,54223,2011-12-31,1419,6512,7931
54,54223,2012-12-31,1432,6484,7916
54,54223,2013-12-31,1432,6458,7890
54,54223,2014-12-31,1445,6436,7881
54,54223,2015-12-31,1471,6417,7888
54,54223,2016-12-31,1449,6424,7873
54,54223,2017-12-31,1462,6461,7923
54,54223,2018-12-31,1502,6593,8095
54,54223,2019-12-31,1541,6766,8307
54,54223,2020-12-31,1571,6904,8475
54,54223,2021-12-31,1661,6930,8591
54,54223,2022-12-31,1699,6937,8636
54,54223,2023-12-31,1725,6950,8675
54,54223,2024-12-31,1737,6973,8710
54,54223,2025-12-31,1741,7003,8744
54,54223,2026-12-31,1747,7040,8787
54,54223,2027-12-31,1757,7111,8868
54,54223,2028-12-31,1755,7185,8940
54,54223,2029-12-31,1769,7285,9054
54,54223,2030-12-31,1784,7392,9176
54,54223,2031-12-31,1780,7500,9280
54,54223,2032-12-31,1783,7622,9405
54,54223,2033-12-31,1799,7744,9543
54,54223,2034-12-31,1799,7871,9670
54,54223,2035-12-31,1804,7976,9780
54,54239,1985-12-31,1849,3207,5056
54,54239,1986-12-31,1902,3152,5054
54,54239,1987-12-31,1958,3070,5028
54,54239,1988-12-31,1973,2948,4921
54,54239,1989-12-31,2008,2898,4906
54,54239,1990-12-31,2034,2788,4822
54,54239,1991-12-31,2058,2664,4722
54,54239,1992-12-31,2084,2619,4703
54,54239,1993-12-31,2119,2890,5009
54,54239,1994-12-31,2132,2800,4932
54,54239,1995-12-31,2156,2698,4854
54,54239,1996-12-31,2198,2658,4856
54,54239,1997-12-31,2196,2580,4776
54,54239,1998-12-31,2251,2522,4773
54,54239,1999-12-31,2257,2486,4743
54,54239,2000-12-31,2265,2452,4717
54,54239,2001-12-31,2289,2411,4700
54,54239,2002-12-31,2255,2400,4655
54,54239,2003-12-31,2227,2382,4609
54,54239,2004-12-31,2236,2371,4607
54,54239,2005-12-31,2238,2365,4603
54,54239,2006-12-31,2219,2354,4573
54,54239,2007-12-31,2214,2332,4546
54,54239,2008-12-31,2205,2322,4527
54,54239,2009-12-31,2201,2307,4508
54,54239,2010-12-31,2191,2312,4503
54,54239,2011-12-31,2162,2313,4475
54,54239,2012-12-31,2134,2300,4434
54,54239,2013-12-31,2141,2285,4426
54,54239,2014-12-31,2180,2254,4434
54,54239,2015-12-31,2186,2243,4429
54,54239,2016-12-31,2181,2240,4421
54,54239,2017-12-31,2161,2311,4472
54,54239,2018-12-31,2216,2325,4541
54,54239,2019-12-31,2288,2405,4693
54,54239,2020-12-31,2346,2466,4812
54,54239,2021-12-31,2405,2473,4878
54,54239,2022-12-31,2429,2474,4903
54,54239,2023-12-31,2448,2478,4926
54,54239,2024-12-31,2463,2482,4945
54,54239,2025-12-31,2471,2487,4958
54,54239,2026-12-31,2482,2507,4989
54,54239,2027-12-31,2490,2524,5014
54,54239,2028-12-31,2499,2555,5054
54,54239,2029-12-31,2511,2580,5091
54,54239,2030-12-31,2526,2618,5144
54,54239,2031-12-31,2535,2655,5190
54,54239,2032-12-31,2541,2693,5234
54,54239,2033-12-31,2553,2734,5287
54,54239,2034-12-31,2557,2775,5332
54,54239,2035-12-31,2566,2828,5394
54,54245,1985-12-31,2618,12847,15465
54,54245,1986-12-31,2632,12666,15298
54,54245,1987-12-31,2665,12434,15099
54,54245,1988-12-31,2648,12133,14781
54,54245,1989-12-31,2646,11781,14427
54,54245,1990-12-31,2660,11416,14076
54,54245,1991-12-31,2689,11069,13758
54,54245,1992-12-31,2683,10867,13550
54,54245,1993-12-31,2696,11904,14600
54,54245,1994-12-31,2691,11718,14409
54,54245,1995-12-31,2688,11431,14119
54,54245,1996-12-31,2695,11159,13854
54,54245,1997-12-31,2694,10938,13632
54,54245,1998-12-31,2716,10740,13456
54,54245,1999-12-31,2688,10614,13302
54,54245,2000-12-31,2693,10494,13187
54,54245,2001-12-31,2652,10427,13079
54,54245,2002-12-31,2606,10380,12986
54,54245,2003-12-31,2592,10352,12944
54,54245,2004-12-31,2578,10339,12917
54,54245,2005-12-31,2574,10344,12918
54,54245,2006-12-31,2508,10358,12866
54,54245,2007-12-31,2441,10384,12825
54,54245,2008-12-31,2435,10400,12835
54,54245,2009-12-31,2447,10422,12869
54,54245,2010-12-31,2423,10451,12874
54,54245,2011-12-31,2382,10471,12853
54,54245,2012-12-31,2273,10483,12756
54,54245,2013-12-31,2262,10485,12747
54,54245,2014-12-31,2255,10497,12752
54,54245,2015-12-31,2246,10508,12754
54,54245,2016-12-31,2244,10562,12806
54,54245,2017-12-31,2181,10662,12843
54,54245,2018-12-31,2196,10948,13144
54,54245,2019-12-31,2240,11408,13648
54,54245,2020-12-31,2281,11762,14043
54,54245,2021-12-31,2426,11809,14235
54,54245,2022-12-31,2489,11820,14309
54,54245,2023-12-31,2532,11842,14374
54,54245,2024-12-31,2540,11879,14419
54,54245,2025-12-31,2550,11933,14483
54,54245,2026-12-31,2558,12005,14563
54,54245,2027-12-31,2579,12105,14684
54,54245,2028-12-31,2592,12231,14823
54,54245,2029-12-31,2600,12388,14988
54,54245,2030-12-31,2606,12589,15195
54,54245,2031-12-31,2614,12794,15408
54,54245,2032-12-31,2622,13010,15632
54,54245,2033-12-31,2632,13222,15854
54,54245,2034-12-31,2640,13427,16067
54,54245,2035-12-31,2647,13637,16284
54,54250,1985-12-31,0,0,0
54,54250,1986-12-31,0,0,0
54,54250,1987-12-31,0,0,0
54,54250,1988-12-31,0,0,0
54,54250,1989-12-31,0,0,0
54,54250,1990-12-31,0,0,0
54,54250,1991-12-31,1951,6621,8572
54,54250,1992-12-31,2183,6668,8851
54,54250,1993-12-31,2520,7499,10019
54,54250,1994-12-31,2806,7588,10394
54,54250,1995-12-31,3097,7564,10661
54,54250,1996-12-31,3379,7574,10953
54,54250,1997-12-31,3615,7613,11228
54,54250,1998-12-31,3896,7665,11561
54,54250,1999-12-31,4178,7729,11907
54,54250,2000-12-31,4451,7828,12279
54,54250,2001-12-31,4701,7951,12652
54,54250,2002-12-31,4941,8093,13034
54,54250,2003-12-31,5187,8246,13433
54,54250,2004-12-31,5421,8416,13837
54,54250,2005-12-31,5657,8592,14249
54,54250,2006-12-31,5875,8805,14680
54,54250,2007-12-31,6090,9002,15092
54,54250,2008-12-31,6297,9214,15511
54,54250,2009-12-31,6539,9434,15973
54,54250,2010-12-31,6712,9628,16340
54,54250,2011-12-31,6916,9844,16760
54,54250,2012-12-31,7101,10042,17143
54,54250,2013-12-31,7263,10246,17509
54,54250,2014-12-31,7424,10451,17875
54,54250,2015-12-31,7587,10659,18246
54,54250,2016-12-31,7720,10907,18627
54,54250,2017-12-31,7992,11228,19220
54,54250,2018-12-31,8371,11722,20093
54,54250,2019-12-31,9003,12142,21145
54,54250,2020-12-31,9480,12446,21926
54,54250,2021-12-31,9736,12494,22230
54,54250,2022-12-31,9842,12504,22346
54,54250,2023-12-31,9921,12527,22448
54,54250,2024-12-31,9982,12564,22546
54,54250,2025-12-31,10033,12623,22656
54,54250,2026-12-31,10083,12709,22792
54,54250,2027-12-31,10127,12826,22953
54,54250,2028-12-31,10171,12968,23139
54,54250,2029-12-31,10207,13119,23326
54,54250,2030-12-31,10245,13312,23557
54,54250,2031-12-31,10289,13518,23807
54,54250,2032-12-31,10325,13734,24059
54,54250,2033-12-31,10362,13942,24304
54,54250,2034-12-31,10388,14164,24552
54,54250,2035-12-31,10412,14392,24804
54,54261,1985-12-31,6663,6083,12746
54,54261,1986-12-31,6986,6159,13145
54,54261,1987-12-31,7320,6205,13525
54,54261,1988-12-31,7692,6230,13922
54,54261,1989-12-31,8072,6197,14269
54,54261,1990-12-31,8455,6158,14613
54,54261,1991-12-31,8841,6104,14945
54,54261,1992-12-31,9198,6146,15344
54,54261,1993-12-31,9572,6890,16462
54,54261,1994-12-31,9945,6973,16918
54,54261,1995-12-31,10370,6944,17314
54,54261,1996-12-31,10749,6924,17673
54,54261,1997-12-31,11137,6941,18078
54,54261,1998-12-31,11538,6972,18510
54,54261,1999-12-31,11879,7037,18916
54,54261,2000-12-31,12164,7104,19268
54,54261,2001-12-31,12403,7213,19616
54,54261,2002-12-31,12710,7318,20028
54,54261,2003-12-31,12967,7449,20416
54,54261,2004-12-31,13221,7605,20826
54,54261,2005-12-31,13463,7744,21207
54,54261,2006-12-31,13694,7912,21606
54,54261,2007-12-31,13920,8091,22011
54,54261,2008-12-31,14141,8264,22405
54,54261,2009-12-31,14327,8444,22771
54,54261,2010-12-31,14525,8624,23149
54,54261,2011-12-31,14711,8804,23515
54,54261,2012-12-31,14876,8973,23849
54,54261,2013-12-31,15019,9141,24160
54,54261,2014-12-31,15092,9286,24378
54,54261,2015-12-31,15246,9479,24725
54,54261,2016-12-31,15474,9690,25164
54,54261,2017-12-31,15762,9965,25727
54,54261,2018-12-31,16307,10393,26700
54,54261,2019-12-31,17243,10997,28240
54,54261,2020-12-31,17956,11436,29392
54,54261,2021-12-31,18318,11482,29800
54,54261,2022-12-31,18463,11492,29955
54,54261,2023-12-31,18578,11514,30092
54,54261,2024-12-31,18670,11556,30226
54,54261,2025-12-31,18761,11615,30376
54,54261,2026-12-31,18840,11687,30527
54,54261,2027-12-31,18923,11790,30713
54,54261,2028-12-31,18992,11908,30900
54,54261,2029-12-31,19061,12060,31121
54,54261,2030-12-31,19142,12250,31392
54,54261,2031-12-31,19214,12458,31672
54,54261,2032-12-31,19280,12654,31934
54,54261,2033-12-31,19330,12856,32186
54,54261,2034-12-31,19388,13064,32452
54,54261,2035-12-31,19437,13261,32698
54,54313,1985-12-31,2885,5119,8004
54,54313,1986-12-31,2857,5037,7894
54,54313,1987-12-31,2901,4955,7856
54,54313,1988-12-31,2929,4843,7772
54,54313,1989-12-31,2932,4735,7667
54,54313,1990-12-31,2945,4597,7542
54,54313,1991-12-31,2953,4467,7420
54,54313,1992-12-31,2948,4406,7354
54,54313,1993-12-31,2958,4850,7808
54,54313,1994-12-31,2959,4810,7769
54,54313,1995-12-31,2983,4661,7644
54,54313,1996-12-31,2992,4581,7573
54,54313,1997-12-31,2982,4503,7485
54,54313,1998-12-31,2988,4438,7426
54,54313,1999-12-31,2990,4381,7371
54,54313,2000-12-31,2948,4362,7310
54,54313,2001-12-31,2941,4333,7274
54,54313,2002-12-31,2903,4327,7230
54,54313,2003-12-31,2891,4326,7217
54,54313,2004-12-31,2857,4351,7208
54,54313,2005-12-31,2820,4351,7171
54,54313,2006-12-31,2798,4382,7180
54,54313,2007-12-31,2769,4416,7185
54,54313,2008-12-31,2754,4443,7197
54,54313,2009-12-31,2703,4463,7166
54,54313,2010-12-31,2751,4483,7234
54,54313,2011-12-31,2683,4498,7181
54,54313,2012-12-31,2553,4525,7078
54,54313,2013-12-31,2500,4539,7039
54,54313,2014-12-31,2521,4571,7092
54,54313,2015-12-31,2529,4578,7107
54,54313,2016-12-31,2490,4611,7101
54,54313,2017-12-31,2434,4672,7106
54,54313,2018-12-31,2482,4813,7295
54,54313,2019-12-31,2539,4985,7524
54,54313,2020-12-31,2589,5105,7694
54,54313,2021-12-31,2677,5122,7799
54,54313,2022-12-31,2714,5126,7840
54,54313,2023-12-31,2740,5136,7876
54,54313,2024-12-31,2750,5154,7904
54,54313,2025-12-31,2767,5181,7948
54,54313,2026-12-31,2778,5218,7996
54,54313,2027-12-31,2786,5254,8040
54,54313,2028-12-31,2807,5313,8120
54,54313,2029-12-31,2809,5374,8183
54,54313,2030-12-31,2824,5458,8282
54,54313,2031-12-31,2835,5548,8383
54,54313,2032-12-31,2837,5622,8459
54,54313,2033-12-31,2846,5716,8562
54,54313,2034-12-31,2857,5808,8665
54,54313,2035-12-31,2861,5902,8763
54,54344,1985-12-31,791,9714,10505
54,54344,1986-12-31,797,9563,10360
54,54344,1987-12-31,828,9408,10236
54,54344,1988-12-31,826,9194,10020
54,54344,1989-12-31,857,8934,9791
54,54344,1990-12-31,893,8655,9548
54,54344,1991-12-31,931,8402,9333
54,54344,1992-12-31,957,8266,9223
54,54344,1993-12-31,963,9066,10029
54,54344,1994-12-31,980,8914,9894
54,54344,1995-12-31,1033,8723,9756
54,54344,1996-12-31,1061,8523,9584
54,54344,1997-12-31,1102,8376,9478
54,54344,1998-12-31,1119,8239,9358
54,54344,1999-12-31,1117,8167,9284
54,54344,2000-12-31,1134,8084,9218
54,54344,2001-12-31,1148,8037,9185
54,54344,2002-12-31,1173,8017,9190
54,54344,2003-12-31,1180,7999,9179
54,54344,2004-12-31,1202,8001,9203
54,54344,2005-12-31,1208,8024,9232
54,54344,2006-12-31,1220,8030,9250
54,54344,2007-12-31,1248,8065,9313
54,54344,2008-12-31,1268,8104,9372
54,54344,2009-12-31,1269,8129,9398
54,54344,2010-12-31,1261,8160,9421
54,54344,2011-12-31,1247,8203,9450
54,54344,2012-12-31,1245,8213,9458
54,54344,2013-12-31,1253,8238,9491
54,54344,2014-12-31,1264,8252,9516
54,54344,2015-12-31,1264,8276,9540
54,54344,2016-12-31,1276,8333,9609
54,54344,2017-12-31,1298,8428,9726
54,54344,2018-12-31,1339,8659,9998
54,54344,2019-12-31,1403,8939,10342
54,54344,2020-12-31,1452,9151,10603
54,54344,2021-12-31,1564,9184,10748
54,54344,2022-12-31,1612,9192,10804
54,54344,2023-12-31,1643,9210,10853
54,54344,2024-12-31,1642,9237,10879
54,54344,2025-12-31,1654,9281,10935
54,54344,2026-12-31,1657,9339,10996
54,54344,2027-12-31,1670,9414,11084
54,54344,2028-12-31,1687,9524,11211
54,54344,2029-12-31,1681,9648,11329
54,54344,2030-12-31,1684,9803,11487
54,54344,2031-12-31,1691,9969,11660
54,54344,2032-12-31,1701,10134,11835
54,54344,2033-12-31,1701,10296,11997
54,54344,2034-12-31,1704,10456,12160
54,54344,2035-12-31,1708,10636,12344
54,54347,1985-12-31,907,4552,5459
54,54347,1986-12-31,882,4518,5400
54,54347,1987-12-31,896,4485,5381
54,54347,1988-12-31,917,4410,5327
54,54347,1989-12-31,935,4361,5296
54,54347,1990-12-31,920,4251,5171
54,54347,1991-12-31,964,4179,5143
54,54347,1992-12-31,999,4160,5159
54,54347,1993-12-31,1016,4607,5623
54,54347,1994-12-31,1042,4615,5657
54,54347,1995-12-31,1049,4530,5579
54,54347,1996-12-31,1048,4460,5508
54,54347,1997-12-31,1077,4434,5511
54,54347,1998-12-31,1112,4404,5516
54,54347,1999-12-31,1113,4401,5514
54,54347,2000-12-31,1150,4392,5542
54,54347,2001-12-31,1167,4409,5576
54,54347,2002-12-31,1166,4434,5600
54,54347,2003-12-31,1165,4471,5636
54,54347,2004-12-31,1156,4532,5688
54,54347,2005-12-31,1177,4572,5749
54,54347,2006-12-31,1165,4633,5798
54,54347,2007-12-31,1142,4704,5846
54,54347,2008-12-31,1126,4769,5895
54,54347,2009-12-31,1167,4814,5981
54,54347,2010-12-31,1158,4881,6039
54,54347,2011-12-31,1156,4921,6077
54,54347,2012-12-31,1155,4982,6137
54,54347,2013-12-31,1149,5052,6201
54,54347,2014-12-31,1143,5104,6247
54,54347,2015-12-31,1144,5159,6303
54,54347,2016-12-31,1152,5257,6409
54,54347,2017-12-31,1164,5358,6522
54,54347,2018-12-31,1204,5551,6755
54,54347,2019-12-31,1256,5831,7087
54,54347,2020-12-31,1297,6029,7326
54,54347,2021-12-31,1373,6053,7426
54,54347,2022-12-31,1406,6059,7465
54,54347,2023-12-31,1429,6070,7499
54,54347,2024-12-31,1436,6075,7511
54,54347,2025-12-31,1441,6096,7537
54,54347,2026-12-31,1442,6140,7582
54,54347,2027-12-31,1445,6163,7608
54,54347,2028-12-31,1462,6249,7711
54,54347,2029-12-31,1465,6320,7785
54,54347,2030-12-31,1469,6422,7891
54,54347,2031-12-31,1468,6525,7993
54,54347,2032-12-31,1475,6640,8115
54,54347,2033-12-31,1475,6746,8221
54,54347,2034-12-31,1486,6856,8342
54,54347,2035-12-31,1491,6958,8449
54,54377,1985-12-31,1321,6205,7526
54,54377,1986-12-31,1351,6096,7447
54,54377,1987-12-31,1348,5951,7299
54,54377,1988-12-31,1359,5790,7149
54,54377,1989-12-31,1391,5592,6983
54,54377,1990-12-31,1431,5401,6832
54,54377,1991-12-31,1457,5212,6669
54,54377,1992-12-31,1473,5102,6575
54,54377,1993-12-31,1489,5602,7091
54,54377,1994-12-31,1496,5476,6972
54,54377,1995-12-31,1508,5303,6811
54,54377,1996-12-31,1529,5154,6683
54,54377,1997-12-31,1532,5036,6568
54,54377,1998-12-31,1577,4943,6520
54,54377,1999-12-31,1583,4874,6457
54,54377,2000-12-31,1582,4808,6390
54,54377,2001-12-31,1588,4753,6341
54,54377,2002-12-31,1587,4729,6316
54,54377,2003-12-31,1592,4691,6283
54,54377,2004-12-31,1594,4679,6273
54,54377,2005-12-31,1613,4655,6268
54,54377,2006-12-31,1621,4638,6259
54,54377,2007-12-31,1638,4630,6268
54,54377,2008-12-31,1643,4613,6256
54,54377,2009-12-31,1639,4599,6238
54,54377,2010-12-31,1586,4595,6181
54,54377,2011-12-31,1564,4591,6155
54,54377,2012-12-31,1566,4559,6125
54,54377,2013-12-31,1580,4544,6124
54,54377,2014-12-31,1594,4544,6138
54,54377,2015-12-31,1598,4525,6123
54,54377,2016-12-31,1576,4512,6088
54,54377,2017-12-31,1572,4536,6108
54,54377,2018-12-31,1619,4649,6268
54,54377,2019-12-31,1675,4768,6443
54,54377,2020-12-31,1716,4858,6574
54,54377,2021-12-31,1788,4876,6664
54,54377,2022-12-31,1818,4881,6699
54,54377,2023-12-31,1839,4890,6729
54,54377,2024-12-31,1854,4905,6759
54,54377,2025-12-31,1857,4950,6807
54,54377,2026-12-31,1868,4985,6853
54,54377,2027-12-31,1880,5020,6900
54,54377,2028-12-31,1885,5067,6952
54,54377,2029-12-31,1884,5134,7018
54,54377,2030-12-31,1891,5213,7104
54,54377,2031-12-31,1893,5301,7194
54,54377,2032-12-31,1910,5377,7287
54,54377,2033-12-31,1915,5474,7389
54,54377,2034-12-31,1911,5543,7454
54,54377,2035-12-31,1916,5640,7556
54,54385,1985-12-31,0,0,0
54,54385,1986-12-31,0,0,0
54,54385,1987-12-31,0,0,0
54,54385,1988-12-31,0,0,0
54,54385,1989-12-31,0,0,0
54,54385,1990-12-31,0,0,0
54,54385,1991-12-31,0,0,0
54,54385,1992-12-31,0,0,0
54,54385,1993-12-31,332,4488,4820
54,54385,1994-12-31,450,4731,5181
54,54385,1995-12-31,490,4817,5307
54,54385,1996-12-31,540,4902,5442
54,54385,1997-12-31,608,5015,5623
54,54385,1998-12-31,685,5136,5821
54,54385,1999-12-31,740,5274,6014
54,54385,2000-12-31,805,5405,6210
54,54385,2001-12-31,847,5582,6429
54,54385,2002-12-31,907,5762,6669
54,54385,2003-12-31,954,5948,6902
54,54385,2004-12-31,1006,6141,7147
54,54385,2005-12-31,1057,6353,7410
54,54385,2006-12-31,1095,6571,7666
54,54385,2007-12-31,1145,6800,7945
54,54385,2008-12-31,1226,7026,8252
54,54385,2009-12-31,1249,7256,8505
54,54385,2010-12-31,1288,7483,8771
54,54385,2011-12-31,1300,7724,9024
54,54385,2012-12-31,1348,7944,9292
54,54385,2013-12-31,1393,8177,9570
54,54385,2014-12-31,1458,8401,9859
54,54385,2015-12-31,1513,8627,10140
54,54385,2016-12-31,1582,8927,10509
54,54385,2017-12-31,1600,9210,10810
54,54385,2018-12-31,1660,9698,11358
54,54385,2019-12-31,1749,10192,11941
54,54385,2020-12-31,1817,10556,12373
54,54385,2021-12-31,1947,10598,12545
54,54385,2022-12-31,2002,10608,12610
54,54385,2023-12-31,2040,10628,12668
54,54385,2024-12-31,2048,10662,12710
54,54385,2025-12-31,2055,10721,12776
54,54385,2026-12-31,2069,10800,12869
54,54385,2027-12-31,2066,10909,12975
54,54385,2028-12-31,2081,11009,13090
54,54385,2029-12-31,2078,11159,13237
54,54385,2030-12-31,2096,11322,13418
54,54385,2031-12-31,2111,11509,13620
54,54385,2032-12-31,2122,11701,13823
54,54385,2033-12-31,2122,11876,13998
54,54385,2034-12-31,2129,12075,14204
54,54385,2035-12-31,2127,12241,14368
54,54398,1985-12-31,770,7917,8687
54,54398,1986-12-31,746,7790,8536
54,54398,1987-12-31,734,7633,8367
54,54398,1988-12-31,729,7473,8202
54,54398,1989-12-31,765,7245,8010
54,54398,1990-12-31,760,6986,7746
54,54398,1991-12-31,749,6795,7544
54,54398,1992-12-31,766,6663,7429
54,54398,1993-12-31,797,7355,8152
54,54398,1994-12-31,798,7199,7997
54,54398,1995-12-31,819,7017,7836
54,54398,1996-12-31,847,6827,7674
54,54398,1997-12-31,852,6708,7560
54,54398,1998-12-31,878,6618,7496
54,54398,1999-12-31,906,6522,7428
54,54398,2000-12-31,921,6466,7387
54,54398,2001-12-31,927,6413,7340
54,54398,2002-12-31,924,6390,7314
54,54398,2003-12-31,905,6369,7274
54,54398,2004-12-31,912,6355,7267
54,54398,2005-12-31,890,6353,7243
54,54398,2006-12-31,874,6369,7243
54,54398,2007-12-31,827,6379,7206
54,54398,2008-12-31,827,6400,7227
54,54398,2009-12-31,784,6415,7199
54,54398,2010-12-31,785,6416,7201
54,54398,2011-12-31,785,6425,7210
54,54398,2012-12-31,784,6440,7224
54,54398,2013-12-31,791,6445,7236
54,54398,2014-12-31,803,6460,7263
54,54398,2015-12-31,808,6467,7275
54,54398,2016-12-31,812,6491,7303
54,54398,2017-12-31,831,6565,7396
54,54398,2018-12-31,851,6731,7582
54,54398,2019-12-31,873,6948,7821
54,54398,2020-12-31,890,7113,8003
54,54398,2021-12-31,974,7138,8112
54,54398,2022-12-31,1010,7145,8155
54,54398,2023-12-31,1033,7159,8192
54,54398,2024-12-31,1031,7182,8213
54,54398,2025-12-31,1041,7197,8238
54,54398,2026-12-31,1043,7250,8293
54,54398,2027-12-31,1046,7307,8353
54,54398,2028-12-31,1054,7379,8433
54,54398,2029-12-31,1059,7470,8529
54,54398,2030-12-31,1060,7586,8646
54,54398,2031-12-31,1060,7708,8768
54,54398,2032-12-31,1060,7835,8895
54,54398,2033-12-31,1058,7956,9014
54,54398,2034-12-31,1069,8067,9136
54,54398,2035-12-31,1067,8204,9271
54,54405,1985-12-31,13701,1098,14799
54,54405,1986-12-31,15956,1135,17091
54,54405,1987-12-31,18306,1142,19448
54,54405,1988-12-31,20718,1194,21912
54,54405,1989-12-31,23190,1231,24421
54,54405,1990-12-31,25771,1294,27065
54,54405,1991-12-31,28350,1306,29656
54,54405,1992-12-31,30758,1331,32089
54,54405,1993-12-31,33373,1467,34840
54,54405,1994-12-31,35935,1547,37482
54,54405,1995-12-31,38662,1569,40231
54,54405,1996-12-31,41359,1577,42936
54,54405,1997-12-31,43988,1594,45582
54,54405,1998-12-31,46550,1626,48176
54,54405,1999-12-31,49036,1657,50693
54,54405,2000-12-31,51408,1705,53113
54,54405,2001-12-31,53698,1734,55432
54,54405,2002-12-31,55919,1776,57695
54,54405,2003-12-31,58058,1819,59877
54,54405,2004-12-31,60128,1884,62012
54,54405,2005-12-31,62153,1932,64085
54,54405,2006-12-31,64136,1993,66129
54,54405,2007-12-31,66057,2080,68137
54,54405,2008-12-31,67905,2147,70052
54,54405,2009-12-31,69663,2204,71867
54,54405,2010-12-31,71365,2263,73628
54,54405,2011-12-31,72989,2319,75308
54,54405,2012-12-31,74540,2346,76886
54,54405,2013-12-31,76051,2444,78495
54,54405,2014-12-31,77456,2513,79969
54,54405,2015-12-31,78866,2541,81407
54,54405,2016-12-31,80641,2581,83222
54,54405,2017-12-31,82802,2648,85450
54,54405,2018-12-31,86266,2825,89091
54,54405,2019-12-31,91137,2617,93754
54,54405,2020-12-31,94847,2373,97220
54,54405,2021-12-31,96187,2382,98569
54,54405,2022-12-31,96697,2384,99081
54,54405,2023-12-31,97146,2389,99535
54,54405,2024-12-31,97604,2398,100002
54,54405,2025-12-31,98037,2409,100446
54,54405,2026-12-31,98444,2413,100857
54,54405,2027-12-31,98867,2446,101313
54,54405,2028-12-31,99262,2467,101729
54,54405,2029-12-31,99651,2505,102156
54,54405,2030-12-31,100024,2538,102562
54,54405,2031-12-31,100383,2583,102966
54,54405,2032-12-31,100721,2627,103348
54,54405,2033-12-31,101031,2672,103703
54,54405,2034-12-31,101304,2712,104016
54,54405,2035-12-31,101558,2754,104312
54,54418,1985-12-31,1194,2885,4079
54,54418,1986-12-31,1227,2788,4015
54,54418,1987-12-31,1250,2757,4007
54,54418,1988-12-31,1287,2653,3940
54,54418,1989-12-31,1336,2610,3946
54,54418,1990-12-31,1365,2520,3885
54,54418,1991-12-31,1428,2434,3862
54,54418,1992-12-31,1419,2378,3797
54,54418,1993-12-31,1448,2580,4028
54,54418,1994-12-31,1464,2562,4026
54,54418,1995-12-31,1520,2471,3991
54,54418,1996-12-31,1545,2386,3931
54,54418,1997-12-31,1598,2344,3942
54,54418,1998-12-31,1622,2289,3911
54,54418,1999-12-31,1650,2253,3903
54,54418,2000-12-31,1654,2224,3878
54,54418,2001-12-31,1672,2184,3856
54,54418,2002-12-31,1698,2157,3855
54,54418,2003-12-31,1699,2153,3852
54,54418,2004-12-31,1716,2180,3896
54,54418,2005-12-31,1744,2163,3907
54,54418,2006-12-31,1759,2144,3903
54,54418,2007-12-31,1743,2131,3874
54,54418,2008-12-31,1758,2131,3889
54,54418,2009-12-31,1769,2136,3905
54,54418,2010-12-31,1771,2125,3896
54,54418,2011-12-31,1727,2106,3833
54,54418,2012-12-31,1729,2086,3815
54,54418,2013-12-31,1749,2079,3828
54,54418,2014-12-31,1738,2081,3819
54,54418,2015-12-31,1756,2073,3829
54,54418,2016-12-31,1758,2060,3818
54,54418,2017-12-31,1772,2073,3845
54,54418,2018-12-31,1831,2123,3954
54,54418,2019-12-31,1923,2168,4091
54,54418,2020-12-31,1991,2200,4191
54,54418,2021-12-31,2040,2208,4248
54,54418,2022-12-31,2060,2210,4270
54,54418,2023-12-31,2075,2215,4290
54,54418,2024-12-31,2078,2219,4297
54,54418,2025-12-31,2091,2221,4312
54,54418,2026-12-31,2103,2238,4341
54,54418,2027-12-31,2111,2254,4365
54,54418,2028-12-31,2108,2282,4390
54,54418,2029-12-31,2121,2324,4445
54,54418,2030-12-31,2136,2344,4480
54,54418,2031-12-31,2140,2385,4525
54,54418,2032-12-31,2144,2428,4572
54,54418,2033-12-31,2155,2470,4625
54,54418,2034-12-31,2169,2507,4676
54,54418,2035-12-31,2170,2551,4721
54,54480,1985-12-31,523,2912,3435
54,54480,1986-12-31,515,2890,3405
54,54480,1987-12-31,519,2866,3385
54,54480,1988-12-31,524,2817,3341
54,54480,1989-12-31,524,2815,3339
54,54480,1990-12-31,519,2728,3247
54,54480,1991-12-31,522,2665,3187
54,54480,1992-12-31,553,2663,3216
54,54480,1993-12-31,567,2911,3478
54,54480,1994-12-31,571,2921,3492
54,54480,1995-12-31,576,2854,3430
54,54480,1996-12-31,607,2838,3445
54,54480,1997-12-31,639,2782,3421
54,54480,1998-12-31,635,2778,3413
54,54480,1999-12-31,654,2757,3411
54,54480,2000-12-31,671,2742,3413
54,54480,2001-12-31,680,2771,3451
54,54480,2002-12-31,698,2782,3480
54,54480,2003-12-31,687,2797,3484
54,54480,2004-12-31,672,2816,3488
54,54480,2005-12-31,666,2839,3505
54,54480,2006-12-31,681,2881,3562
54,54480,2007-12-31,688,2881,3569
54,54480,2008-12-31,702,2938,3640
54,54480,2009-12-31,713,2954,3667
54,54480,2010-12-31,724,3014,3738
54,54480,2011-12-31,721,3049,3770
54,54480,2012-12-31,728,3051,3779
54,54480,2013-12-31,736,3049,3785
54,54480,2014-12-31,744,3107,3851
54,54480,2015-12-31,748,3178,3926
54,54480,2016-12-31,757,3218,3975
54,54480,2017-12-31,769,3240,4009
54,54480,2018-12-31,796,3367,4163
54,54480,2019-12-31,828,3545,4373
54,54480,2020-12-31,850,3680,4530
54,54480,2021-12-31,898,3695,4593
54,54480,2022-12-31,919,3698,4617
54,54480,2023-12-31,933,3705,4638
54,54480,2024-12-31,936,3711,4647
54,54480,2025-12-31,932,3724,4656
54,54480,2026-12-31,939,3755,4694
54,54480,2027-12-31,947,3787,4734
54,54480,2028-12-31,954,3825,4779
54,54480,2029-12-31,954,3881,4835
54,54480,2030-12-31,957,3934,4891
54,54480,2031-12-31,955,4007,4962
54,54480,2032-12-31,959,4067,5026
54,54480,2033-12-31,963,4134,5097
54,54480,2034-12-31,959,4201,5160
54,54480,2035-12-31,966,4252,5218
54,54498,1985-12-31,51888,16465,68353
54,54498,1986-12-31,53752,16163,69915
54,54498,1987-12-31,55758,15807,71565
54,54498,1988-12-31,57912,15383,73295
54,54498,1989-12-31,60209,14863,75072
54,54498,1990-12-31,62599,14318,76917
54,54498,1991-12-31,64940,13836,78776
54,54498,1992-12-31,66879,13545,80424
54,54498,1993-12-31,69204,14756,83960
54,54498,1994-12-31,71355,14459,85814
54,54498,1995-12-31,73848,14062,87910
54,54498,1996-12-31,76209,13677,89886
54,54498,1997-12-31,78436,13345,91781
54,54498,1998-12-31,80482,13077,93559
54,54498,1999-12-31,82401,12850,95251
54,54498,2000-12-31,84173,12676,96849
54,54498,2001-12-31,85796,12529,98325
54,54498,2002-12-31,87285,12429,99714
54,54498,2003-12-31,88686,12336,101022
54,54498,2004-12-31,90008,12263,102271
54,54498,2005-12-31,91239,12204,103443
54,54498,2006-12-31,92459,12148,104607
54,54498,2007-12-31,93622,12130,105752
54,54498,2008-12-31,94667,12102,106769
54,54498,2009-12-31,95653,12072,107725
54,54498,2010-12-31,96579,12045,108624
54,54498,2011-12-31,97409,11994,109403
54,54498,2012-12-31,98184,11953,110137
54,54498,2013-12-31,98912,11905,110817
54,54498,2014-12-31,99558,11851,111409
54,54498,2015-12-31,100184,11801,111985
54,54498,2016-12-31,101309,11811,113120
54,54498,2017-12-31,102938,11871,114809
54,54498,2018-12-31,106159,12114,118273
54,54498,2019-12-31,111872,12731,124603
54,54498,2020-12-31,116232,13076,129308
54,54498,2021-12-31,117975,13128,131103
54,54498,2022-12-31,118644,13140,131784
54,54498,2023-12-31,119222,13165,132387
54,54498,2024-12-31,119792,13210,133002
54,54498,2025-12-31,120341,13268,133609
54,54498,2026-12-31,120887,13351,134238
54,54498,2027-12-31,121397,13466,134863
54,54498,2028-12-31,121905,13605,135510
54,54498,2029-12-31,122402,13780,136182
54,54498,2030-12-31,122886,13998,136884
54,54498,2031-12-31,123338,14218,137556
54,54498,2032-12-31,123756,14454,138210
54,54498,2033-12-31,124148,14675,138823
54,54498,2034-12-31,124495,14920,139415
54,54498,2035-12-31,124818,15151,139969
54,54518,1985-12-31,34108,5639,39747
54,54518,1986-12-31,34625,5526,40151
54,54518,1987-12-31,35188,5400,40588
54,54518,1988-12-31,35864,5219,41083
54,54518,1989-12-31,36585,5078,41663
54,54518,1990-12-31,37375,4885,42260
54,54518,1991-12-31,38120,4720,42840
54,54518,1992-12-31,38626,4612,43238
54,54518,1993-12-31,39320,5032,44352
54,54518,1994-12-31,39942,4935,44877
54,54518,1995-12-31,40717,4785,45502
54,54518,1996-12-31,41425,4646,46071
54,54518,1997-12-31,42054,4527,46581
54,54518,1998-12-31,42586,4437,47023
54,54518,1999-12-31,43043,4349,47392
54,54518,2000-12-31,43413,4284,47697
54,54518,2001-12-31,43721,4241,47962
54,54518,2002-12-31,43980,4189,48169
54,54518,2003-12-31,44166,4153,48319
54,54518,2004-12-31,44320,4140,48460
54,54518,2005-12-31,44464,4118,48582
54,54518,2006-12-31,44589,4124,48713
54,54518,2007-12-31,44687,4078,48765
54,54518,2008-12-31,44736,4064,48800
54,54518,2009-12-31,44758,4033,48791
54,54518,2010-12-31,44761,4036,48797
54,54518,2011-12-31,44750,4015,48765
54,54518,2012-12-31,44693,3981,48674
54,54518,2013-12-31,44642,3975,48617
54,54518,2014-12-31,44513,3955,48468
54,54518,2015-12-31,44460,3920,48380
54,54518,2016-12-31,44582,3927,48509
54,54518,2017-12-31,44952,3926,48878
54,54518,2018-12-31,46013,4012,50025
54,54518,2019-12-31,48309,3931,52240
54,54518,2020-12-31,50045,3864,53909
54,54518,2021-12-31,50768,3879,54647
54,54518,2022-12-31,51048,3882,54930
54,54518,2023-12-31,51292,3890,55182
54,54518,2024-12-31,51522,3911,55433
54,54518,2025-12-31,51736,3921,55657
54,54518,2026-12-31,51976,3946,55922
54,54518,2027-12-31,52172,3986,56158
54,54518,2028-12-31,52377,4028,56405
54,54518,2029-12-31,52580,4083,56663
54,54518,2030-12-31,52781,4139,56920
54,54518,2031-12-31,52975,4212,57187
54,54518,2032-12-31,53157,4274,57431
54,54518,2033-12-31,53318,4341,57659
54,54518,2034-12-31,53453,4428,57881
54,54518,2035-12-31,53581,4490,58071
54,54520,1985-12-31,509,4806,5315
54,54520,1986-12-31,523,4779,5302
54,54520,1987-12-31,530,4666,5196
54,54520,1988-12-31,543,4545,5088
54,54520,1989-12-31,572,4458,5030
54,54520,1990-12-31,639,4312,4951
54,54520,1991-12-31,656,4182,4838
54,54520,1992-12-31,665,4102,4767
54,54520,1993-12-31,730,4524,5254
54,54520,1994-12-31,760,4483,5243
54,54520,1995-12-31,785,4340,5125
54,54520,1996-12-31,814,4241,5055
54,54520,1997-12-31,844,4172,5016
54,54520,1998-12-31,843,4119,4962
54,54520,1999-12-31,877,4060,4937
54,54520,2000-12-31,891,4045,4936
54,54520,2001-12-31,897,4026,4923
54,54520,2002-12-31,930,3985,4915
54,54520,2003-12-31,944,3979,4923
54,54520,2004-12-31,957,3980,4937
54,54520,2005-12-31,948,3988,4936
54,54520,2006-12-31,977,4012,4989
54,54520,2007-12-31,973,4027,5000
54,54520,2008-12-31,974,4047,5021
54,54520,2009-12-31,964,4077,5041
54,54520,2010-12-31,975,4080,5055
54,54520,2011-12-31,988,4082,5070
54,54520,2012-12-31,1001,4095,5096
54,54520,2013-12-31,1015,4101,5116
54,54520,2014-12-31,1020,4103,5123
54,54520,2015-12-31,1020,4114,5134
54,54520,2016-12-31,1033,4158,5191
54,54520,2017-12-31,1051,4191,5242
54,54520,2018-12-31,1091,4311,5402
54,54520,2019-12-31,1150,4478,5628
54,54520,2020-12-31,1194,4599,5793
54,54520,2021-12-31,1255,4617,5872
54,54520,2022-12-31,1281,4622,5903
54,54520,2023-12-31,1300,4630,5930
54,54520,2024-12-31,1308,4645,5953
54,54520,2025-12-31,1312,4678,5990
54,54520,2026-12-31,1309,4705,6014
54,54520,2027-12-31,1318,4742,6060
54,54520,2028-12-31,1327,4797,6124
54,54520,2029-12-31,1332,4867,6199
54,54520,2030-12-31,1337,4933,6270
54,54520,2031-12-31,1341,5010,6351
54,54520,2032-12-31,1347,5100,6447
54,54520,2033-12-31,1350,5176,6526
54,54520,2034-12-31,1353,5252,6605
54,54520,2035-12-31,1360,5332,6692
54,54553,1985-12-31,0,0,0
54,54553,1986-12-31,0,0,0
54,54553,1987-12-31,0,0,0
54,54553,1988-12-31,0,0,0
54,54553,1989-12-31,0,0,0
54,54553,1990-12-31,0,0,0
54,54553,1991-12-31,0,0,0
54,54553,1992-12-31,0,0,0
54,54553,1993-12-31,3455,340,3795
54,54553,1994-12-31,3673,311,3984
54,54553,1995-12-31,3933,315,4248
54,54553,1996-12-31,4141,347,4488
54,54553,1997-12-31,4373,353,4726
54,54553,1998-12-31,4598,316,4914
54,54553,1999-12-31,4808,319,5127
54,54553,2000-12-31,5024,381,5405
54,54553,2001-12-31,5227,358,5585
54,54553,2002-12-31,5413,346,5759
54,54553,2003-12-31,5597,345,5942
54,54553,2004-12-31,5756,345,6101
54,54553,2005-12-31,5914,412,6326
54,54553,2006-12-31,6081,429,6510
54,54553,2007-12-31,6253,405,6658
54,54553,2008-12-31,6398,444,6842
54,54553,2009-12-31,6553,456,7009
54,54553,2010-12-31,6679,458,7137
54,54553,2011-12-31,6825,469,7294
54,54553,2012-12-31,6960,467,7427
54,54553,2013-12-31,7102,490,7592
54,54553,2014-12-31,7181,496,7677
54,54553,2015-12-31,7264,509,7773
54,54553,2016-12-31,7438,519,7957
54,54553,2017-12-31,7614,529,8143
54,54553,2018-12-31,7938,564,8502
54,54553,2019-12-31,8355,583,8938
54,54553,2020-12-31,8673,589,9262
54,54553,2021-12-31,8800,591,9391
54,54553,2022-12-31,8847,592,9439
54,54553,2023-12-31,8890,593,9483
54,54553,2024-12-31,8930,582,9512
54,54553,2025-12-31,8976,585,9561
54,54553,2026-12-31,8996,590,9586
54,54553,2027-12-31,9038,599,9637
54,54553,2028-12-31,9070,606,9676
54,54553,2029-12-31,9117,617,9734
54,54553,2030-12-31,9161,626,9787
54,54553,2031-12-31,9191,632,9823
54,54553,2032-12-31,9205,638,9843
54,54553,2033-12-31,9242,656,9898
54,54553,2034-12-31,9278,669,9947
54,54553,2035-12-31,9300,678,9978
54,54599,1985-12-31,2085,3546,5631
54,54599,1986-12-31,2117,3485,5602
54,54599,1987-12-31,2202,3417,5619
54,54599,1988-12-31,2260,3330,5590
54,54599,1989-12-31,2301,3272,5573
54,54599,1990-12-31,2365,3164,5529
54,54599,1991-12-31,2401,3049,5450
54,54599,1992-12-31,2432,3004,5436
54,54599,1993-12-31,2466,3277,5743
54,54599,1994-12-31,2500,3267,5767
54,54599,1995-12-31,2550,3142,5692
54,54599,1996-12-31,2592,3085,5677
54,54599,1997-12-31,2647,3021,5668
54,54599,1998-12-31,2685,2968,5653
54,54599,1999-12-31,2713,2942,5655
54,54599,2000-12-31,2705,2923,5628
54,54599,2001-12-31,2722,2906,5628
54,54599,2002-12-31,2736,2871,5607
54,54599,2003-12-31,2751,2876,5627
54,54599,2004-12-31,2759,2870,5629
54,54599,2005-12-31,2779,2862,5641
54,54599,2006-12-31,2787,2861,5648
54,54599,2007-12-31,2800,2876,5676
54,54599,2008-12-31,2769,2888,5657
54,54599,2009-12-31,2828,2891,5719
54,54599,2010-12-31,2823,2891,5714
54,54599,2011-12-31,2825,2912,5737
54,54599,2012-12-31,2851,2938,5789
54,54599,2013-12-31,2767,2922,5689
54,54599,2014-12-31,2757,2869,5626
54,54599,2015-12-31,2759,2912,5671
54,54599,2016-12-31,2741,2918,5659
54,54599,2017-12-31,2757,2916,5673
54,54599,2018-12-31,2874,3025,5899
54,54599,2019-12-31,2987,3162,6149
54,54599,2020-12-31,3075,3264,6339
54,54599,2021-12-31,3149,3277,6426
54,54599,2022-12-31,3179,3280,6459
54,54599,2023-12-31,3203,3286,6489
54,54599,2024-12-31,3221,3294,6515
54,54599,2025-12-31,3233,3307,6540
54,54599,2026-12-31,3252,3333,6585
54,54599,2027-12-31,3264,3356,6620
54,54599,2028-12-31,3279,3392,6671
54,54599,2029-12-31,3284,3433,6717
54,54599,2030-12-31,3297,3476,6773
54,54599,2031-12-31,3311,3525,6836
54,54599,2032-12-31,3323,3597,6920
54,54599,2033-12-31,3323,3657,6980
54,54599,2034-12-31,3346,3711,7057
54,54599,2035-12-31,3342,3777,7119
54,54660,1985-12-31,3136,9066,12202
54,54660,1986-12-31,3142,8916,12058
54,54660,1987-12-31,3226,8678,11904
54,54660,1988-12-31,3264,8437,11701
54,54660,1989-12-31,3300,8152,11452
54,54660,1990-12-31,3371,7842,11213
54,54660,1991-12-31,3446,7566,11012
54,54660,1992-12-31,3493,7393,10886
54,54660,1993-12-31,3537,8041,11578
54,54660,1994-12-31,3591,7898,11489
54,54660,1995-12-31,3645,7634,11279
54,54660,1996-12-31,3671,7435,11106
54,54660,1997-12-31,3723,7232,10955
54,54660,1998-12-31,3746,7089,10835
54,54660,1999-12-31,3784,6948,10732
54,54660,2000-12-31,3799,6843,10642
54,54660,2001-12-31,3813,6762,10575
54,54660,2002-12-31,3834,6700,10534
54,54660,2003-12-31,3844,6627,10471
54,54660,2004-12-31,3856,6579,10435
54,54660,2005-12-31,3845,6538,10383
54,54660,2006-12-31,3836,6520,10356
54,54660,2007-12-31,3840,6501,10341
54,54660,2008-12-31,3834,6451,10285
54,54660,2009-12-31,3835,6438,10273
54,54660,2010-12-31,3868,6406,10274
54,54660,2011-12-31,3836,6363,10199
54,54660,2012-12-31,3803,6332,10135
54,54660,2013-12-31,3702,6304,10006
54,54660,2014-12-31,3748,6270,10018
54,54660,2015-12-31,3780,6233,10013
54,54660,2016-12-31,3732,6229,9961
54,54660,2017-12-31,3736,6233,9969
54,54660,2018-12-31,3845,6360,10205
54,54660,2019-12-31,3989,6512,10501
54,54660,2020-12-31,4100,6628,10728
54,54660,2021-12-31,4222,6653,10875
54,54660,2022-12-31,4272,6659,10931
54,54660,2023-12-31,4309,6672,10981
54,54660,2024-12-31,4333,6693,11026
54,54660,2025-12-31,4342,6720,11062
54,54660,2026-12-31,4365,6766,11131
54,54660,2027-12-31,4391,6820,11211
54,54660,2028-12-31,4403,6905,11308
54,54660,2029-12-31,4426,6976,11402
54,54660,2030-12-31,4436,7081,11517
54,54660,2031-12-31,4450,7215,11665
54,54660,2032-12-31,4462,7317,11779
54,54660,2033-12-31,4489,7439,11928
54,54660,2034-12-31,4491,7559,12050
54,54660,2035-12-31,4511,7674,12185
54,54670,1985-12-31,1299,22527,23826
54,54670,1986-12-31,1288,21644,22932
54,54670,1987-12-31,1307,20684,21991
54,54670,1988-12-31,1358,19677,21035
54,54670,1989-12-31,1414,18500,19914
54,54670,1990-12-31,1441,17413,18854
54,54670,1991-12-31,1505,8178,9683
54,54670,1992-12-31,1521,8098,9619
54,54670,1993-12-31,1554,8914,10468
54,54670,1994-12-31,1594,8877,10471
54,54670,1995-12-31,1645,8717,10362
54,54670,1996-12-31,1687,8581,10268
54,54670,1997-12-31,1715,8442,10157
54,54670,1998-12-31,1748,8387,10135
54,54670,1999-12-31,1737,8351,10088
54,54670,2000-12-31,1763,8325,10088
54,54670,2001-12-31,1803,8340,10143
54,54670,2002-12-31,1825,8373,10198
54,54670,2003-12-31,1852,8417,10269
54,54670,2004-12-31,1874,8461,10335
54,54670,2005-12-31,1882,8527,10409
54,54670,2006-12-31,1893,8612,10505
54,54670,2007-12-31,1878,8707,10585
54,54670,2008-12-31,1863,8796,10659
54,54670,2009-12-31,1879,8890,10769
54,54670,2010-12-31,1909,8985,10894
54,54670,2011-12-31,1919,9058,10977
54,54670,2012-12-31,1943,9140,11083
54,54670,2013-12-31,1915,9223,11138
54,54670,2014-12-31,1919,9301,11220
54,54670,2015-12-31,1918,9379,11297
54,54670,2016-12-31,1930,9508,11438
54,54670,2017-12-31,1953,9681,11634
54,54670,2018-12-31,2008,10003,12011
54,54670,2019-12-31,2115,10012,12127
54,54670,2020-12-31,2197,9977,12174
54,54670,2021-12-31,2326,10015,12341
54,54670,2022-12-31,2381,10024,12405
54,54670,2023-12-31,2418,10043,12461
54,54670,2024-12-31,2430,10078,12508
54,54670,2025-12-31,2439,10125,12564
54,54670,2026-12-31,2441,10185,12626
54,54670,2027-12-31,2463,10278,12741
54,54670,2028-12-31,2464,10391,12855
54,54670,2029-12-31,2481,10524,13005
54,54670,2030-12-31,2487,10686,13173
54,54670,2031-12-31,2497,10863,13360
54,54670,2032-12-31,2506,11033,13539
54,54670,2033-12-31,2514,11214,13728
54,54670,2034-12-31,2522,11392,13914
54,54670,2035-12-31,2521,11581,14102
54,54673,1985-12-31,1380,1416,2796
54,54673,1986-12-31,1441,1487,2928
54,54673,1987-12-31,1450,1531,2981
54,54673,1988-12-31,1481,1633,3114
54,54673,1989-12-31,1564,1746,3310
54,54673,1990-12-31,1659,1770,3429
54,54673,1991-12-31,1671,1819,3490
54,54673,1992-12-31,1695,1839,3534
54,54673,1993-12-31,1756,2137,3893
54,54673,1994-12-31,1779,2260,4039
54,54673,1995-12-31,1814,2291,4105
54,54673,1996-12-31,1873,2344,4217
54,54673,1997-12-31,1899,2406,4305
54,54673,1998-12-31,1932,2448,4380
54,54673,1999-12-31,1957,2505,4462
54,54673,2000-12-31,1994,2585,4579
54,54673,2001-12-31,1998,2680,4678
54,54673,2002-12-31,2028,2736,4764
54,54673,2003-12-31,2054,2842,4896
54,54673,2004-12-31,2059,2929,4988
54,54673,2005-12-31,2061,3051,5112
54,54673,2006-12-31,2079,3141,5220
54,54673,2007-12-31,2102,3235,5337
54,54673,2008-12-31,2146,3404,5550
54,54673,2009-12-31,2178,3501,5679
54,54673,2010-12-31,2167,3575,5742
54,54673,2011-12-31,2170,3702,5872
54,54673,2012-12-31,2152,3828,5980
54,54673,2013-12-31,2129,3995,6124
54,54673,2014-12-31,2177,4084,6261
54,54673,2015-12-31,2204,4160,6364
54,54673,2016-12-31,2226,4282,6508
54,54673,2017-12-31,2209,4442,6651
54,54673,2018-12-31,2288,4690,6978
54,54673,2019-12-31,2411,5031,7442
54,54673,2020-12-31,2505,5285,7790
54,54673,2021-12-31,2592,5306,7898
54,54673,2022-12-31,2628,5311,7939
54,54673,2023-12-31,2654,5321,7975
54,54673,2024-12-31,2658,5334,7992
54,54673,2025-12-31,2674,5364,8038
54,54673,2026-12-31,2694,5397,8091
54,54673,2027-12-31,2698,5438,8136
54,54673,2028-12-31,2696,5504,8200
54,54673,2029-12-31,2719,5580,8299
54,54673,2030-12-31,2730,5672,8402
54,54673,2031-12-31,2745,5777,8522
54,54673,2032-12-31,2755,5853,8608
54,54673,2033-12-31,2763,5949,8712
54,54673,2034-12-31,2761,6047,8808
54,54673,2035-12-31,2777,6141,8918
54,54680,1985-12-31,698,1990,2688
54,54680,1986-12-31,720,1934,2654
54,54680,1987-12-31,744,1901,2645
54,54680,1988-12-31,802,1852,2654
54,54680,1989-12-31,835,1828,2663
54,54680,1990-12-31,883,1758,2641
54,54680,1991-12-31,934,1726,2660
54,54680,1992-12-31,977,1690,2667
54,54680,1993-12-31,1020,1796,2816
54,54680,1994-12-31,1078,1803,2881
54,54680,1995-12-31,1119,1773,2892
54,54680,1996-12-31,1162,1695,2857
54,54680,1997-12-31,1203,1663,2866
54,54680,1998-12-31,1245,1636,2881
54,54680,1999-12-31,1280,1614,2894
54,54680,2000-12-31,1296,1595,2891
54,54680,2001-12-31,1319,1567,2886
54,54680,2002-12-31,1339,1570,2909
54,54680,2003-12-31,1353,1568,2921
54,54680,2004-12-31,1369,1564,2933
54,54680,2005-12-31,1436,1562,2998
54,54680,2006-12-31,1487,1563,3050
54,54680,2007-12-31,1528,1562,3090
54,54680,2008-12-31,1554,1553,3107
54,54680,2009-12-31,1576,1552,3128
54,54680,2010-12-31,1589,1563,3152
54,54680,2011-12-31,1569,1562,3131
54,54680,2012-12-31,1587,1548,3135
54,54680,2013-12-31,1600,1546,3146
54,54680,2014-12-31,1623,1547,3170
54,54680,2015-12-31,1634,1552,3186
54,54680,2016-12-31,1657,1579,3236
54,54680,2017-12-31,1691,1575,3266
54,54680,2018-12-31,1749,1612,3361
54,54680,2019-12-31,1851,1686,3537
54,54680,2020-12-31,1928,1739,3667
54,54680,2021-12-31,1972,1746,3718
54,54680,2022-12-31,1989,1748,3737
54,54680,2023-12-31,2003,1751,3754
54,54680,2024-12-31,2010,1757,3767
54,54680,2025-12-31,2019,1772,3791
54,54680,2026-12-31,2029,1778,3807
54,54680,2027-12-31,2037,1796,3833
54,54680,2028-12-31,2050,1812,3862
54,54680,2029-12-31,2050,1835,3885
54,54680,2030-12-31,2060,1865,3925
54,54680,2031-12-31,2070,1890,3960
54,54680,2032-12-31,2079,1927,4006
54,54680,2033-12-31,2083,1961,4044
54,54680,2034-12-31,2090,1987,4077
54,54680,2035-12-31,2095,2012,4107
54,54720,1985-12-31,5044,18513,23557
54,54720,1986-12-31,5192,18230,23422
54,54720,1987-12-31,5352,17890,23242
54,54720,1988-12-31,5542,17456,22998
54,54720,1989-12-31,5745,16958,22703
54,54720,1990-12-31,5960,16427,22387
54,54720,1991-12-31,6154,15915,22069
54,54720,1992-12-31,6292,15638,21930
54,54720,1993-12-31,6481,17101,23582
54,54720,1994-12-31,6681,16849,23530
54,54720,1995-12-31,6899,16431,23330
54,54720,1996-12-31,7081,16042,23123
54,54720,1997-12-31,7272,15723,22995
54,54720,1998-12-31,7430,15460,22890
54,54720,1999-12-31,7583,15263,22846
54,54720,2000-12-31,7727,15095,22822
54,54720,2001-12-31,7852,14999,22851
54,54720,2002-12-31,7974,14924,22898
54,54720,2003-12-31,8081,14873,22954
54,54720,2004-12-31,8172,14861,23033
54,54720,2005-12-31,8270,14867,23137
54,54720,2006-12-31,8378,14893,23271
54,54720,2007-12-31,8439,14931,23370
54,54720,2008-12-31,8530,14965,23495
54,54720,2009-12-31,8615,15007,23622
54,54720,2010-12-31,8668,15027,23695
54,54720,2011-12-31,8740,15052,23792
54,54720,2012-12-31,8810,15063,23873
54,54720,2013-12-31,8855,15089,23944
54,54720,2014-12-31,8885,15094,23979
54,54720,2015-12-31,8872,15110,23982
54,54720,2016-12-31,8973,15193,24166
54,54720,2017-12-31,9102,15351,24453
54,54720,2018-12-31,9398,15744,25142
54,54720,2019-12-31,9901,16199,26100
54,54720,2020-12-31,10285,16519,26804
54,54720,2021-12-31,10589,16582,27171
54,54720,2022-12-31,10715,16597,27312
54,54720,2023-12-31,10809,16628,27437
54,54720,2024-12-31,10861,16694,27555
54,54720,2025-12-31,10907,16768,27675
54,54720,2026-12-31,10963,16895,27858
54,54720,2027-12-31,10995,17030,28025
54,54720,2028-12-31,11042,17211,28253
54,54720,2029-12-31,11092,17443,28535
54,54720,2030-12-31,11139,17692,28831
54,54720,2031-12-31,11178,17995,29173
54,54720,2032-12-31,11224,18295,29519
54,54720,2033-12-31,11247,18572,29819
54,54720,2034-12-31,11273,18869,30142
54,54720,2035-12-31,11292,19169,30461
54,54743,1985-12-31,768,5686,6454
54,54743,1986-12-31,776,5616,6392
54,54743,1987-12-31,779,5526,6305
54,54743,1988-12-31,788,5380,6168
54,54743,1989-12-31,791,5245,6036
54,54743,1990-12-31,804,5089,5893
54,54743,1991-12-31,856,4949,5805
54,54743,1992-12-31,881,4878,5759
54,54743,1993-12-31,891,5373,6264
54,54743,1994-12-31,901,5299,6200
54,54743,1995-12-31,917,5171,6088
54,54743,1996-12-31,913,5073,5986
54,54743,1997-12-31,913,4970,5883
54,54743,1998-12-31,923,4920,5843
54,54743,1999-12-31,915,4864,5779
54,54743,2000-12-31,942,4819,5761
54,54743,2001-12-31,931,4797,5728
54,54743,2002-12-31,932,4801,5733
54,54743,2003-12-31,918,4795,5713
54,54743,2004-12-31,918,4800,5718
54,54743,2005-12-31,906,4826,5732
54,54743,2006-12-31,885,4830,5715
54,54743,2007-12-31,858,4873,5731
54,54743,2008-12-31,835,4890,5725
54,54743,2009-12-31,889,4903,5792
54,54743,2010-12-31,893,4941,5834
54,54743,2011-12-31,876,4967,5843
54,54743,2012-12-31,858,4999,5857
54,54743,2013-12-31,854,4986,5840
54,54743,2014-12-31,845,5011,5856
54,54743,2015-12-31,845,5051,5896
54,54743,2016-12-31,844,5069,5913
54,54743,2017-12-31,848,5140,5988
54,54743,2018-12-31,871,5291,6162
54,54743,2019-12-31,898,5482,6380
54,54743,2020-12-31,919,5627,6546
54,54743,2021-12-31,987,5649,6636
54,54743,2022-12-31,1015,5655,6670
54,54743,2023-12-31,1036,5665,6701
54,54743,2024-12-31,1039,5674,6713
54,54743,2025-12-31,1049,5704,6753
54,54743,2026-12-31,1049,5739,6788
54,54743,2027-12-31,1053,5769,6822
54,54743,2028-12-31,1058,5824,6882
54,54743,2029-12-31,1066,5883,6949
54,54743,2030-12-31,1064,5977,7041
54,54743,2031-12-31,1073,6058,7131
54,54743,2032-12-31,1074,6147,7221
54,54743,2033-12-31,1077,6241,7318
54,54743,2034-12-31,1081,6334,7415
54,54743,2035-12-31,1089,6414,7503
54,54800,1985-12-31,1408,14488,15896
54,54800,1986-12-31,1446,14304,15750
54,54800,1987-12-31,1478,14083,15561
54,54800,1988-12-31,1537,13787,15324
54,54800,1989-12-31,1602,13421,15023
54,54800,1990-12-31,1642,13048,14690
54,54800,1991-12-31,1691,12678,14369
54,54800,1992-12-31,1725,12492,14217
54,54800,1993-12-31,1780,13716,15496
54,54800,1994-12-31,1818,13522,15340
54,54800,1995-12-31,1869,13251,15120
54,54800,1996-12-31,1970,12981,14951
54,54800,1997-12-31,2010,12762,14772
54,54800,1998-12-31,2053,12594,14647
54,54800,1999-12-31,2090,12466,14556
54,54800,2000-12-31,2147,12375,14522
54,54800,2001-12-31,2168,12325,14493
54,54800,2002-12-31,2198,12303,14501
54,54800,2003-12-31,2191,12292,14483
54,54800,2004-12-31,2240,12346,14586
54,54800,2005-12-31,2239,12384,14623
54,54800,2006-12-31,2251,12456,14707
54,54800,2007-12-31,2297,12505,14802
54,54800,2008-12-31,2321,12571,14892
54,54800,2009-12-31,2334,12651,14985
54,54800,2010-12-31,2347,12711,15058
54,54800,2011-12-31,2369,12781,15150
54,54800,2012-12-31,2399,12845,15244
54,54800,2013-12-31,2381,12894,15275
54,54800,2014-12-31,2390,12946,15336
54,54800,2015-12-31,2394,13003,15397
54,54800,2016-12-31,2382,13112,15494
54,54800,2017-12-31,2414,13297,15711
54,54800,2018-12-31,2518,13675,16193
54,54800,2019-12-31,2659,14381,17040
54,54800,2020-12-31,2769,14901,17670
54,54800,2021-12-31,2955,14960,17915
54,54800,2022-12-31,3034,14974,18008
54,54800,2023-12-31,3088,15003,18091
54,54800,2024-12-31,3101,15034,18135
54,54800,2025-12-31,3121,15106,18227
54,54800,2026-12-31,3135,15198,18333
54,54800,2027-12-31,3145,15336,18481
54,54800,2028-12-31,3156,15503,18659
54,54800,2029-12-31,3169,15710,18879
54,54800,2030-12-31,3181,15960,19141
54,54800,2031-12-31,3188,16232,19420
54,54800,2032-12-31,3206,16474,19680
54,54800,2033-12-31,3216,16760,19976
54,54800,2034-12-31,3218,17015,20233
54,54800,2035-12-31,3219,17287,20506
54,54810,1985-12-31,9164,25527,34691
54,54810,1986-12-31,9547,25539,35086
54,54810,1987-12-31,9932,25433,35365
54,54810,1988-12-31,10317,25234,35551
54,54810,1989-12-31,10742,24843,35585
54,54810,1990-12-31,11200,24401,35601
54,54810,1991-12-31,11645,24010,35655
54,54810,1992-12-31,12016,23936,35952
54,54810,1993-12-31,12453,26527,38980
54,54810,1994-12-31,12865,26550,39415
54,54810,1995-12-31,13331,26251,39582
54,54810,1996-12-31,13778,25994,39772
54,54810,1997-12-31,14198,25834,40032
54,54810,1998-12-31,14592,25760,40352
54,54810,1999-12-31,14956,25780,40736
54,54810,2000-12-31,15299,25847,41146
54,54810,2001-12-31,15627,26016,41643
54,54810,2002-12-31,15897,26244,42141
54,54810,2003-12-31,16181,26552,42733
54,54810,2004-12-31,16438,26864,43302
54,54810,2005-12-31,16690,27213,43903
54,54810,2006-12-31,16933,27628,44561
54,54810,2007-12-31,17159,28057,45216
54,54810,2008-12-31,17365,28481,45846
54,54810,2009-12-31,17562,28921,46483
54,54810,2010-12-31,17757,29361,47118
54,54810,2011-12-31,17937,29772,47709
54,54810,2012-12-31,18092,30188,48280
54,54810,2013-12-31,18220,30600,48820
54,54810,2014-12-31,18337,31009,49346
54,54810,2015-12-31,18464,31416,49880
54,54810,2016-12-31,18679,31980,50659
54,54810,2017-12-31,18990,32719,51709
54,54810,2018-12-31,19627,33959,53586
54,54810,2019-12-31,20683,35827,56510
54,54810,2020-12-31,21488,37233,58721
54,54810,2021-12-31,22155,37381,59536
54,54810,2022-12-31,22429,37416,59845
54,54810,2023-12-31,22632,37487,60119
54,54810,2024-12-31,22759,37612,60371
54,54810,2025-12-31,22859,37796,60655
54,54810,2026-12-31,22952,38037,60989
54,54810,2027-12-31,23045,38370,61415
54,54810,2028-12-31,23150,38782,61932
54,54810,2029-12-31,23240,39280,62520
54,54810,2030-12-31,23326,39884,63210
54,54810,2031-12-31,23418,40530,63948
54,54810,2032-12-31,23492,41210,64702
54,54810,2033-12-31,23555,41852,65407
54,54810,2034-12-31,23631,42544,66175
54,54810,2035-12-31,23696,43208,66904
54,54820,1985-12-31,3614,13910,17524
54,54820,1986-12-31,3627,13668,17295
54,54820,1987-12-31,3724,13338,17062
54,54820,1988-12-31,3826,12966,16792
54,54820,1989-12-31,3912,12523,16435
54,54820,1990-12-31,3978,12081,16059
54,54820,1991-12-31,4101,11665,15766
54,54820,1992-12-31,4179,11426,15605
54,54820,1993-12-31,4265,12445,16710
54,54820,1994-12-31,4373,12171,16544
54,54820,1995-12-31,4463,11840,16303
54,54820,1996-12-31,4549,11506,16055
54,54820,1997-12-31,4644,11238,15882
54,54820,1998-12-31,4674,11005,15679
54,54820,1999-12-31,4729,10817,15546
54,54820,2000-12-31,4785,10671,15456
54,54820,2001-12-31,4783,10554,15337
54,54820,2002-12-31,4840,10471,15311
54,54820,2003-12-31,4879,10376,15255
54,54820,2004-12-31,4951,10312,15263
54,54820,2005-12-31,4913,10274,15187
54,54820,2006-12-31,4953,10235,15188
54,54820,2007-12-31,4983,10203,15186
54,54820,2008-12-31,5000,10185,15185
54,54820,2009-12-31,5017,10162,15179
54,54820,2010-12-31,5014,10138,15152
54,54820,2011-12-31,5012,10082,15094
54,54820,2012-12-31,5075,10048,15123
54,54820,2013-12-31,5120,9996,15116
54,54820,2014-12-31,5076,9973,15049
54,54820,2015-12-31,5052,9903,14955
54,54820,2016-12-31,5054,9912,14966
54,54820,2017-12-31,5113,9945,15058
54,54820,2018-12-31,5273,10167,15440
54,54820,2019-12-31,5492,10445,15937
54,54820,2020-12-31,5660,10665,16325
54,54820,2021-12-31,5843,10705,16548
54,54820,2022-12-31,5919,10715,16634
54,54820,2023-12-31,5974,10736,16710
54,54820,2024-12-31,6001,10762,16763
54,54820,2025-12-31,6022,10819,16841
54,54820,2026-12-31,6057,10877,16934
54,54820,2027-12-31,6074,10983,17057
54,54820,2028-12-31,6098,11100,17198
54,54820,2029-12-31,6123,11229,17352
54,54820,2030-12-31,6147,11400,17547
54,54820,2031-12-31,6172,11590,17762
54,54820,2032-12-31,6196,11771,17967
54,54820,2033-12-31,6217,11970,18187
54,54820,2034-12-31,6226,12149,18375
54,54820,2035-12-31,6245,12343,18588
54,54871,1985-12-31,1224,4006,5230
54,54871,1986-12-31,1224,3895,5119
54,54871,1987-12-31,1260,3805,5065
54,54871,1988-12-31,1292,3692,4984
54,54871,1989-12-31,1374,3597,4971
54,54871,1990-12-31,1467,3464,4931
54,54871,1991-12-31,1496,3361,4857
54,54871,1992-12-31,1538,3257,4795
54,54871,1993-12-31,1562,3546,5108
54,54871,1994-12-31,1609,3503,5112
54,54871,1995-12-31,1656,3378,5034
54,54871,1996-12-31,1718,3291,5009
54,54871,1997-12-31,1736,3193,4929
54,54871,1998-12-31,1773,3130,4903
54,54871,1999-12-31,1807,3066,4873
54,54871,2000-12-31,1829,3055,4884
54,54871,2001-12-31,1878,3013,4891
54,54871,2002-12-31,1892,2972,4864
54,54871,2003-12-31,1896,2948,4844
54,54871,2004-12-31,1914,2921,4835
54,54871,2005-12-31,1937,2923,4860
54,54871,2006-12-31,1963,2898,4861
54,54871,2007-12-31,1985,2895,4880
54,54871,2008-12-31,2018,2873,4891
54,54871,2009-12-31,2057,2859,4916
54,54871,2010-12-31,2091,2841,4932
54,54871,2011-12-31,2061,2830,4891
54,54871,2012-12-31,2035,2820,4855
54,54871,2013-12-31,2033,2790,4823
54,54871,2014-12-31,2046,2765,4811
54,54871,2015-12-31,2063,2751,4814
54,54871,2016-12-31,2080,2771,4851
54,54871,2017-12-31,2110,2769,4879
54,54871,2018-12-31,2179,2817,4996
54,54871,2019-12-31,2289,2883,5172
54,54871,2020-12-31,2372,2931,5303
54,54871,2021-12-31,2434,2942,5376
54,54871,2022-12-31,2458,2945,5403
54,54871,2023-12-31,2478,2950,5428
54,54871,2024-12-31,2486,2957,5443
54,54871,2025-12-31,2500,2971,5471
54,54871,2026-12-31,2508,2988,5496
54,54871,2027-12-31,2518,3021,5539
54,54871,2028-12-31,2524,3043,5567
54,54871,2029-12-31,2532,3081,5613
54,54871,2030-12-31,2550,3137,5687
54,54871,2031-12-31,2551,3188,5739
54,54871,2032-12-31,2565,3231,5796
54,54871,2033-12-31,2584,3296,5880
54,54871,2034-12-31,2590,3343,5933
54,54871,2035-12-31,2591,3403,5994
54,54874,1985-12-31,58340,3145,61485
54,54874,1986-12-31,59823,3112,62935
54,54874,1987-12-31,61429,3080,64509
54,54874,1988-12-31,63186,3006,66192
54,54874,1989-12-31,65100,2969,68069
54,54874,1990-12-31,67131,2904,70035
54,54874,1991-12-31,69070,2791,71861
54,54874,1992-12-31,70581,2832,73413
54,54874,1993-12-31,72481,3075,75556
54,54874,1994-12-31,74203,3079,77282
54,54874,1995-12-31,76260,2992,79252
54,54874,1996-12-31,78165,2951,81116
54,54874,1997-12-31,79925,2891,82816
54,54874,1998-12-31,81517,2875,84392
54,54874,1999-12-31,82964,2851,85815
54,54874,2000-12-31,84258,2858,87116
54,54874,2001-12-31,85402,2841,88243
54,54874,2002-12-31,86435,2871,89306
54,54874,2003-12-31,87384,2881,90265
54,54874,2004-12-31,88232,2884,91116
54,54874,2005-12-31,89046,2902,91948
54,54874,2006-12-31,89805,2909,92714
54,54874,2007-12-31,90531,2969,93500
54,54874,2008-12-31,91175,2954,94129
54,54874,2009-12-31,91734,2963,94697
54,54874,2010-12-31,92258,2997,95255
54,54874,2011-12-31,92709,3034,95743
54,54874,2012-12-31,93078,3063,96141
54,54874,2013-12-31,93432,3082,96514
54,54874,2014-12-31,93709,3109,96818
54,54874,2015-12-31,94002,3136,97138
54,54874,2016-12-31,94736,3173,97909
54,54874,2017-12-31,95963,3206,99169
54,54874,2018-12-31,98637,3315,101952
54,54874,2019-12-31,103942,3346,107288
54,54874,2020-12-31,107991,3263,111254
54,54874,2021-12-31,109523,3275,112798
54,54874,2022-12-31,110106,3278,113384
54,54874,2023-12-31,110618,3285,113903
54,54874,2024-12-31,111151,3294,114445
54,54874,2025-12-31,111644,3307,114951
54,54874,2026-12-31,112121,3332,115453
54,54874,2027-12-31,112585,3359,115944
54,54874,2028-12-31,113039,3391,116430
54,54874,2029-12-31,113473,3448,116921
54,54874,2030-12-31,113909,3496,117405
54,54874,2031-12-31,114313,3549,117862
54,54874,2032-12-31,114706,3607,118313
54,54874,2033-12-31,115050,3664,118714
54,54874,2034-12-31,115367,3718,119085
54,54874,2035-12-31,115657,3783,119440
63,63001,1985-12-31,216830,7510,224340
63,63001,1986-12-31,218972,7547,226519
63,63001,1987-12-31,221243,7555,228798
63,63001,1988-12-31,223743,7562,231305
63,63001,1989-12-31,226391,7572,233963
63,63001,1990-12-31,229216,7533,236749
63,63001,1991-12-31,232221,7476,239697
63,63001,1992-12-31,235571,7416,242987
63,63001,1993-12-31,239324,7337,246661
63,63001,1994-12-31,243044,7193,250237
63,63001,1995-12-31,246702,7167,253869
63,63001,1996-12-31,250243,7086,257329
63,63001,1997-12-31,253549,6999,260548
63,63001,1998-12-31,256544,6961,263505
63,63001,1999-12-31,259209,6921,266130
63,63001,2000-12-31,261446,6905,268351
63,63001,2001-12-31,263358,6888,270246
63,63001,2002-12-31,264949,6890,271839
63,63001,2003-12-31,266201,6900,273101
63,63001,2004-12-31,267352,6930,274282
63,63001,2005-12-31,268413,6972,275385
63,63001,2006-12-31,269596,7009,276605
63,63001,2007-12-31,270587,7058,277645
63,63001,2008-12-31,271459,7107,278566
63,63001,2009-12-31,272328,7162,279490
63,63001,2010-12-31,273399,7220,280619
63,63001,2011-12-31,274571,7309,281880
63,63001,2012-12-31,275714,7372,283086
63,63001,2013-12-31,276747,7436,284183
63,63001,2014-12-31,277976,7514,285490
63,63001,2015-12-31,279473,7563,287036
63,63001,2016-12-31,281433,7718,289151
63,63001,2017-12-31,283909,7789,291698
63,63001,2018-12-31,287245,7963,295208
63,63001,2019-12-31,292273,7921,300194
63,63001,2020-12-31,297052,7712,304764
63,63001,2021-12-31,300785,7678,308463
63,63001,2022-12-31,304780,7771,312551
63,63001,2023-12-31,309020,7906,316926
63,63001,2024-12-31,313132,8054,321186
63,63001,2025-12-31,316835,8221,325056
63,63001,2026-12-31,320274,8394,328668
63,63001,2027-12-31,323398,8598,331996
63,63001,2028-12-31,326207,8787,334994
63,63001,2029-12-31,328669,9013,337682
63,63001,2030-12-31,330735,9246,339981
63,63001,2031-12-31,332547,9480,342027
63,63001,2032-12-31,334265,9737,344002
63,63001,2033-12-31,335867,10000,345867
63,63001,2034-12-31,337405,10277,347682
63,63001,2035-12-31,338803,10559,349362
63,63111,1985-12-31,1311,2416,3727
63,63111,1986-12-31,1290,2401,3691
63,63111,1987-12-31,1299,2393,3692
63,63111,1988-12-31,1306,2368,3674
63,63111,1989-12-31,1316,2333,3649
63,63111,1990-12-31,1272,2311,3583
63,63111,1991-12-31,1273,2270,3543
63,63111,1992-12-31,1296,2209,3505
63,63111,1993-12-31,1310,2192,3502
63,63111,1994-12-31,1290,2158,3448
63,63111,1995-12-31,1321,2135,3456
63,63111,1996-12-31,1311,2063,3374
63,63111,1997-12-31,1303,2045,3348
63,63111,1998-12-31,1359,1971,3330
63,63111,1999-12-31,1343,1960,3303
63,63111,2000-12-31,1344,1940,3284
63,63111,2001-12-31,1326,1917,3243
63,63111,2002-12-31,1307,1897,3204
63,63111,2003-12-31,1286,1889,3175
63,63111,2004-12-31,1287,1889,3176
63,63111,2005-12-31,1287,1865,3152
63,63111,2006-12-31,1258,1868,3126
63,63111,2007-12-31,1231,1868,3099
63,63111,2008-12-31,1194,1870,3064
63,63111,2009-12-31,1182,1872,3054
63,63111,2010-12-31,1170,1845,3015
63,63111,2011-12-31,1179,1825,3004
63,63111,2012-12-31,1169,1808,2977
63,63111,2013-12-31,1181,1842,3023
63,63111,2014-12-31,1178,1862,3040
63,63111,2015-12-31,1184,1892,3076
63,63111,2016-12-31,1189,1859,3048
63,63111,2017-12-31,1192,1853,3045
63,63111,2018-12-31,1212,1883,3095
63,63111,2019-12-31,1216,1891,3107
63,63111,2020-12-31,1225,1904,3129
63,63111,2021-12-31,1270,1896,3166
63,63111,2022-12-31,1289,1919,3208
63,63111,2023-12-31,1301,1952,3253
63,63111,2024-12-31,1309,1986,3295
63,63111,2025-12-31,1324,2030,3354
63,63111,2026-12-31,1340,2077,3417
63,63111,2027-12-31,1354,2118,3472
63,63111,2028-12-31,1368,2167,3535
63,63111,2029-12-31,1375,2218,3593
63,63111,2030-12-31,1387,2278,3665
63,63111,2031-12-31,1390,2339,3729
63,63111,2032-12-31,1401,2397,3798
63,63111,2033-12-31,1407,2468,3875
63,63111,2034-12-31,1408,2539,3947
63,63111,2035-12-31,1417,2609,4026
63,63130,1985-12-31,45562,16697,62259
63,63130,1986-12-31,45888,16741,62629
63,63130,1987-12-31,46249,16749,62998
63,63130,1988-12-31,46635,16718,63353
63,63130,1989-12-31,47084,16639,63723
63,63130,1990-12-31,47542,16520,64062
63,63130,1991-12-31,48045,16332,64377
63,63130,1992-12-31,48619,16141,64760
63,63130,1993-12-31,49282,15901,65183
63,63130,1994-12-31,49929,15693,65622
63,63130,1995-12-31,50571,15489,66060
63,63130,1996-12-31,51170,15291,66461
63,63130,1997-12-31,51741,15110,66851
63,63130,1998-12-31,52246,14942,67188
63,63130,1999-12-31,52674,14819,67493
63,63130,2000-12-31,53018,14783,67801
63,63130,2001-12-31,53298,14711,68009
63,63130,2002-12-31,53513,14666,68179
63,63130,2003-12-31,53667,14674,68341
63,63130,2004-12-31,53796,14678,68474
63,63130,2005-12-31,53911,14722,68633
63,63130,2006-12-31,54057,14780,68837
63,63130,2007-12-31,54165,14836,69001
63,63130,2008-12-31,54253,14903,69156
63,63130,2009-12-31,54330,14970,69300
63,63130,2010-12-31,54438,15063,69501
63,63130,2011-12-31,54588,15202,69790
63,63130,2012-12-31,54725,15300,70025
63,63130,2013-12-31,54870,15404,70274
63,63130,2014-12-31,55038,15527,70565
63,63130,2015-12-31,55309,15656,70965
63,63130,2016-12-31,55482,15838,71320
63,63130,2017-12-31,55897,16045,71942
63,63130,2018-12-31,56505,16278,72783
63,63130,2019-12-31,57489,16383,73872
63,63130,2020-12-31,58426,16464,74890
63,63130,2021-12-31,59402,16394,75796
63,63130,2022-12-31,60210,16593,76803
63,63130,2023-12-31,60996,16882,77878
63,63130,2024-12-31,61739,17207,78946
63,63130,2025-12-31,62467,17541,80008
63,63130,2026-12-31,63144,17934,81078
63,63130,2027-12-31,63768,18333,82101
63,63130,2028-12-31,64316,18774,83090
63,63130,2029-12-31,64797,19249,84046
63,63130,2030-12-31,65204,19729,84933
63,63130,2031-12-31,65558,20269,85827
63,63130,2032-12-31,65904,20802,86706
63,63130,2033-12-31,66224,21369,87593
63,63130,2034-12-31,66528,21964,88492
63,63130,2035-12-31,66793,22568,89361
63,63190,1985-12-31,13301,8041,21342
63,63190,1986-12-31,13533,8037,21570
63,63190,1987-12-31,13785,8038,21823
63,63190,1988-12-31,14049,7990,22039
63,63190,1989-12-31,14320,7966,22286
63,63190,1990-12-31,14610,7835,22445
63,63190,1991-12-31,14904,7730,22634
63,63190,1992-12-31,15231,7614,22845
63,63190,1993-12-31,15572,7493,23065
63,63190,1994-12-31,15908,7353,23261
63,63190,1995-12-31,16246,7227,23473
63,63190,1996-12-31,16593,7124,23717
63,63190,1997-12-31,16926,7015,23941
63,63190,1998-12-31,17209,6950,24159
63,63190,1999-12-31,17486,6869,24355
63,63190,2000-12-31,17729,6811,24540
63,63190,2001-12-31,17966,6780,24746
63,63190,2002-12-31,18153,6729,24882
63,63190,2003-12-31,18326,6719,25045
63,63190,2004-12-31,18496,6699,25195
63,63190,2005-12-31,18665,6676,25341
63,63190,2006-12-31,18835,6687,25522
63,63190,2007-12-31,18990,6720,25710
63,63190,2008-12-31,19140,6728,25868
63,63190,2009-12-31,19266,6759,26025
63,63190,2010-12-31,19420,6766,26186
63,63190,2011-12-31,19575,6789,26364
63,63190,2012-12-31,19745,6827,26572
63,63190,2013-12-31,19917,6848,26765
63,63190,2014-12-31,20067,6878,26945
63,63190,2015-12-31,20216,6888,27104
63,63190,2016-12-31,20476,6985,27461
63,63190,2017-12-31,20783,7051,27834
63,63190,2018-12-31,21025,7137,28162
63,63190,2019-12-31,21501,7130,28631
63,63190,2020-12-31,21935,7125,29060
63,63190,2021-12-31,22318,7095,29413
63,63190,2022-12-31,22621,7181,29802
63,63190,2023-12-31,22914,7306,30220
63,63190,2024-12-31,23182,7449,30631
63,63190,2025-12-31,23448,7603,31051
63,63190,2026-12-31,23692,7755,31447
63,63190,2027-12-31,23926,7956,31882
63,63190,2028-12-31,24140,8147,32287
63,63190,2029-12-31,24320,8341,32661
63,63190,2030-12-31,24461,8560,33021
63,63190,2031-12-31,24614,8790,33404
63,63190,2032-12-31,24717,9033,33750
63,63190,2033-12-31,24847,9276,34123
63,63190,2034-12-31,24942,9526,34468
63,63190,2035-12-31,25056,9783,34839
63,63212,1985-12-31,2734,3088,5822
63,63212,1986-12-31,2750,3088,5838
63,63212,1987-12-31,2770,3053,5823
63,63212,1988-12-31,2789,3027,5816
63,63212,1989-12-31,2813,2986,5799
63,63212,1990-12-31,2845,2948,5793
63,63212,1991-12-31,2863,2889,5752
63,63212,1992-12-31,2898,2833,5731
63,63212,1993-12-31,2946,2760,5706
63,63212,1994-12-31,2975,2718,5693
63,63212,1995-12-31,3014,2665,5679
63,63212,1996-12-31,3046,2580,5626
63,63212,1997-12-31,3091,2548,5639
63,63212,1998-12-31,3099,2506,5605
63,63212,1999-12-31,3167,2469,5636
63,63212,2000-12-31,3209,2425,5634
63,63212,2001-12-31,3158,2396,5554
63,63212,2002-12-31,3182,2381,5563
63,63212,2003-12-31,3210,2343,5553
63,63212,2004-12-31,3192,2320,5512
63,63212,2005-12-31,3206,2324,5530
63,63212,2006-12-31,3218,2309,5527
63,63212,2007-12-31,3160,2305,5465
63,63212,2008-12-31,3177,2284,5461
63,63212,2009-12-31,3208,2278,5486
63,63212,2010-12-31,3242,2261,5503
63,63212,2011-12-31,3224,2271,5495
63,63212,2012-12-31,3211,2263,5474
63,63212,2013-12-31,3218,2226,5444
63,63212,2014-12-31,3234,2225,5459
63,63212,2015-12-31,3259,2257,5516
63,63212,2016-12-31,3293,2292,5585
63,63212,2017-12-31,3323,2255,5578
63,63212,2018-12-31,3363,2279,5642
63,63212,2019-12-31,3414,2273,5687
63,63212,2020-12-31,3462,2277,5739
63,63212,2021-12-31,3540,2267,5807
63,63212,2022-12-31,3589,2295,5884
63,63212,2023-12-31,3632,2335,5967
63,63212,2024-12-31,3678,2372,6050
63,63212,2025-12-31,3718,2432,6150
63,63212,2026-12-31,3764,2469,6233
63,63212,2027-12-31,3798,2531,6329
63,63212,2028-12-31,3825,2591,6416
63,63212,2029-12-31,3854,2658,6512
63,63212,2030-12-31,3874,2723,6597
63,63212,2031-12-31,3896,2793,6689
63,63212,2032-12-31,3918,2865,6783
63,63212,2033-12-31,3938,2954,6892
63,63212,2034-12-31,3955,3038,6993
63,63212,2035-12-31,3964,3106,7070
63,63272,1985-12-31,4573,7884,12457
63,63272,1986-12-31,4630,7825,12455
63,63272,1987-12-31,4701,7749,12450
63,63272,1988-12-31,4773,7671,12444
63,63272,1989-12-31,4854,7556,12410
63,63272,1990-12-31,4918,7424,12342
63,63272,1991-12-31,5006,7270,12276
63,63272,1992-12-31,5095,7150,12245
63,63272,1993-12-31,5196,6958,12154
63,63272,1994-12-31,5288,6806,12094
63,63272,1995-12-31,5385,6625,12010
63,63272,1996-12-31,5495,6472,11967
63,63272,1997-12-31,5568,6351,11919
63,63272,1998-12-31,5666,6229,11895
63,63272,1999-12-31,5739,6121,11860
63,63272,2000-12-31,5810,6016,11826
63,63272,2001-12-31,5872,5936,11808
63,63272,2002-12-31,5902,5870,11772
63,63272,2003-12-31,5953,5803,11756
63,63272,2004-12-31,6018,5731,11749
63,63272,2005-12-31,6032,5687,11719
63,63272,2006-12-31,6073,5656,11729
63,63272,2007-12-31,6126,5610,11736
63,63272,2008-12-31,6154,5555,11709
63,63272,2009-12-31,6191,5541,11732
63,63272,2010-12-31,6215,5521,11736
63,63272,2011-12-31,6267,5501,11768
63,63272,2012-12-31,6327,5474,11801
63,63272,2013-12-31,6395,5442,11837
63,63272,2014-12-31,6366,5415,11781
63,63272,2015-12-31,6448,5445,11893
63,63272,2016-12-31,6513,5363,11876
63,63272,2017-12-31,6566,5442,12008
63,63272,2018-12-31,6640,5426,12066
63,63272,2019-12-31,6771,5383,12154
63,63272,2020-12-31,6894,5365,12259
63,63272,2021-12-31,7063,5342,12405
63,63272,2022-12-31,7163,5407,12570
63,63272,2023-12-31,7245,5501,12746
63,63272,2024-12-31,7332,5589,12921
63,63272,2025-12-31,7415,5711,13126
63,63272,2026-12-31,7504,5831,13335
63,63272,2027-12-31,7578,5958,13536
63,63272,2028-12-31,7639,6109,13748
63,63272,2029-12-31,7694,6265,13959
63,63272,2030-12-31,7741,6424,14165
63,63272,2031-12-31,7789,6601,14390
63,63272,2032-12-31,7831,6781,14612
63,63272,2033-12-31,7865,6950,14815
63,63272,2034-12-31,7903,7144,15047
63,63272,2035-12-31,7938,7340,15278
63,63302,1985-12-31,5896,5537,11433
63,63302,1986-12-31,5831,5482,11313
63,63302,1987-12-31,5777,5423,11200
63,63302,1988-12-31,5731,5333,11064
63,63302,1989-12-31,5690,5243,10933
63,63302,1990-12-31,5657,5120,10777
63,63302,1991-12-31,5615,4982,10597
63,63302,1992-12-31,5589,4876,10465
63,63302,1993-12-31,5567,4759,10326
63,63302,1994-12-31,5559,4656,10215
63,63302,1995-12-31,5537,4515,10052
63,63302,1996-12-31,5508,4407,9915
63,63302,1997-12-31,5475,4253,9728
63,63302,1998-12-31,5438,4159,9597
63,63302,1999-12-31,5392,4070,9462
63,63302,2000-12-31,5385,4029,9414
63,63302,2001-12-31,5319,3948,9267
63,63302,2002-12-31,5234,3853,9087
63,63302,2003-12-31,5173,3794,8967
63,63302,2004-12-31,5094,3754,8848
63,63302,2005-12-31,5046,3686,8732
63,63302,2006-12-31,4916,3633,8549
63,63302,2007-12-31,4897,3568,8465
63,63302,2008-12-31,4791,3548,8339
63,63302,2009-12-31,4716,3489,8205
63,63302,2010-12-31,4658,3490,8148
63,63302,2011-12-31,4616,3445,8061
63,63302,2012-12-31,4559,3395,7954
63,63302,2013-12-31,4444,3372,7816
63,63302,2014-12-31,4375,3335,7710
63,63302,2015-12-31,4368,3279,7647
63,63302,2016-12-31,4359,3258,7617
63,63302,2017-12-31,4252,3316,7568
63,63302,2018-12-31,4269,3247,7516
63,63302,2019-12-31,4253,3202,7455
63,63302,2020-12-31,4265,3182,7447
63,63302,2021-12-31,4369,3167,7536
63,63302,2022-12-31,4431,3205,7636
63,63302,2023-12-31,4482,3261,7743
63,63302,2024-12-31,4537,3325,7862
63,63302,2025-12-31,4588,3387,7975
63,63302,2026-12-31,4637,3466,8103
63,63302,2027-12-31,4675,3539,8214
63,63302,2028-12-31,4719,3620,8339
63,63302,2029-12-31,4752,3715,8467
63,63302,2030-12-31,4791,3804,8595
63,63302,2031-12-31,4819,3907,8726
63,63302,2032-12-31,4838,4013,8851
63,63302,2033-12-31,4867,4120,8987
63,63302,2034-12-31,4885,4225,9110
63,63302,2035-12-31,4897,4340,9237
63,63401,1985-12-31,19356,2938,22294
63,63401,1986-12-31,19684,2991,22675
63,63401,1987-12-31,20029,3011,23040
63,63401,1988-12-31,20383,3045,23428
63,63401,1989-12-31,20754,2990,23744
63,63401,1990-12-31,21145,3036,24181
63,63401,1991-12-31,21544,3050,24594
63,63401,1992-12-31,21981,2998,24979
63,63401,1993-12-31,22456,2992,25448
63,63401,1994-12-31,22928,2997,25925
63,63401,1995-12-31,23395,2963,26358
63,63401,1996-12-31,23855,2959,26814
63,63401,1997-12-31,24282,2971,27253
63,63401,1998-12-31,24683,2955,27638
63,63401,1999-12-31,25059,2934,27993
63,63401,2000-12-31,25390,2928,28318
63,63401,2001-12-31,25689,2960,28649
63,63401,2002-12-31,25964,2983,28947
63,63401,2003-12-31,26187,2999,29186
63,63401,2004-12-31,26407,3009,29416
63,63401,2005-12-31,26633,3071,29704
63,63401,2006-12-31,26844,3084,29928
63,63401,2007-12-31,27051,3122,30173
63,63401,2008-12-31,27230,3156,30386
63,63401,2009-12-31,27408,3179,30587
63,63401,2010-12-31,27623,3251,30874
63,63401,2011-12-31,27816,3273,31089
63,63401,2012-12-31,28044,3367,31411
63,63401,2013-12-31,28233,3434,31667
63,63401,2014-12-31,28438,3480,31918
63,63401,2015-12-31,28678,3486,32164
63,63401,2016-12-31,29007,3464,32471
63,63401,2017-12-31,29287,3641,32928
63,63401,2018-12-31,29752,3699,33451
63,63401,2019-12-31,30687,3485,34172
63,63401,2020-12-31,31530,3273,34803
63,63401,2021-12-31,31967,3258,35225
63,63401,2022-12-31,32394,3298,35692
63,63401,2023-12-31,32837,3355,36192
63,63401,2024-12-31,33208,3423,36631
63,63401,2025-12-31,33611,3495,37106
63,63401,2026-12-31,33978,3567,37545
63,63401,2027-12-31,34304,3645,37949
63,63401,2028-12-31,34599,3736,38335
63,63401,2029-12-31,34864,3821,38685
63,63401,2030-12-31,35086,3928,39014
63,63401,2031-12-31,35267,4022,39289
63,63401,2032-12-31,35459,4134,39593
63,63401,2033-12-31,35632,4248,39880
63,63401,2034-12-31,35782,4365,40147
63,63401,2035-12-31,35951,4486,40437
63,63470,1985-12-31,26699,8499,35198
63,63470,1986-12-31,26788,8466,35254
63,63470,1987-12-31,26904,8390,35294
63,63470,1988-12-31,27035,8318,35353
63,63470,1989-12-31,27194,8250,35444
63,63470,1990-12-31,27371,8135,35506
63,63470,1991-12-31,27572,7990,35562
63,63470,1992-12-31,27786,7839,35625
63,63470,1993-12-31,28074,7683,35757
63,63470,1994-12-31,28358,7531,35889
63,63470,1995-12-31,28639,7386,36025
63,63470,1996-12-31,28898,7230,36128
63,63470,1997-12-31,29142,7089,36231
63,63470,1998-12-31,29319,6996,36315
63,63470,1999-12-31,29470,6906,36376
63,63470,2000-12-31,29582,6807,36389
63,63470,2001-12-31,29669,6750,36419
63,63470,2002-12-31,29686,6681,36367
63,63470,2003-12-31,29697,6632,36329
63,63470,2004-12-31,29681,6599,36280
63,63470,2005-12-31,29670,6567,36237
63,63470,2006-12-31,29671,6521,36192
63,63470,2007-12-31,29648,6508,36156
63,63470,2008-12-31,29630,6494,36124
63,63470,2009-12-31,29596,6485,36081
63,63470,2010-12-31,29590,6476,36066
63,63470,2011-12-31,29583,6478,36061
63,63470,2012-12-31,29596,6457,36053
63,63470,2013-12-31,29581,6483,36064
63,63470,2014-12-31,29603,6493,36096
63,63470,2015-12-31,29644,6485,36129
63,63470,2016-12-31,29748,6582,36330
63,63470,2017-12-31,29869,6523,36392
63,63470,2018-12-31,30130,6621,36751
63,63470,2019-12-31,30571,6556,37127
63,63470,2020-12-31,31015,6503,37518
63,63470,2021-12-31,31492,6474,37966
63,63470,2022-12-31,31916,6553,38469
63,63470,2023-12-31,32340,6667,39007
63,63470,2024-12-31,32726,6793,39519
63,63470,2025-12-31,33103,6917,40020
63,63470,2026-12-31,33462,7076,40538
63,63470,2027-12-31,33790,7232,41022
63,63470,2028-12-31,34083,7398,41481
63,63470,2029-12-31,34330,7582,41912
63,63470,2030-12-31,34550,7758,42308
63,63470,2031-12-31,34740,7970,42710
63,63470,2032-12-31,34913,8180,43093
63,63470,2033-12-31,35083,8398,43481
63,63470,2034-12-31,35257,8616,43873
63,63470,2035-12-31,35387,8887,44274
63,63548,1985-12-31,5007,4081,9088
63,63548,1986-12-31,4957,4024,8981
63,63548,1987-12-31,4867,3982,8849
63,63548,1988-12-31,4802,3913,8715
63,63548,1989-12-31,4750,3847,8597
63,63548,1990-12-31,4693,3747,8440
63,63548,1991-12-31,4643,3680,8323
63,63548,1992-12-31,4614,3564,8178
63,63548,1993-12-31,4574,3472,8046
63,63548,1994-12-31,4537,3397,7934
63,63548,1995-12-31,4497,3260,7757
63,63548,1996-12-31,4441,3169,7610
63,63548,1997-12-31,4410,3097,7507
63,63548,1998-12-31,4365,3019,7384
63,63548,1999-12-31,4272,2951,7223
63,63548,2000-12-31,4194,2880,7074
63,63548,2001-12-31,4150,2815,6965
63,63548,2002-12-31,4068,2776,6844
63,63548,2003-12-31,4021,2722,6743
63,63548,2004-12-31,3957,2684,6641
63,63548,2005-12-31,3821,2636,6457
63,63548,2006-12-31,3749,2611,6360
63,63548,2007-12-31,3692,2565,6257
63,63548,2008-12-31,3578,2528,6106
63,63548,2009-12-31,3518,2490,6008
63,63548,2010-12-31,3462,2456,5918
63,63548,2011-12-31,3360,2435,5795
63,63548,2012-12-31,3253,2411,5664
63,63548,2013-12-31,3197,2343,5540
63,63548,2014-12-31,3146,2297,5443
63,63548,2015-12-31,3106,2294,5400
63,63548,2016-12-31,3092,2310,5402
63,63548,2017-12-31,2976,2274,5250
63,63548,2018-12-31,2977,2242,5219
63,63548,2019-12-31,2944,2202,5146
63,63548,2020-12-31,2938,2183,5121
63,63548,2021-12-31,3009,2173,5182
63,63548,2022-12-31,3051,2200,5251
63,63548,2023-12-31,3086,2238,5324
63,63548,2024-12-31,3123,2282,5405
63,63548,2025-12-31,3162,2320,5482
63,63548,2026-12-31,3194,2379,5573
63,63548,2027-12-31,3216,2430,5646
63,63548,2028-12-31,3249,2483,5732
63,63548,2029-12-31,3274,2540,5814
63,63548,2030-12-31,3296,2618,5914
63,63548,2031-12-31,3310,2677,5987
63,63548,2032-12-31,3330,2747,6077
63,63548,2033-12-31,3348,2823,6171
63,63548,2034-12-31,3357,2896,6253
63,63548,2035-12-31,3389,2975,6364
63,63594,1985-12-31,24751,10396,35147
63,63594,1986-12-31,24729,10270,34999
63,63594,1987-12-31,24739,10134,34873
63,63594,1988-12-31,24767,9981,34748
63,63594,1989-12-31,24809,9797,34606
63,63594,1990-12-31,24871,9593,34464
63,63594,1991-12-31,24949,9369,34318
63,63594,1992-12-31,25071,9124,34195
63,63594,1993-12-31,25235,8886,34121
63,63594,1994-12-31,25395,8591,33986
63,63594,1995-12-31,25539,8329,33868
63,63594,1996-12-31,25675,8105,33780
63,63594,1997-12-31,25795,7898,33693
63,63594,1998-12-31,25872,7710,33582
63,63594,1999-12-31,25914,7538,33452
63,63594,2000-12-31,25921,7378,33299
63,63594,2001-12-31,25882,7226,33108
63,63594,2002-12-31,25833,7100,32933
63,63594,2003-12-31,25743,6990,32733
63,63594,2004-12-31,25655,6874,32529
63,63594,2005-12-31,25542,6766,32308
63,63594,2006-12-31,25465,6678,32143
63,63594,2007-12-31,25372,6590,31962
63,63594,2008-12-31,25267,6503,31770
63,63594,2009-12-31,25156,6424,31580
63,63594,2010-12-31,25069,6336,31405
63,63594,2011-12-31,24992,6271,31263
63,63594,2012-12-31,24903,6193,31096
63,63594,2013-12-31,24802,6126,30928
63,63594,2014-12-31,24755,6052,30807
63,63594,2015-12-31,24685,6002,30687
63,63594,2016-12-31,24754,5929,30683
63,63594,2017-12-31,24830,5824,30654
63,63594,2018-12-31,24913,5838,30751
63,63594,2019-12-31,25189,5722,30911
63,63594,2020-12-31,25493,5649,31142
63,63594,2021-12-31,25890,5624,31514
63,63594,2022-12-31,26239,5692,31931
63,63594,2023-12-31,26587,5791,32378
63,63594,2024-12-31,26910,5899,32809
63,63594,2025-12-31,27233,6020,33253
63,63594,2026-12-31,27516,6146,33662
63,63594,2027-12-31,27800,6286,34086
63,63594,2028-12-31,28035,6438,34473
63,63594,2029-12-31,28239,6601,34840
63,63594,2030-12-31,28415,6777,35192
63,63594,2031-12-31,28580,6948,35528
63,63594,2032-12-31,28721,7133,35854
63,63594,2033-12-31,28863,7333,36196
63,63594,2034-12-31,28991,7532,36523
63,63594,2035-12-31,29127,7733,36860
63,63690,1985-12-31,2963,4030,6993
63,63690,1986-12-31,2984,4085,7069
63,63690,1987-12-31,3025,4140,7165
63,63690,1988-12-31,3070,4176,7246
63,63690,1989-12-31,3084,4198,7282
63,63690,1990-12-31,3123,4204,7327
63,63690,1991-12-31,3208,4198,7406
63,63690,1992-12-31,3242,4197,7439
63,63690,1993-12-31,3250,4219,7469
63,63690,1994-12-31,3315,4183,7498
63,63690,1995-12-31,3363,4156,7519
63,63690,1996-12-31,3414,4168,7582
63,63690,1997-12-31,3428,4146,7574
63,63690,1998-12-31,3467,4148,7615
63,63690,1999-12-31,3537,4169,7706
63,63690,2000-12-31,3571,4166,7737
63,63690,2001-12-31,3600,4194,7794
63,63690,2002-12-31,3611,4238,7849
63,63690,2003-12-31,3610,4269,7879
63,63690,2004-12-31,3610,4307,7917
63,63690,2005-12-31,3631,4352,7983
63,63690,2006-12-31,3651,4420,8071
63,63690,2007-12-31,3648,4485,8133
63,63690,2008-12-31,3639,4537,8176
63,63690,2009-12-31,3660,4597,8257
63,63690,2010-12-31,3704,4672,8376
63,63690,2011-12-31,3786,4733,8519
63,63690,2012-12-31,3766,4818,8584
63,63690,2013-12-31,3728,4888,8616
63,63690,2014-12-31,3745,4971,8716
63,63690,2015-12-31,3774,5093,8867
63,63690,2016-12-31,3795,5152,8947
63,63690,2017-12-31,3831,5238,9069
63,63690,2018-12-31,3879,5381,9260
63,63690,2019-12-31,3947,5452,9399
63,63690,2020-12-31,4011,5518,9529
63,63690,2021-12-31,4149,5495,9644
63,63690,2022-12-31,4211,5561,9772
63,63690,2023-12-31,4251,5658,9909
63,63690,2024-12-31,4293,5769,10062
63,63690,2025-12-31,4351,5889,10240
63,63690,2026-12-31,4391,6012,10403
63,63690,2027-12-31,4441,6138,10579
63,63690,2028-12-31,4477,6295,10772
63,63690,2029-12-31,4511,6446,10957
63,63690,2030-12-31,4536,6625,11161
63,63690,2031-12-31,4555,6793,11348
63,63690,2032-12-31,4592,6974,11566
63,63690,2033-12-31,4608,7152,11760
63,63690,2034-12-31,4631,7354,11985
63,63690,2035-12-31,4653,7565,12218
66,66001,1985-12-31,248127,63500,311627
66,66001,1986-12-31,254470,64010,318480
66,66001,1987-12-31,260751,64499,325250
66,66001,1988-12-31,267021,65047,332068
66,66001,1989-12-31,273189,65586,338775
66,66001,1990-12-31,279205,66120,345325
66,66001,1991-12-31,285236,66657,351893
66,66001,1992-12-31,291389,67259,358648
66,66001,1993-12-31,297880,67984,365864
66,66001,1994-12-31,303977,68660,372637
66,66001,1995-12-31,309943,69323,379266
66,66001,1996-12-31,315744,69978,385722
66,66001,1997-12-31,321191,70624,391815
66,66001,1998-12-31,326371,71196,397567
66,66001,1999-12-31,331144,71773,402917
66,66001,2000-12-31,335457,72262,407719
66,66001,2001-12-31,339347,72686,412033
66,66001,2002-12-31,342823,73077,415900
66,66001,2003-12-31,346002,73449,419451
66,66001,2004-12-31,349177,73846,423023
66,66001,2005-12-31,352295,74271,426566
66,66001,2006-12-31,355448,74750,430198
66,66001,2007-12-31,358399,75233,433632
66,66001,2008-12-31,360868,75626,436494
66,66001,2009-12-31,363306,76064,439370
66,66001,2010-12-31,365897,76596,442493
66,66001,2011-12-31,368364,77074,445438
66,66001,2012-12-31,370604,77570,448174
66,66001,2013-12-31,372453,77969,450422
66,66001,2014-12-31,374290,78386,452676
66,66001,2015-12-31,376594,78965,455559
66,66001,2016-12-31,379302,79731,459033
66,66001,2017-12-31,382217,80451,462668
66,66001,2018-12-31,385838,81431,467269
66,66001,2019-12-31,392641,79765,472406
66,66001,2020-12-31,399283,77744,477027
66,66001,2021-12-31,404270,76533,480803
66,66001,2022-12-31,409070,76303,485373
66,66001,2023-12-31,414043,76421,490464
66,66001,2024-12-31,419060,76689,495749
66,66001,2025-12-31,423774,77032,500806
66,66001,2026-12-31,428149,77429,505578
66,66001,2027-12-31,432158,77964,510122
66,66001,2028-12-31,435708,78606,514314
66,66001,2029-12-31,438789,79355,518144
66,66001,2030-12-31,441342,80253,521595
66,66001,2031-12-31,443562,81195,524757
66,66001,2032-12-31,445675,82148,527823
66,66001,2033-12-31,447689,83104,530793
66,66001,2034-12-31,449577,84042,533619
66,66001,2035-12-31,451391,84995,536386
66,66045,1985-12-31,5229,10554,15783
66,66045,1986-12-31,5261,10428,15689
66,66045,1987-12-31,5314,10283,15597
66,66045,1988-12-31,5361,10175,15536
66,66045,1989-12-31,5403,10044,15447
66,66045,1990-12-31,5392,9911,15303
66,66045,1991-12-31,5447,9809,15256
66,66045,1992-12-31,5564,9684,15248
66,66045,1993-12-31,5578,9615,15193
66,66045,1994-12-31,5624,9507,15131
66,66045,1995-12-31,5648,9416,15064
66,66045,1996-12-31,5627,9318,14945
66,66045,1997-12-31,5712,9220,14932
66,66045,1998-12-31,5720,9095,14815
66,66045,1999-12-31,5743,9004,14747
66,66045,2000-12-31,5731,8891,14622
66,66045,2001-12-31,5738,8772,14510
66,66045,2002-12-31,5718,8627,14345
66,66045,2003-12-31,5708,8501,14209
66,66045,2004-12-31,5679,8372,14051
66,66045,2005-12-31,5666,8275,13941
66,66045,2006-12-31,5687,8155,13842
66,66045,2007-12-31,5660,7998,13658
66,66045,2008-12-31,5643,7908,13551
66,66045,2009-12-31,5631,7794,13425
66,66045,2010-12-31,5611,7681,13292
66,66045,2011-12-31,5573,7556,13129
66,66045,2012-12-31,5553,7458,13011
66,66045,2013-12-31,5550,7379,12929
66,66045,2014-12-31,5544,7300,12844
66,66045,2015-12-31,5439,7204,12643
66,66045,2016-12-31,5385,7103,12488
66,66045,2017-12-31,5403,7065,12468
66,66045,2018-12-31,5453,6953,12406
66,66045,2019-12-31,5471,6805,12276
66,66045,2020-12-31,5506,6715,12221
66,66045,2021-12-31,5703,6612,12315
66,66045,2022-12-31,5840,6592,12432
66,66045,2023-12-31,5961,6602,12563
66,66045,2024-12-31,6038,6621,12659
66,66045,2025-12-31,6104,6650,12754
66,66045,2026-12-31,6168,6683,12851
66,66045,2027-12-31,6220,6746,12966
66,66045,2028-12-31,6275,6786,13061
66,66045,2029-12-31,6325,6853,13178
66,66045,2030-12-31,6353,6933,13286
66,66045,2031-12-31,6391,7021,13412
66,66045,2032-12-31,6422,7091,13513
66,66045,2033-12-31,6444,7173,13617
66,66045,2034-12-31,6478,7249,13727
66,66045,2035-12-31,6497,7329,13826
66,66075,1985-12-31,1961,7442,9403
66,66075,1986-12-31,1947,7325,9272
66,66075,1987-12-31,1944,7242,9186
66,66075,1988-12-31,1956,7157,9113
66,66075,1989-12-31,1936,7082,9018
66,66075,1990-12-31,1953,6997,8950
66,66075,1991-12-31,1947,6880,8827
66,66075,1992-12-31,1935,6843,8778
66,66075,1993-12-31,1920,6778,8698
66,66075,1994-12-31,1945,6702,8647
66,66075,1995-12-31,1932,6632,8564
66,66075,1996-12-31,1933,6556,8489
66,66075,1997-12-31,1926,6486,8412
66,66075,1998-12-31,1891,6432,8323
66,66075,1999-12-31,1920,6328,8248
66,66075,2000-12-31,1856,6253,8109
66,66075,2001-12-31,1872,6171,8043
66,66075,2002-12-31,1876,6086,7962
66,66075,2003-12-31,1850,5978,7828
66,66075,2004-12-31,1796,5892,7688
66,66075,2005-12-31,1780,5798,7578
66,66075,2006-12-31,1801,5738,7539
66,66075,2007-12-31,1784,5670,7454
66,66075,2008-12-31,1745,5574,7319
66,66075,2009-12-31,1679,5471,7150
66,66075,2010-12-31,1632,5386,7018
66,66075,2011-12-31,1586,5315,6901
66,66075,2012-12-31,1540,5265,6805
66,66075,2013-12-31,1526,5193,6719
66,66075,2014-12-31,1514,5132,6646
66,66075,2015-12-31,1512,5083,6595
66,66075,2016-12-31,1511,5003,6514
66,66075,2017-12-31,1511,4999,6510
66,66075,2018-12-31,1518,4905,6423
66,66075,2019-12-31,1506,4842,6348
66,66075,2020-12-31,1504,4793,6297
66,66075,2021-12-31,1627,4719,6346
66,66075,2022-12-31,1701,4705,6406
66,66075,2023-12-31,1761,4712,6473
66,66075,2024-12-31,1779,4722,6501
66,66075,2025-12-31,1795,4727,6522
66,66075,2026-12-31,1818,4760,6578
66,66075,2027-12-31,1836,4784,6620
66,66075,2028-12-31,1847,4830,6677
66,66075,2029-12-31,1859,4879,6738
66,66075,2030-12-31,1871,4915,6786
66,66075,2031-12-31,1890,4985,6875
66,66075,2032-12-31,1892,5063,6955
66,66075,2033-12-31,1901,5109,7010
66,66075,2034-12-31,1915,5156,7071
66,66075,2035-12-31,1925,5228,7153
66,66088,1985-12-31,9296,16165,25461
66,66088,1986-12-31,9491,16022,25513
66,66088,1987-12-31,9662,15862,25524
66,66088,1988-12-31,9819,15727,25546
66,66088,1989-12-31,9983,15592,25575
66,66088,1990-12-31,10146,15467,25613
66,66088,1991-12-31,10312,15342,25654
66,66088,1992-12-31,10463,15212,25675
66,66088,1993-12-31,10649,15127,25776
66,66088,1994-12-31,10808,15026,25834
66,66088,1995-12-31,10957,14922,25879
66,66088,1996-12-31,11105,14825,25930
66,66088,1997-12-31,11235,14727,25962
66,66088,1998-12-31,11358,14604,25962
66,66088,1999-12-31,11487,14486,25973
66,66088,2000-12-31,11590,14353,25943
66,66088,2001-12-31,11658,14207,25865
66,66088,2002-12-31,11735,14074,25809
66,66088,2003-12-31,11795,13912,25707
66,66088,2004-12-31,11859,13784,25643
66,66088,2005-12-31,11907,13636,25543
66,66088,2006-12-31,11962,13516,25478
66,66088,2007-12-31,12029,13394,25423
66,66088,2008-12-31,12056,13253,25309
66,66088,2009-12-31,12098,13112,25210
66,66088,2010-12-31,12142,13015,25157
66,66088,2011-12-31,12178,12921,25099
66,66088,2012-12-31,12215,12747,24962
66,66088,2013-12-31,12226,12602,24828
66,66088,2014-12-31,12261,12542,24803
66,66088,2015-12-31,12276,12408,24684
66,66088,2016-12-31,12429,12374,24803
66,66088,2017-12-31,12356,12313,24669
66,66088,2018-12-31,12460,12230,24690
66,66088,2019-12-31,12615,12045,24660
66,66088,2020-12-31,12786,11922,24708
66,66088,2021-12-31,13160,11739,24899
66,66088,2022-12-31,13432,11703,25135
66,66088,2023-12-31,13678,11721,25399
66,66088,2024-12-31,13844,11735,25579
66,66088,2025-12-31,14001,11774,25775
66,66088,2026-12-31,14145,11839,25984
66,66088,2027-12-31,14286,11934,26220
66,66088,2028-12-31,14397,12031,26428
66,66088,2029-12-31,14496,12151,26647
66,66088,2030-12-31,14578,12292,26870
66,66088,2031-12-31,14653,12425,27078
66,66088,2032-12-31,14734,12574,27308
66,66088,2033-12-31,14791,12720,27511
66,66088,2034-12-31,14859,12865,27724
66,66088,2035-12-31,14908,13027,27935
66,66170,1985-12-31,100294,9387,109681
66,66170,1986-12-31,104391,9480,113871
66,66170,1987-12-31,108467,9584,118051
66,66170,1988-12-31,112570,9682,122252
66,66170,1989-12-31,116633,9796,126429
66,66170,1990-12-31,120672,9903,130575
66,66170,1991-12-31,124696,10018,134714
66,66170,1992-12-31,128805,10148,138953
66,66170,1993-12-31,133084,10269,143353
66,66170,1994-12-31,137186,10402,147588
66,66170,1995-12-31,141265,10523,151788
66,66170,1996-12-31,145237,10653,155890
66,66170,1997-12-31,149097,10781,159878
66,66170,1998-12-31,152822,10880,163702
66,66170,1999-12-31,156352,10962,167314
66,66170,2000-12-31,159651,11081,170732
66,66170,2001-12-31,162766,11174,173940
66,66170,2002-12-31,165654,11259,176913
66,66170,2003-12-31,168400,11347,179747
66,66170,2004-12-31,171128,11426,182554
66,66170,2005-12-31,173821,11519,185340
66,66170,2006-12-31,176518,11605,188123
66,66170,2007-12-31,179117,11707,190824
66,66170,2008-12-31,181436,11768,193204
66,66170,2009-12-31,183741,11864,195605
66,66170,2010-12-31,186121,11972,198093
66,66170,2011-12-31,188419,12122,200541
66,66170,2012-12-31,190582,12164,202746
66,66170,2013-12-31,192544,12227,204771
66,66170,2014-12-31,194474,12312,206786
66,66170,2015-12-31,196641,12470,209111
66,66170,2016-12-31,199007,12585,211592
66,66170,2017-12-31,201469,12694,214163
66,66170,2018-12-31,204280,12898,217178
66,66170,2019-12-31,209127,11644,220771
66,66170,2020-12-31,213520,10262,223782
66,66170,2021-12-31,215452,10102,225554
66,66170,2022-12-31,217624,10072,227696
66,66170,2023-12-31,219999,10087,230086
66,66170,2024-12-31,222637,10131,232768
66,66170,2025-12-31,225161,10176,235337
66,66170,2026-12-31,227498,10236,237734
66,66170,2027-12-31,229606,10288,239894
66,66170,2028-12-31,231504,10383,241887
66,66170,2029-12-31,233149,10468,243617
66,66170,2030-12-31,234501,10590,245091
66,66170,2031-12-31,235689,10715,246404
66,66170,2032-12-31,236814,10834,247648
66,66170,2033-12-31,237881,10974,248855
66,66170,2034-12-31,238889,11085,249974
66,66170,2035-12-31,239864,11207,251071
66,66318,1985-12-31,2660,11701,14361
66,66318,1986-12-31,2660,11587,14247
66,66318,1987-12-31,2691,11480,14171
66,66318,1988-12-31,2762,11359,14121
66,66318,1989-12-31,2872,11250,14122
66,66318,1990-12-31,2934,11159,14093
66,66318,1991-12-31,2935,11061,13996
66,66318,1992-12-31,2991,10964,13955
66,66318,1993-12-31,3045,10887,13932
66,66318,1994-12-31,3094,10796,13890
66,66318,1995-12-31,3124,10730,13854
66,66318,1996-12-31,3175,10647,13822
66,66318,1997-12-31,3206,10554,13760
66,66318,1998-12-31,3243,10466,13709
66,66318,1999-12-31,3266,10363,13629
66,66318,2000-12-31,3317,10264,13581
66,66318,2001-12-31,3330,10163,13493
66,66318,2002-12-31,3335,10042,13377
66,66318,2003-12-31,3356,9941,13297
66,66318,2004-12-31,3388,9815,13203
66,66318,2005-12-31,3402,9716,13118
66,66318,2006-12-31,3429,9626,13055
66,66318,2007-12-31,3402,9510,12912
66,66318,2008-12-31,3412,9423,12835
66,66318,2009-12-31,3412,9337,12749
66,66318,2010-12-31,3475,9250,12725
66,66318,2011-12-31,3500,9117,12617
66,66318,2012-12-31,3492,9006,12498
66,66318,2013-12-31,3485,8945,12430
66,66318,2014-12-31,3494,8892,12386
66,66318,2015-12-31,3501,8753,12254
66,66318,2016-12-31,3520,8675,12195
66,66318,2017-12-31,3534,8626,12160
66,66318,2018-12-31,3558,8600,12158
66,66318,2019-12-31,3621,8487,12108
66,66318,2020-12-31,3683,8427,12110
66,66318,2021-12-31,3906,8297,12203
66,66318,2022-12-31,4046,8273,12319
66,66318,2023-12-31,4164,8285,12449
66,66318,2024-12-31,4218,8312,12530
66,66318,2025-12-31,4264,8344,12608
66,66318,2026-12-31,4312,8379,12691
66,66318,2027-12-31,4355,8430,12785
66,66318,2028-12-31,4393,8503,12896
66,66318,2029-12-31,4421,8605,13026
66,66318,2030-12-31,4444,8696,13140
66,66318,2031-12-31,4455,8786,13241
66,66318,2032-12-31,4488,8898,13386
66,66318,2033-12-31,4503,8980,13483
66,66318,2034-12-31,4539,9099,13638
66,66318,2035-12-31,4552,9193,13745
66,66383,1985-12-31,2942,6386,9328
66,66383,1986-12-31,2924,6332,9256
66,66383,1987-12-31,2960,6250,9210
66,66383,1988-12-31,2999,6199,9198
66,66383,1989-12-31,3010,6119,9129
66,66383,1990-12-31,3038,6073,9111
66,66383,1991-12-31,3038,6014,9052
66,66383,1992-12-31,3041,5965,9006
66,66383,1993-12-31,3065,5924,8989
66,66383,1994-12-31,3073,5864,8937
66,66383,1995-12-31,3088,5829,8917
66,66383,1996-12-31,3105,5784,8889
66,66383,1997-12-31,3105,5733,8838
66,66383,1998-12-31,3125,5683,8808
66,66383,1999-12-31,3118,5629,8747
66,66383,2000-12-31,3114,5585,8699
66,66383,2001-12-31,3112,5515,8627
66,66383,2002-12-31,3096,5445,8541
66,66383,2003-12-31,3096,5372,8468
66,66383,2004-12-31,3072,5305,8377
66,66383,2005-12-31,3061,5247,8308
66,66383,2006-12-31,3042,5204,8246
66,66383,2007-12-31,3029,5169,8198
66,66383,2008-12-31,3020,5112,8132
66,66383,2009-12-31,2996,4989,7985
66,66383,2010-12-31,2972,4907,7879
66,66383,2011-12-31,3045,4870,7915
66,66383,2012-12-31,3011,4882,7893
66,66383,2013-12-31,2943,4854,7797
66,66383,2014-12-31,2862,4811,7673
66,66383,2015-12-31,2856,4777,7633
66,66383,2016-12-31,2852,4716,7568
66,66383,2017-12-31,2861,4618,7479
66,66383,2018-12-31,2881,4633,7514
66,66383,2019-12-31,2887,4561,7448
66,66383,2020-12-31,2907,4519,7426
66,66383,2021-12-31,3034,4449,7483
66,66383,2022-12-31,3118,4436,7554
66,66383,2023-12-31,3191,4443,7634
66,66383,2024-12-31,3232,4451,7683
66,66383,2025-12-31,3273,4473,7746
66,66383,2026-12-31,3305,4494,7799
66,66383,2027-12-31,3342,4523,7865
66,66383,2028-12-31,3367,4563,7930
66,66383,2029-12-31,3382,4598,7980
66,66383,2030-12-31,3402,4662,8064
66,66383,2031-12-31,3413,4721,8134
66,66383,2032-12-31,3440,4760,8200
66,66383,2033-12-31,3456,4825,8281
66,66383,2034-12-31,3461,4879,8340
66,66383,2035-12-31,3483,4924,8407
66,66400,1985-12-31,25538,735,26273
66,66400,1986-12-31,25800,698,26498
66,66400,1987-12-31,26024,732,26756
66,66400,1988-12-31,26279,719,26998
66,66400,1989-12-31,26498,723,27221
66,66400,1990-12-31,26712,709,27421
66,66400,1991-12-31,26913,707,27620
66,66400,1992-12-31,27113,711,27824
66,66400,1993-12-31,27359,707,28066
66,66400,1994-12-31,27560,712,28272
66,66400,1995-12-31,27746,705,28451
66,66400,1996-12-31,27927,737,28664
66,66400,1997-12-31,28053,699,28752
66,66400,1998-12-31,28169,739,28908
66,66400,1999-12-31,28236,697,28933
66,66400,2000-12-31,28292,697,28989
66,66400,2001-12-31,28292,681,28973
66,66400,2002-12-31,28260,679,28939
66,66400,2003-12-31,28211,699,28910
66,66400,2004-12-31,28165,701,28866
66,66400,2005-12-31,28110,714,28824
66,66400,2006-12-31,28063,718,28781
66,66400,2007-12-31,28005,690,28695
66,66400,2008-12-31,27909,693,28602
66,66400,2009-12-31,27830,686,28516
66,66400,2010-12-31,27761,690,28451
66,66400,2011-12-31,27678,703,28381
66,66400,2012-12-31,27594,695,28289
66,66400,2013-12-31,27478,705,28183
66,66400,2014-12-31,27348,708,28056
66,66400,2015-12-31,27264,710,27974
66,66400,2016-12-31,27231,708,27939
66,66400,2017-12-31,27231,712,27943
66,66400,2018-12-31,27189,734,27923
66,66400,2019-12-31,27231,685,27916
66,66400,2020-12-31,27350,631,27981
66,66400,2021-12-31,27576,621,28197
66,66400,2022-12-31,27846,619,28465
66,66400,2023-12-31,28143,620,28763
66,66400,2024-12-31,28458,619,29077
66,66400,2025-12-31,28766,616,29382
66,66400,2026-12-31,29068,620,29688
66,66400,2027-12-31,29333,625,29958
66,66400,2028-12-31,29573,631,30204
66,66400,2029-12-31,29774,644,30418
66,66400,2030-12-31,29957,648,30605
66,66400,2031-12-31,30108,645,30753
66,66400,2032-12-31,30242,653,30895
66,66400,2033-12-31,30387,663,31050
66,66400,2034-12-31,30510,684,31194
66,66400,2035-12-31,30631,691,31322
66,66440,1985-12-31,8404,13704,22108
66,66440,1986-12-31,8478,13527,22005
66,66440,1987-12-31,8574,13339,21913
66,66440,1988-12-31,8617,13148,21765
66,66440,1989-12-31,8695,12949,21644
66,66440,1990-12-31,8715,12777,21492
66,66440,1991-12-31,8775,12612,21387
66,66440,1992-12-31,8821,12444,21265
66,66440,1993-12-31,8902,12322,21224
66,66440,1994-12-31,8946,12176,21122
66,66440,1995-12-31,9007,12029,21036
66,66440,1996-12-31,9036,11882,20918
66,66440,1997-12-31,9063,11708,20771
66,66440,1998-12-31,9076,11566,20642
66,66440,1999-12-31,9095,11416,20511
66,66440,2000-12-31,9096,11208,20304
66,66440,2001-12-31,9087,11062,20149
66,66440,2002-12-31,9060,10904,19964
66,66440,2003-12-31,9035,10684,19719
66,66440,2004-12-31,9012,10544,19556
66,66440,2005-12-31,8957,10334,19291
66,66440,2006-12-31,8942,10204,19146
66,66440,2007-12-31,8917,10007,18924
66,66440,2008-12-31,8869,9841,18710
66,66440,2009-12-31,8832,9677,18509
66,66440,2010-12-31,8794,9535,18329
66,66440,2011-12-31,8767,9365,18132
66,66440,2012-12-31,8722,9202,17924
66,66440,2013-12-31,8650,9066,17716
66,66440,2014-12-31,8652,8904,17556
66,66440,2015-12-31,8629,8793,17422
66,66440,2016-12-31,8602,8651,17253
66,66440,2017-12-31,8505,8553,17058
66,66440,2018-12-31,8521,8419,16940
66,66440,2019-12-31,8669,8113,16782
66,66440,2020-12-31,8813,7903,16716
66,66440,2021-12-31,9065,7780,16845
66,66440,2022-12-31,9248,7757,17005
66,66440,2023-12-31,9415,7768,17183
66,66440,2024-12-31,9527,7780,17307
66,66440,2025-12-31,9638,7819,17457
66,66440,2026-12-31,9738,7863,17601
66,66440,2027-12-31,9829,7918,17747
66,66440,2028-12-31,9921,7972,17893
66,66440,2029-12-31,9983,8062,18045
66,66440,2030-12-31,10035,8120,18155
66,66440,2031-12-31,10088,8249,18337
66,66440,2032-12-31,10130,8336,18466
66,66440,2033-12-31,10199,8430,18629
66,66440,2034-12-31,10227,8532,18759
66,66440,2035-12-31,10262,8623,18885
66,66456,1985-12-31,3121,8000,11121
66,66456,1986-12-31,3144,8164,11308
66,66456,1987-12-31,3213,8314,11527
66,66456,1988-12-31,3257,8467,11724
66,66456,1989-12-31,3307,8627,11934
66,66456,1990-12-31,3344,8773,12117
66,66456,1991-12-31,3387,8928,12315
66,66456,1992-12-31,3442,9113,12555
66,66456,1993-12-31,3486,9291,12777
66,66456,1994-12-31,3508,9453,12961
66,66456,1995-12-31,3559,9619,13178
66,66456,1996-12-31,3599,9801,13400
66,66456,1997-12-31,3642,9971,13613
66,66456,1998-12-31,3668,10133,13801
66,66456,1999-12-31,3694,10292,13986
66,66456,2000-12-31,3722,10438,14160
66,66456,2001-12-31,3748,10563,14311
66,66456,2002-12-31,3765,10668,14433
66,66456,2003-12-31,3789,10813,14602
66,66456,2004-12-31,3794,10947,14741
66,66456,2005-12-31,3804,11096,14900
66,66456,2006-12-31,3816,11202,15018
66,66456,2007-12-31,3831,11358,15189
66,66456,2008-12-31,3838,11482,15320
66,66456,2009-12-31,3846,11596,15442
66,66456,2010-12-31,3816,11772,15588
66,66456,2011-12-31,3824,11930,15754
66,66456,2012-12-31,3868,12094,15962
66,66456,2013-12-31,3913,12227,16140
66,66456,2014-12-31,3868,12362,16230
66,66456,2015-12-31,3828,12497,16325
66,66456,2016-12-31,3837,12675,16512
66,66456,2017-12-31,3856,12843,16699
66,66456,2018-12-31,3892,13058,16950
66,66456,2019-12-31,3929,13181,17110
66,66456,2020-12-31,3974,13283,17257
66,66456,2021-12-31,4311,13079,17390
66,66456,2022-12-31,4516,13039,17555
66,66456,2023-12-31,4681,13059,17740
66,66456,2024-12-31,4742,13077,17819
66,66456,2025-12-31,4791,13133,17924
66,66456,2026-12-31,4845,13227,18072
66,66456,2027-12-31,4894,13342,18236
66,66456,2028-12-31,4926,13457,18383
66,66456,2029-12-31,4967,13595,18562
66,66456,2030-12-31,4992,13766,18758
66,66456,2031-12-31,5010,13928,18938
66,66456,2032-12-31,5038,14095,19133
66,66456,2033-12-31,5056,14277,19333
66,66456,2034-12-31,5089,14446,19535
66,66456,2035-12-31,5105,14630,19735
66,66572,1985-12-31,1899,8815,10714
66,66572,1986-12-31,2021,8952,10973
66,66572,1987-12-31,2033,9102,11135
66,66572,1988-12-31,2060,9247,11307
66,66572,1989-12-31,2102,9388,11490
66,66572,1990-12-31,2149,9531,11680
66,66572,1991-12-31,2165,9676,11841
66,66572,1992-12-31,2240,9830,12070
66,66572,1993-12-31,2276,9993,12269
66,66572,1994-12-31,2312,10154,12466
66,66572,1995-12-31,2348,10317,12665
66,66572,1996-12-31,2369,10449,12818
66,66572,1997-12-31,2423,10615,13038
66,66572,1998-12-31,2444,10752,13196
66,66572,1999-12-31,2475,10902,13377
66,66572,2000-12-31,2485,11032,13517
66,66572,2001-12-31,2505,11155,13660
66,66572,2002-12-31,2517,11268,13785
66,66572,2003-12-31,2538,11381,13919
66,66572,2004-12-31,2567,11500,14067
66,66572,2005-12-31,2577,11602,14179
66,66572,2006-12-31,2596,11723,14319
66,66572,2007-12-31,2602,11862,14464
66,66572,2008-12-31,2601,11974,14575
66,66572,2009-12-31,2629,12095,14724
66,66572,2010-12-31,2635,12217,14852
66,66572,2011-12-31,2654,12382,15036
66,66572,2012-12-31,2645,12518,15163
66,66572,2013-12-31,2658,12646,15304
66,66572,2014-12-31,2671,12777,15448
66,66572,2015-12-31,2696,12900,15596
66,66572,2016-12-31,2706,13073,15779
66,66572,2017-12-31,2721,13222,15943
66,66572,2018-12-31,2740,13416,16156
66,66572,2019-12-31,2773,13536,16309
66,66572,2020-12-31,2810,13640,16450
66,66572,2021-12-31,3147,13430,16577
66,66572,2022-12-31,3344,13390,16734
66,66572,2023-12-31,3500,13410,16910
66,66572,2024-12-31,3549,13441,16990
66,66572,2025-12-31,3587,13512,17099
66,66572,2026-12-31,3623,13598,17221
66,66572,2027-12-31,3655,13694,17349
66,66572,2028-12-31,3689,13806,17495
66,66572,2029-12-31,3720,13964,17684
66,66572,2030-12-31,3740,14129,17869
66,66572,2031-12-31,3756,14305,18061
66,66572,2032-12-31,3775,14494,18269
66,66572,2033-12-31,3789,14675,18464
66,66572,2034-12-31,3809,14852,18661
66,66572,2035-12-31,3815,15037,18852
66,66594,1985-12-31,6146,25049,31195
66,66594,1986-12-31,6240,24863,31103
66,66594,1987-12-31,6301,24667,30968
66,66594,1988-12-31,6373,24498,30871
66,66594,1989-12-31,6447,24338,30785
66,66594,1990-12-31,6537,24144,30681
66,66594,1991-12-31,6614,23979,30593
66,66594,1992-12-31,6669,23841,30510
66,66594,1993-12-31,6741,23742,30483
66,66594,1994-12-31,6825,23622,30447
66,66594,1995-12-31,6891,23495,30386
66,66594,1996-12-31,6956,23365,30321
66,66594,1997-12-31,7011,23250,30261
66,66594,1998-12-31,7057,23098,30155
66,66594,1999-12-31,7100,22944,30044
66,66594,2000-12-31,7133,22776,29909
66,66594,2001-12-31,7152,22587,29739
66,66594,2002-12-31,7182,22393,29575
66,66594,2003-12-31,7186,22187,29373
66,66594,2004-12-31,7189,21993,29182
66,66594,2005-12-31,7202,21824,29026
66,66594,2006-12-31,7217,21664,28881
66,66594,2007-12-31,7207,21507,28714
66,66594,2008-12-31,7207,21324,28531
66,66594,2009-12-31,7195,21168,28363
66,66594,2010-12-31,7197,21034,28231
66,66594,2011-12-31,7213,20894,28107
66,66594,2012-12-31,7206,20732,27938
66,66594,2013-12-31,7136,20542,27678
66,66594,2014-12-31,7233,20332,27565
66,66594,2015-12-31,7221,20236,27457
66,66594,2016-12-31,7139,20090,27229
66,66594,2017-12-31,7159,20022,27181
66,66594,2018-12-31,7209,20083,27292
66,66594,2019-12-31,7272,19963,27235
66,66594,2020-12-31,7351,19923,27274
66,66594,2021-12-31,7868,19616,27484
66,66594,2022-12-31,8188,19558,27746
66,66594,2023-12-31,8450,19587,28037
66,66594,2024-12-31,8554,19641,28195
66,66594,2025-12-31,8657,19711,28368
66,66594,2026-12-31,8741,19800,28541
66,66594,2027-12-31,8825,19935,28760
66,66594,2028-12-31,8904,20128,29032
66,66594,2029-12-31,8960,20298,29258
66,66594,2030-12-31,9022,20545,29567
66,66594,2031-12-31,9067,20781,29848
66,66594,2032-12-31,9101,21029,30130
66,66594,2033-12-31,9145,21274,30419
66,66594,2034-12-31,9188,21508,30696
66,66594,2035-12-31,9218,21744,30962
66,66682,1985-12-31,39295,27738,67033
66,66682,1986-12-31,40406,27231,67637
66,66682,1987-12-31,41498,26746,68244
66,66682,1988-12-31,42586,26250,68836
66,66682,1989-12-31,43673,25782,69455
66,66682,1990-12-31,44736,25303,70039
66,66682,1991-12-31,45796,24845,70641
66,66682,1992-12-31,46868,24401,71269
66,66682,1993-12-31,48013,23993,72006
66,66682,1994-12-31,49091,23590,72681
66,66682,1995-12-31,50139,23192,73331
66,66682,1996-12-31,51174,22778,73952
66,66682,1997-12-31,52145,22361,74506
66,66682,1998-12-31,53059,21933,74992
66,66682,1999-12-31,53924,21515,75439
66,66682,2000-12-31,54718,21059,75777
66,66682,2001-12-31,55446,20605,76051
66,66682,2002-12-31,56080,20125,76205
66,66682,2003-12-31,56685,19669,76354
66,66682,2004-12-31,57282,19195,76477
66,66682,2005-12-31,57864,18756,76620
66,66682,2006-12-31,58459,18341,76800
66,66682,2007-12-31,59030,17920,76950
66,66682,2008-12-31,59500,17450,76950
66,66682,2009-12-31,59966,17038,77004
66,66682,2010-12-31,60466,16615,77081
66,66682,2011-12-31,60956,16228,77184
66,66682,2012-12-31,61382,15824,77206
66,66682,2013-12-31,61775,15346,77121
66,66682,2014-12-31,62136,14906,77042
66,66682,2015-12-31,62592,14517,77109
66,66682,2016-12-31,63115,14181,77296
66,66682,2017-12-31,63648,13824,77472
66,66682,2018-12-31,64297,13541,77838
66,66682,2019-12-31,65452,13184,78636
66,66682,2020-12-31,66571,12801,79372
66,66682,2021-12-31,67398,12602,80000
66,66682,2022-12-31,68196,12564,80760
66,66682,2023-12-31,69025,12583,81608
66,66682,2024-12-31,69857,12612,82469
66,66682,2025-12-31,70650,12667,83317
66,66682,2026-12-31,71369,12746,84115
66,66682,2027-12-31,72032,12829,84861
66,66682,2028-12-31,72627,12927,85554
66,66682,2029-12-31,73139,13046,86185
66,66682,2030-12-31,73571,13170,86741
66,66682,2031-12-31,73941,13320,87261
66,66682,2032-12-31,74292,13478,87770
66,66682,2033-12-31,74622,13628,88250
66,66682,2034-12-31,74933,13796,88729
66,66682,2035-12-31,75243,13940,89183
66,66687,1985-12-31,6632,10694,17326
66,66687,1986-12-31,6635,10540,17175
66,66687,1987-12-31,6693,10391,17084
66,66687,1988-12-31,6741,10240,16981
66,66687,1989-12-31,6775,10099,16874
66,66687,1990-12-31,6805,9946,16751
66,66687,1991-12-31,6839,9801,16640
66,66687,1992-12-31,6862,9670,16532
66,66687,1993-12-31,6918,9564,16482
66,66687,1994-12-31,6947,9443,16390
66,66687,1995-12-31,6970,9313,16283
66,66687,1996-12-31,6979,9170,16149
66,66687,1997-12-31,7005,9051,16056
66,66687,1998-12-31,7009,8923,15932
66,66687,1999-12-31,6958,8789,15747
66,66687,2000-12-31,7029,8657,15686
66,66687,2001-12-31,6943,8509,15452
66,66687,2002-12-31,6931,8359,15290
66,66687,2003-12-31,6919,8225,15144
66,66687,2004-12-31,6859,8053,14912
66,66687,2005-12-31,6822,7918,14740
66,66687,2006-12-31,6823,7772,14595
66,66687,2007-12-31,6723,7640,14363
66,66687,2008-12-31,6732,7533,14265
66,66687,2009-12-31,6638,7436,14074
66,66687,2010-12-31,6579,7226,13805
66,66687,2011-12-31,6585,7077,13662
66,66687,2012-12-31,6552,6964,13516
66,66687,2013-12-31,6510,6865,13375
66,66687,2014-12-31,6498,6756,13254
66,66687,2015-12-31,6440,6641,13081
66,66687,2016-12-31,6307,6538,12845
66,66687,2017-12-31,6284,6467,12751
66,66687,2018-12-31,6328,6336,12664
66,66687,2019-12-31,6339,6167,12506
66,66687,2020-12-31,6375,6059,12434
66,66687,2021-12-31,6581,5949,12530
66,66687,2022-12-31,6724,5925,12649
66,66687,2023-12-31,6850,5932,12782
66,66687,2024-12-31,6940,5950,12890
66,66687,2025-12-31,7010,5962,12972
66,66687,2026-12-31,7086,6007,13093
66,66687,2027-12-31,7150,6036,13186
66,66687,2028-12-31,7209,6084,13293
66,66687,2029-12-31,7265,6147,13412
66,66687,2030-12-31,7302,6218,13520
66,66687,2031-12-31,7345,6299,13644
66,66687,2032-12-31,7378,6366,13744
66,66687,2033-12-31,7407,6433,13840
66,66687,2034-12-31,7442,6515,13957
66,66687,2035-12-31,7469,6582,14051
68,68001,1985-12-31,313665,11288,324953
68,68001,1986-12-31,320280,11270,331550
68,68001,1987-12-31,327936,11171,339107
68,68001,1988-12-31,335663,10998,346661
68,68001,1989-12-31,343487,10867,354354
68,68001,1990-12-31,351422,10738,362160
68,68001,1991-12-31,359572,10613,370185
68,68001,1992-12-31,367883,10499,378382
68,68001,1993-12-31,376195,11041,387236
68,68001,1994-12-31,384695,11017,395712
68,68001,1995-12-31,393396,10999,404395
68,68001,1996-12-31,402074,10984,413058
68,68001,1997-12-31,410765,10964,421729
68,68001,1998-12-31,419296,10933,430229
68,68001,1999-12-31,427534,10854,438388
68,68001,2000-12-31,435767,10862,446629
68,68001,2001-12-31,443687,10831,454518
68,68001,2002-12-31,451536,10805,462341
68,68001,2003-12-31,459134,10771,469905
68,68001,2004-12-31,466798,10749,477547
68,68001,2005-12-31,474266,10696,484962
68,68001,2006-12-31,482029,10664,492693
68,68001,2007-12-31,489630,10630,500260
68,68001,2008-12-31,497031,10574,507605
68,68001,2009-12-31,504359,10508,514867
68,68001,2010-12-31,511638,10467,522105
68,68001,2011-12-31,518545,10439,528984
68,68001,2012-12-31,525238,10379,535617
68,68001,2013-12-31,531764,10334,542098
68,68001,2014-12-31,538132,10315,548447
68,68001,2015-12-31,544592,10293,554885
68,68001,2016-12-31,551843,10280,562123
68,68001,2017-12-31,559972,10281,570253
68,68001,2018-12-31,570752,10378,581130
68,68001,2019-12-31,585338,10297,595635
68,68001,2020-12-31,597316,10112,607428
68,68001,2021-12-31,604186,10083,614269
68,68001,2022-12-31,608947,10020,618967
68,68001,2023-12-31,613428,9950,623378
68,68001,2024-12-31,618055,9897,627952
68,68001,2025-12-31,622545,9847,632392
68,68001,2026-12-31,626885,9798,636683
68,68001,2027-12-31,630971,9770,640741
68,68001,2028-12-31,634836,9755,644591
68,68001,2029-12-31,638448,9739,648187
68,68001,2030-12-31,641794,9729,651523
68,68001,2031-12-31,644961,9744,654705
68,68001,2032-12-31,648004,9758,657762
68,68001,2033-12-31,650986,9749,660735
68,68001,2034-12-31,653830,9750,663580
68,68001,2035-12-31,656489,9723,666212
68,68013,1985-12-31,138,2163,2301
68,68013,1986-12-31,151,2100,2251
68,68013,1987-12-31,162,2071,2233
68,68013,1988-12-31,170,2065,2235
68,68013,1989-12-31,160,2049,2209
68,68013,1990-12-31,176,2033,2209
68,68013,1991-12-31,180,1954,2134
68,68013,1992-12-31,182,1933,2115
68,68013,1993-12-31,185,1968,2153
68,68013,1994-12-31,187,1959,2146
68,68013,1995-12-31,191,1938,2129
68,68013,1996-12-31,197,1926,2123
68,68013,1997-12-31,193,1889,2082
68,68013,1998-12-31,195,1902,2097
68,68013,1999-12-31,205,1869,2074
68,68013,2000-12-31,247,1851,2098
68,68013,2001-12-31,248,1839,2087
68,68013,2002-12-31,248,1827,2075
68,68013,2003-12-31,249,1806,2055
68,68013,2004-12-31,250,1793,2043
68,68013,2005-12-31,282,1778,2060
68,68013,2006-12-31,282,1755,2037
68,68013,2007-12-31,281,1722,2003
68,68013,2008-12-31,281,1722,2003
68,68013,2009-12-31,285,1732,2017
68,68013,2010-12-31,287,1692,1979
68,68013,2011-12-31,292,1650,1942
68,68013,2012-12-31,292,1624,1916
68,68013,2013-12-31,295,1599,1894
68,68013,2014-12-31,296,1572,1868
68,68013,2015-12-31,299,1558,1857
68,68013,2016-12-31,302,1543,1845
68,68013,2017-12-31,305,1539,1844
68,68013,2018-12-31,313,1542,1855
68,68013,2019-12-31,321,1537,1858
68,68013,2020-12-31,328,1539,1867
68,68013,2021-12-31,354,1534,1888
68,68013,2022-12-31,377,1525,1902
68,68013,2023-12-31,401,1515,1916
68,68013,2024-12-31,411,1511,1922
68,68013,2025-12-31,419,1498,1917
68,68013,2026-12-31,428,1492,1920
68,68013,2027-12-31,437,1478,1915
68,68013,2028-12-31,438,1479,1917
68,68013,2029-12-31,437,1483,1920
68,68013,2030-12-31,440,1483,1923
68,68013,2031-12-31,437,1478,1915
68,68013,2032-12-31,441,1477,1918
68,68013,2033-12-31,435,1479,1914
68,68013,2034-12-31,438,1476,1914
68,68013,2035-12-31,439,1474,1913
68,68020,1985-12-31,315,5660,5975
68,68020,1986-12-31,351,5619,5970
68,68020,1987-12-31,357,5483,5840
68,68020,1988-12-31,331,5320,5651
68,68020,1989-12-31,370,5258,5628
68,68020,1990-12-31,352,5091,5443
68,68020,1991-12-31,334,4988,5322
68,68020,1992-12-31,342,4871,5213
68,68020,1993-12-31,364,5119,5483
68,68020,1994-12-31,404,5056,5460
68,68020,1995-12-31,347,4999,5346
68,68020,1996-12-31,394,4943,5337
68,68020,1997-12-31,408,4870,5278
68,68020,1998-12-31,408,4802,5210
68,68020,1999-12-31,415,4723,5138
68,68020,2000-12-31,462,4653,5115
68,68020,2001-12-31,472,4578,5050
68,68020,2002-12-31,467,4513,4980
68,68020,2003-12-31,491,4447,4938
68,68020,2004-12-31,465,4357,4822
68,68020,2005-12-31,448,4341,4789
68,68020,2006-12-31,459,4260,4719
68,68020,2007-12-31,468,4171,4639
68,68020,2008-12-31,480,4124,4604
68,68020,2009-12-31,495,4056,4551
68,68020,2010-12-31,512,4000,4512
68,68020,2011-12-31,515,3943,4458
68,68020,2012-12-31,536,3882,4418
68,68020,2013-12-31,541,3822,4363
68,68020,2014-12-31,551,3765,4316
68,68020,2015-12-31,569,3710,4279
68,68020,2016-12-31,580,3673,4253
68,68020,2017-12-31,589,3586,4175
68,68020,2018-12-31,597,3532,4129
68,68020,2019-12-31,615,3627,4242
68,68020,2020-12-31,630,3706,4336
68,68020,2021-12-31,690,3695,4385
68,68020,2022-12-31,746,3672,4418
68,68020,2023-12-31,802,3648,4450
68,68020,2024-12-31,815,3630,4445
68,68020,2025-12-31,837,3602,4439
68,68020,2026-12-31,847,3596,4443
68,68020,2027-12-31,851,3580,4431
68,68020,2028-12-31,856,3573,4429
68,68020,2029-12-31,864,3576,4440
68,68020,2030-12-31,866,3571,4437
68,68020,2031-12-31,872,3572,4444
68,68020,2032-12-31,885,3561,4446
68,68020,2033-12-31,893,3557,4450
68,68020,2034-12-31,898,3539,4437
68,68020,2035-12-31,905,3516,4421
68,68051,1985-12-31,878,6217,7095
68,68051,1986-12-31,929,6232,7161
68,68051,1987-12-31,989,6106,7095
68,68051,1988-12-31,1040,6048,7088
68,68051,1989-12-31,1060,5978,7038
68,68051,1990-12-31,1124,5910,7034
68,68051,1991-12-31,1162,5848,7010
68,68051,1992-12-31,1229,5808,7037
68,68051,1993-12-31,1274,6122,7396
68,68051,1994-12-31,1324,6104,7428
68,68051,1995-12-31,1345,6100,7445
68,68051,1996-12-31,1387,6079,7466
68,68051,1997-12-31,1452,6076,7528
68,68051,1998-12-31,1492,6071,7563
68,68051,1999-12-31,1547,6066,7613
68,68051,2000-12-31,1595,6059,7654
68,68051,2001-12-31,1639,6059,7698
68,68051,2002-12-31,1656,6047,7703
68,68051,2003-12-31,1722,6025,7747
68,68051,2004-12-31,1754,5977,7731
68,68051,2005-12-31,1781,5946,7727
68,68051,2006-12-31,1848,5936,7784
68,68051,2007-12-31,1872,5934,7806
68,68051,2008-12-31,1930,5922,7852
68,68051,2009-12-31,1993,5914,7907
68,68051,2010-12-31,2030,5905,7935
68,68051,2011-12-31,2079,5894,7973
68,68051,2012-12-31,2105,5868,7973
68,68051,2013-12-31,2139,5891,8030
68,68051,2014-12-31,2244,5822,8066
68,68051,2015-12-31,2276,5771,8047
68,68051,2016-12-31,2297,5745,8042
68,68051,2017-12-31,2324,5803,8127
68,68051,2018-12-31,2380,5849,8229
68,68051,2019-12-31,2452,5916,8368
68,68051,2020-12-31,2513,5974,8487
68,68051,2021-12-31,2625,5956,8581
68,68051,2022-12-31,2726,5920,8646
68,68051,2023-12-31,2828,5880,8708
68,68051,2024-12-31,2884,5853,8737
68,68051,2025-12-31,2928,5813,8741
68,68051,2026-12-31,2954,5795,8749
68,68051,2027-12-31,2976,5773,8749
68,68051,2028-12-31,3016,5777,8793
68,68051,2029-12-31,3032,5759,8791
68,68051,2030-12-31,3060,5761,8821
68,68051,2031-12-31,3076,5754,8830
68,68051,2032-12-31,3099,5749,8848
68,68051,2033-12-31,3117,5749,8866
68,68051,2034-12-31,3135,5738,8873
68,68051,2035-12-31,3155,5730,8885
68,68077,1985-12-31,11535,4454,15989
68,68077,1986-12-31,11834,4554,16388
68,68077,1987-12-31,12194,4611,16805
68,68077,1988-12-31,12541,4674,17215
68,68077,1989-12-31,12896,4761,17657
68,68077,1990-12-31,13266,4805,18071
68,68077,1991-12-31,13618,4849,18467
68,68077,1992-12-31,13995,4913,18908
68,68077,1993-12-31,14358,5267,19625
68,68077,1994-12-31,14748,5385,20133
68,68077,1995-12-31,15128,5485,20613
68,68077,1996-12-31,15516,5603,21119
68,68077,1997-12-31,15894,5714,21608
68,68077,1998-12-31,16258,5825,22083
68,68077,1999-12-31,16637,5917,22554
68,68077,2000-12-31,17011,6030,23041
68,68077,2001-12-31,17383,6129,23512
68,68077,2002-12-31,17802,6245,24047
68,68077,2003-12-31,18174,6252,24426
68,68077,2004-12-31,18516,6363,24879
68,68077,2005-12-31,18862,6455,25317
68,68077,2006-12-31,19204,6542,25746
68,68077,2007-12-31,19554,6666,26220
68,68077,2008-12-31,19919,6753,26672
68,68077,2009-12-31,20227,6860,27087
68,68077,2010-12-31,20549,6959,27508
68,68077,2011-12-31,20892,7041,27933
68,68077,2012-12-31,21188,7101,28289
68,68077,2013-12-31,21390,7157,28547
68,68077,2014-12-31,21755,7252,29007
68,68077,2015-12-31,22032,7340,29372
68,68077,2016-12-31,22346,7438,29784
68,68077,2017-12-31,22754,7647,30401
68,68077,2018-12-31,23249,7801,31050
68,68077,2019-12-31,23970,7970,31940
68,68077,2020-12-31,24589,8064,32653
68,68077,2021-12-31,24981,8040,33021
68,68077,2022-12-31,25282,7991,33273
68,68077,2023-12-31,25572,7938,33510
68,68077,2024-12-31,25855,7889,33744
68,68077,2025-12-31,26135,7849,33984
68,68077,2026-12-31,26407,7818,34225
68,68077,2027-12-31,26657,7794,34451
68,68077,2028-12-31,26897,7786,34683
68,68077,2029-12-31,27104,7761,34865
68,68077,2030-12-31,27305,7755,35060
68,68077,2031-12-31,27506,7755,35261
68,68077,2032-12-31,27681,7758,35439
68,68077,2033-12-31,27838,7749,35587
68,68077,2034-12-31,28007,7732,35739
68,68077,2035-12-31,28149,7721,35870
68,68079,1985-12-31,1942,4990,6932
68,68079,1986-12-31,1925,5068,6993
68,68079,1987-12-31,1988,5093,7081
68,68079,1988-12-31,2070,5105,7175
68,68079,1989-12-31,2079,5149,7228
68,68079,1990-12-31,2118,5182,7300
68,68079,1991-12-31,2173,5206,7379
68,68079,1992-12-31,2206,5215,7421
68,68079,1993-12-31,2234,5569,7803
68,68079,1994-12-31,2303,5649,7952
68,68079,1995-12-31,2353,5731,8084
68,68079,1996-12-31,2351,5798,8149
68,68079,1997-12-31,2424,5877,8301
68,68079,1998-12-31,2440,5953,8393
68,68079,1999-12-31,2499,6037,8536
68,68079,2000-12-31,2533,6119,8652
68,68079,2001-12-31,2551,6195,8746
68,68079,2002-12-31,2577,6239,8816
68,68079,2003-12-31,2614,6292,8906
68,68079,2004-12-31,2657,6342,8999
68,68079,2005-12-31,2683,6391,9074
68,68079,2006-12-31,2709,6467,9176
68,68079,2007-12-31,2742,6543,9285
68,68079,2008-12-31,2785,6610,9395
68,68079,2009-12-31,2829,6691,9520
68,68079,2010-12-31,2865,6753,9618
68,68079,2011-12-31,2908,6817,9725
68,68079,2012-12-31,2943,6802,9745
68,68079,2013-12-31,2971,6869,9840
68,68079,2014-12-31,2971,6947,9918
68,68079,2015-12-31,2988,7006,9994
68,68079,2016-12-31,2992,7069,10061
68,68079,2017-12-31,3050,7216,10266
68,68079,2018-12-31,3113,7373,10486
68,68079,2019-12-31,3167,7507,10674
68,68079,2020-12-31,3221,7594,10815
68,68079,2021-12-31,3364,7571,10935
68,68079,2022-12-31,3493,7525,11018
68,68079,2023-12-31,3622,7475,11097
68,68079,2024-12-31,3689,7431,11120
68,68079,2025-12-31,3724,7399,11123
68,68079,2026-12-31,3772,7368,11140
68,68079,2027-12-31,3801,7347,11148
68,68079,2028-12-31,3837,7327,11164
68,68079,2029-12-31,3867,7333,11200
68,68079,2030-12-31,3901,7314,11215
68,68079,2031-12-31,3934,7317,11251
68,68079,2032-12-31,3955,7314,11269
68,68079,2033-12-31,3975,7312,11287
68,68079,2034-12-31,3989,7309,11298
68,68079,2035-12-31,4011,7279,11290
68,68081,1985-12-31,126159,16028,142187
68,68081,1986-12-31,127312,16359,143671
68,68081,1987-12-31,128859,16523,145382
68,68081,1988-12-31,130444,16713,147157
68,68081,1989-12-31,132046,16773,148819
68,68081,1990-12-31,133685,16970,150655
68,68081,1991-12-31,135396,17129,152525
68,68081,1992-12-31,137157,17268,154425
68,68081,1993-12-31,138914,18518,157432
68,68081,1994-12-31,140751,18840,159591
68,68081,1995-12-31,142639,19172,161811
68,68081,1996-12-31,144507,19506,164013
68,68081,1997-12-31,146369,19836,166205
68,68081,1998-12-31,148184,20158,168342
68,68081,1999-12-31,149901,20465,170366
68,68081,2000-12-31,151564,20759,172323
68,68081,2001-12-31,153165,21052,174217
68,68081,2002-12-31,154710,21334,176044
68,68081,2003-12-31,156166,21609,177775
68,68081,2004-12-31,157649,21867,179516
68,68081,2005-12-31,159086,22177,181263
68,68081,2006-12-31,160594,22447,183041
68,68081,2007-12-31,162054,22737,184791
68,68081,2008-12-31,163439,23021,186460
68,68081,2009-12-31,164817,23293,188110
68,68081,2010-12-31,166146,23581,189727
68,68081,2011-12-31,167377,23854,191231
68,68081,2012-12-31,168522,24151,192673
68,68081,2013-12-31,169651,24453,194104
68,68081,2014-12-31,170700,24746,195446
68,68081,2015-12-31,171798,25034,196832
68,68081,2016-12-31,173168,25345,198513
68,68081,2017-12-31,174780,25803,200583
68,68081,2018-12-31,177272,26265,203537
68,68081,2019-12-31,180595,26899,207494
68,68081,2020-12-31,183730,26999,210729
68,68081,2021-12-31,186137,26924,213061
68,68081,2022-12-31,187930,26759,214689
68,68081,2023-12-31,189638,26581,216219
68,68081,2024-12-31,191549,26434,217983
68,68081,2025-12-31,193478,26317,219795
68,68081,2026-12-31,195361,26211,221572
68,68081,2027-12-31,197171,26115,223286
68,68081,2028-12-31,198878,26060,224938
68,68081,2029-12-31,200468,26035,226503
68,68081,2030-12-31,201916,26049,227965
68,68081,2031-12-31,203279,26056,229335
68,68081,2032-12-31,204554,26047,230601
68,68081,2033-12-31,205788,26039,231827
68,68081,2034-12-31,206921,26007,232928
68,68081,2035-12-31,207968,25975,233943
68,68092,1985-12-31,916,4948,5864
68,68092,1986-12-31,914,4923,5837
68,68092,1987-12-31,960,4870,5830
68,68092,1988-12-31,991,4813,5804
68,68092,1989-12-31,1017,4780,5797
68,68092,1990-12-31,1008,4714,5722
68,68092,1991-12-31,1030,4667,5697
68,68092,1992-12-31,1010,4628,5638
68,68092,1993-12-31,1028,4855,5883
68,68092,1994-12-31,1048,4830,5878
68,68092,1995-12-31,1054,4852,5906
68,68092,1996-12-31,1093,4843,5936
68,68092,1997-12-31,1110,4846,5956
68,68092,1998-12-31,1089,4830,5919
68,68092,1999-12-31,1064,4833,5897
68,68092,2000-12-31,1097,4816,5913
68,68092,2001-12-31,1132,4801,5933
68,68092,2002-12-31,1160,4771,5931
68,68092,2003-12-31,1159,4742,5901
68,68092,2004-12-31,1167,4719,5886
68,68092,2005-12-31,1122,4711,5833
68,68092,2006-12-31,1133,4710,5843
68,68092,2007-12-31,1150,4680,5830
68,68092,2008-12-31,1162,4679,5841
68,68092,2009-12-31,1166,4685,5851
68,68092,2010-12-31,1175,4673,5848
68,68092,2011-12-31,1188,4674,5862
68,68092,2012-12-31,1206,4674,5880
68,68092,2013-12-31,1230,4658,5888
68,68092,2014-12-31,1243,4655,5898
68,68092,2015-12-31,1251,4635,5886
68,68092,2016-12-31,1271,4597,5868
68,68092,2017-12-31,1294,4591,5885
68,68092,2018-12-31,1313,4628,5941
68,68092,2019-12-31,1334,4669,6003
68,68092,2020-12-31,1355,4706,6061
68,68092,2021-12-31,1436,4692,6128
68,68092,2022-12-31,1512,4663,6175
68,68092,2023-12-31,1587,4632,6219
68,68092,2024-12-31,1627,4607,6234
68,68092,2025-12-31,1641,4575,6216
68,68092,2026-12-31,1654,4563,6217
68,68092,2027-12-31,1675,4549,6224
68,68092,2028-12-31,1691,4539,6230
68,68092,2029-12-31,1704,4546,6250
68,68092,2030-12-31,1713,4538,6251
68,68092,2031-12-31,1732,4542,6274
68,68092,2032-12-31,1741,4534,6275
68,68092,2033-12-31,1749,4541,6290
68,68092,2034-12-31,1763,4531,6294
68,68092,2035-12-31,1770,4514,6284
68,68101,1985-12-31,1618,20719,22337
68,68101,1986-12-31,1626,23649,25275
68,68101,1987-12-31,1620,26288,27908
68,68101,1988-12-31,1624,28902,30526
68,68101,1989-12-31,1608,31347,32955
68,68101,1990-12-31,1640,33825,35465
68,68101,1991-12-31,1631,36277,37908
68,68101,1992-12-31,1627,38684,40311
68,68101,1993-12-31,1630,18269,19899
68,68101,1994-12-31,1653,17956,19609
68,68101,1995-12-31,1652,17620,19272
68,68101,1996-12-31,1680,17265,18945
68,68101,1997-12-31,1596,16942,18538
68,68101,1998-12-31,1606,16601,18207
68,68101,1999-12-31,1622,16268,17890
68,68101,2000-12-31,1589,15915,17504
68,68101,2001-12-31,1600,15550,17150
68,68101,2002-12-31,1577,15167,16744
68,68101,2003-12-31,1591,14823,16414
68,68101,2004-12-31,1584,14466,16050
68,68101,2005-12-31,1567,14112,15679
68,68101,2006-12-31,1559,13732,15291
68,68101,2007-12-31,1566,13385,14951
68,68101,2008-12-31,1563,13021,14584
68,68101,2009-12-31,1552,12659,14211
68,68101,2010-12-31,1549,12305,13854
68,68101,2011-12-31,1515,11963,13478
68,68101,2012-12-31,1518,11618,13136
68,68101,2013-12-31,1519,11272,12791
68,68101,2014-12-31,1531,10931,12462
68,68101,2015-12-31,1523,10600,12123
68,68101,2016-12-31,1474,10295,11769
68,68101,2017-12-31,1473,10006,11479
68,68101,2018-12-31,1495,9792,11287
68,68101,2019-12-31,1511,9562,11073
68,68101,2020-12-31,1524,9456,10980
68,68101,2021-12-31,1675,9426,11101
68,68101,2022-12-31,1818,9368,11186
68,68101,2023-12-31,1960,9306,11266
68,68101,2024-12-31,2015,9248,11263
68,68101,2025-12-31,2040,9191,11231
68,68101,2026-12-31,2068,9152,11220
68,68101,2027-12-31,2093,9137,11230
68,68101,2028-12-31,2105,9112,11217
68,68101,2029-12-31,2129,9091,11220
68,68101,2030-12-31,2142,9089,11231
68,68101,2031-12-31,2154,9096,11250
68,68101,2032-12-31,2171,9095,11266
68,68101,2033-12-31,2184,9078,11262
68,68101,2034-12-31,2193,9072,11265
68,68101,2035-12-31,2208,9054,11262
68,68121,1985-12-31,246,2171,2417
68,68121,1986-12-31,237,2157,2394
68,68121,1987-12-31,250,2111,2361
68,68121,1988-12-31,245,2084,2329
68,68121,1989-12-31,246,2062,2308
68,68121,1990-12-31,342,2028,2370
68,68121,1991-12-31,342,2021,2363
68,68121,1992-12-31,350,1989,2339
68,68121,1993-12-31,356,1967,2323
68,68121,1994-12-31,336,1927,2263
68,68121,1995-12-31,304,1932,2236
68,68121,1996-12-31,333,1935,2268
68,68121,1997-12-31,334,1928,2262
68,68121,1998-12-31,295,1878,2173
68,68121,1999-12-31,359,1873,2232
68,68121,2000-12-31,369,1852,2221
68,68121,2001-12-31,343,1845,2188
68,68121,2002-12-31,348,1822,2170
68,68121,2003-12-31,351,1795,2146
68,68121,2004-12-31,356,1802,2158
68,68121,2005-12-31,373,1791,2164
68,68121,2006-12-31,365,1760,2125
68,68121,2007-12-31,356,1716,2072
68,68121,2008-12-31,393,1683,2076
68,68121,2009-12-31,389,1672,2061
68,68121,2010-12-31,398,1670,2068
68,68121,2011-12-31,393,1670,2063
68,68121,2012-12-31,394,1666,2060
68,68121,2013-12-31,385,1659,2044
68,68121,2014-12-31,377,1616,1993
68,68121,2015-12-31,377,1566,1943
68,68121,2016-12-31,379,1524,1903
68,68121,2017-12-31,378,1525,1903
68,68121,2018-12-31,395,1542,1937
68,68121,2019-12-31,407,1576,1983
68,68121,2020-12-31,417,1604,2021
68,68121,2021-12-31,444,1599,2043
68,68121,2022-12-31,470,1589,2059
68,68121,2023-12-31,495,1579,2074
68,68121,2024-12-31,513,1567,2080
68,68121,2025-12-31,520,1557,2077
68,68121,2026-12-31,523,1557,2080
68,68121,2027-12-31,523,1549,2072
68,68121,2028-12-31,529,1547,2076
68,68121,2029-12-31,533,1542,2075
68,68121,2030-12-31,536,1540,2076
68,68121,2031-12-31,539,1534,2073
68,68121,2032-12-31,544,1540,2084
68,68121,2033-12-31,547,1545,2092
68,68121,2034-12-31,552,1540,2092
68,68121,2035-12-31,552,1529,2081
68,68132,1985-12-31,350,786,1136
68,68132,1986-12-31,338,840,1178
68,68132,1987-12-31,378,860,1238
68,68132,1988-12-31,396,868,1264
68,68132,1989-12-31,411,870,1281
68,68132,1990-12-31,433,859,1292
68,68132,1991-12-31,439,858,1297
68,68132,1992-12-31,455,877,1332
68,68132,1993-12-31,480,931,1411
68,68132,1994-12-31,501,940,1441
68,68132,1995-12-31,530,942,1472
68,68132,1996-12-31,511,943,1454
68,68132,1997-12-31,571,938,1509
68,68132,1998-12-31,625,966,1591
68,68132,1999-12-31,637,974,1611
68,68132,2000-12-31,612,972,1584
68,68132,2001-12-31,645,961,1606
68,68132,2002-12-31,665,982,1647
68,68132,2003-12-31,687,1015,1702
68,68132,2004-12-31,703,1033,1736
68,68132,2005-12-31,730,1022,1752
68,68132,2006-12-31,738,1027,1765
68,68132,2007-12-31,742,1057,1799
68,68132,2008-12-31,756,1091,1847
68,68132,2009-12-31,778,1115,1893
68,68132,2010-12-31,795,1128,1923
68,68132,2011-12-31,850,1141,1991
68,68132,2012-12-31,863,1151,2014
68,68132,2013-12-31,870,1159,2029
68,68132,2014-12-31,881,1171,2052
68,68132,2015-12-31,890,1171,2061
68,68132,2016-12-31,900,1174,2074
68,68132,2017-12-31,914,1179,2093
68,68132,2018-12-31,931,1199,2130
68,68132,2019-12-31,964,1222,2186
68,68132,2020-12-31,993,1239,2232
68,68132,2021-12-31,1022,1235,2257
68,68132,2022-12-31,1046,1228,2274
68,68132,2023-12-31,1071,1220,2291
68,68132,2024-12-31,1084,1210,2294
68,68132,2025-12-31,1110,1205,2315
68,68132,2026-12-31,1117,1199,2316
68,68132,2027-12-31,1131,1201,2332
68,68132,2028-12-31,1151,1198,2349
68,68132,2029-12-31,1165,1196,2361
68,68132,2030-12-31,1168,1194,2362
68,68132,2031-12-31,1178,1193,2371
68,68132,2032-12-31,1191,1189,2380
68,68132,2033-12-31,1186,1188,2374
68,68132,2034-12-31,1197,1194,2391
68,68132,2035-12-31,1204,1192,2396
68,68147,1985-12-31,2822,4812,7634
68,68147,1986-12-31,2838,4721,7559
68,68147,1987-12-31,2847,4567,7414
68,68147,1988-12-31,2865,4459,7324
68,68147,1989-12-31,2877,4365,7242
68,68147,1990-12-31,2893,4251,7144
68,68147,1991-12-31,2908,4109,7017
68,68147,1992-12-31,2935,3967,6902
68,68147,1993-12-31,2973,4107,7080
68,68147,1994-12-31,3009,4023,7032
68,68147,1995-12-31,3071,3940,7011
68,68147,1996-12-31,3085,3861,6946
68,68147,1997-12-31,3119,3790,6909
68,68147,1998-12-31,3152,3712,6864
68,68147,1999-12-31,3177,3634,6811
68,68147,2000-12-31,3173,3508,6681
68,68147,2001-12-31,3192,3422,6614
68,68147,2002-12-31,3217,3343,6560
68,68147,2003-12-31,3234,3256,6490
68,68147,2004-12-31,3244,3169,6413
68,68147,2005-12-31,3248,3066,6314
68,68147,2006-12-31,3264,3020,6284
68,68147,2007-12-31,3292,2919,6211
68,68147,2008-12-31,3295,2863,6158
68,68147,2009-12-31,3313,2791,6104
68,68147,2010-12-31,3325,2704,6029
68,68147,2011-12-31,3340,2627,5967
68,68147,2012-12-31,3353,2534,5887
68,68147,2013-12-31,3371,2463,5834
68,68147,2014-12-31,3399,2368,5767
68,68147,2015-12-31,3426,2276,5702
68,68147,2016-12-31,3441,2221,5662
68,68147,2017-12-31,3381,2095,5476
68,68147,2018-12-31,3452,2053,5505
68,68147,2019-12-31,3490,1989,5479
68,68147,2020-12-31,3532,1947,5479
68,68147,2021-12-31,3599,1941,5540
68,68147,2022-12-31,3653,1929,5582
68,68147,2023-12-31,3706,1916,5622
68,68147,2024-12-31,3744,1910,5654
68,68147,2025-12-31,3787,1896,5683
68,68147,2026-12-31,3824,1887,5711
68,68147,2027-12-31,3867,1880,5747
68,68147,2028-12-31,3900,1874,5774
68,68147,2029-12-31,3930,1876,5806
68,68147,2030-12-31,3963,1879,5842
68,68147,2031-12-31,3983,1876,5859
68,68147,2032-12-31,4013,1879,5892
68,68147,2033-12-31,4037,1879,5916
68,68147,2034-12-31,4059,1874,5933
68,68147,2035-12-31,4079,1868,5947
68,68152,1985-12-31,1759,4561,6320
68,68152,1986-12-31,1735,4548,6283
68,68152,1987-12-31,1710,4480,6190
68,68152,1988-12-31,1654,4415,6069
68,68152,1989-12-31,1667,4364,6031
68,68152,1990-12-31,1593,4310,5903
68,68152,1991-12-31,1591,4235,5826
68,68152,1992-12-31,1577,4142,5719
68,68152,1993-12-31,1499,4337,5836
68,68152,1994-12-31,1483,4319,5802
68,68152,1995-12-31,1493,4280,5773
68,68152,1996-12-31,1430,4259,5689
68,68152,1997-12-31,1421,4227,5648
68,68152,1998-12-31,1387,4203,5590
68,68152,1999-12-31,1344,4180,5524
68,68152,2000-12-31,1298,4150,5448
68,68152,2001-12-31,1277,4111,5388
68,68152,2002-12-31,1213,4077,5290
68,68152,2003-12-31,1140,4052,5192
68,68152,2004-12-31,1106,4015,5121
68,68152,2005-12-31,1110,3983,5093
68,68152,2006-12-31,1087,3940,5027
68,68152,2007-12-31,1051,3934,4985
68,68152,2008-12-31,981,3899,4880
68,68152,2009-12-31,944,3900,4844
68,68152,2010-12-31,930,3851,4781
68,68152,2011-12-31,940,3827,4767
68,68152,2012-12-31,862,3824,4686
68,68152,2013-12-31,809,3804,4613
68,68152,2014-12-31,798,3743,4541
68,68152,2015-12-31,739,3689,4428
68,68152,2016-12-31,716,3670,4386
68,68152,2017-12-31,635,3647,4282
68,68152,2018-12-31,640,3652,4292
68,68152,2019-12-31,616,3647,4263
68,68152,2020-12-31,595,3664,4259
68,68152,2021-12-31,656,3650,4306
68,68152,2022-12-31,712,3627,4339
68,68152,2023-12-31,767,3603,4370
68,68152,2024-12-31,779,3575,4354
68,68152,2025-12-31,792,3558,4350
68,68152,2026-12-31,798,3547,4345
68,68152,2027-12-31,796,3531,4327
68,68152,2028-12-31,809,3529,4338
68,68152,2029-12-31,822,3521,4343
68,68152,2030-12-31,830,3517,4347
68,68152,2031-12-31,832,3521,4353
68,68152,2032-12-31,837,3528,4365
68,68152,2033-12-31,844,3524,4368
68,68152,2034-12-31,845,3510,4355
68,68152,2035-12-31,849,3503,4352
68,68160,1985-12-31,332,2113,2445
68,68160,1986-12-31,304,2044,2348
68,68160,1987-12-31,319,2013,2332
68,68160,1988-12-31,395,1989,2384
68,68160,1989-12-31,393,1978,2371
68,68160,1990-12-31,379,1956,2335
68,68160,1991-12-31,371,1900,2271
68,68160,1992-12-31,374,1863,2237
68,68160,1993-12-31,430,1935,2365
68,68160,1994-12-31,400,1889,2289
68,68160,1995-12-31,422,1876,2298
68,68160,1996-12-31,437,1847,2284
68,68160,1997-12-31,386,1846,2232
68,68160,1998-12-31,373,1831,2204
68,68160,1999-12-31,395,1818,2213
68,68160,2000-12-31,397,1781,2178
68,68160,2001-12-31,409,1779,2188
68,68160,2002-12-31,421,1756,2177
68,68160,2003-12-31,443,1748,2191
68,68160,2004-12-31,465,1715,2180
68,68160,2005-12-31,479,1703,2182
68,68160,2006-12-31,476,1684,2160
68,68160,2007-12-31,474,1666,2140
68,68160,2008-12-31,471,1652,2123
68,68160,2009-12-31,471,1638,2109
68,68160,2010-12-31,472,1625,2097
68,68160,2011-12-31,480,1614,2094
68,68160,2012-12-31,483,1607,2090
68,68160,2013-12-31,480,1570,2050
68,68160,2014-12-31,485,1543,2028
68,68160,2015-12-31,491,1524,2015
68,68160,2016-12-31,499,1487,1986
68,68160,2017-12-31,512,1485,1997
68,68160,2018-12-31,517,1498,2015
68,68160,2019-12-31,535,1483,2018
68,68160,2020-12-31,550,1475,2025
68,68160,2021-12-31,577,1470,2047
68,68160,2022-12-31,602,1461,2063
68,68160,2023-12-31,626,1452,2078
68,68160,2024-12-31,642,1437,2079
68,68160,2025-12-31,655,1434,2089
68,68160,2026-12-31,653,1424,2077
68,68160,2027-12-31,657,1420,2077
68,68160,2028-12-31,659,1412,2071
68,68160,2029-12-31,670,1409,2079
68,68160,2030-12-31,675,1408,2083
68,68160,2031-12-31,678,1409,2087
68,68160,2032-12-31,679,1418,2097
68,68160,2033-12-31,683,1414,2097
68,68160,2034-12-31,688,1410,2098
68,68160,2035-12-31,693,1408,2101
68,68162,1985-12-31,1838,4087,5925
68,68162,1986-12-31,1885,4085,5970
68,68162,1987-12-31,1929,4017,5946
68,68162,1988-12-31,1970,3970,5940
68,68162,1989-12-31,1997,3953,5950
68,68162,1990-12-31,2072,3884,5956
68,68162,1991-12-31,2122,3840,5962
68,68162,1992-12-31,2175,3767,5942
68,68162,1993-12-31,2223,3906,6129
68,68162,1994-12-31,2269,3890,6159
68,68162,1995-12-31,2323,3876,6199
68,68162,1996-12-31,2394,3854,6248
68,68162,1997-12-31,2426,3843,6269
68,68162,1998-12-31,2464,3823,6287
68,68162,1999-12-31,2522,3801,6323
68,68162,2000-12-31,2568,3774,6342
68,68162,2001-12-31,2614,3742,6356
68,68162,2002-12-31,2657,3723,6380
68,68162,2003-12-31,2695,3698,6393
68,68162,2004-12-31,2733,3666,6399
68,68162,2005-12-31,2772,3640,6412
68,68162,2006-12-31,2821,3629,6450
68,68162,2007-12-31,2854,3601,6455
68,68162,2008-12-31,2893,3605,6498
68,68162,2009-12-31,2952,3566,6518
68,68162,2010-12-31,2977,3570,6547
68,68162,2011-12-31,3017,3555,6572
68,68162,2012-12-31,3070,3511,6581
68,68162,2013-12-31,3120,3480,6600
68,68162,2014-12-31,3169,3443,6612
68,68162,2015-12-31,3211,3413,6624
68,68162,2016-12-31,3197,3399,6596
68,68162,2017-12-31,3248,3392,6640
68,68162,2018-12-31,3329,3400,6729
68,68162,2019-12-31,3430,3408,6838
68,68162,2020-12-31,3516,3417,6933
68,68162,2021-12-31,3604,3406,7010
68,68162,2022-12-31,3678,3385,7063
68,68162,2023-12-31,3751,3363,7114
68,68162,2024-12-31,3813,3344,7157
68,68162,2025-12-31,3854,3329,7183
68,68162,2026-12-31,3903,3321,7224
68,68162,2027-12-31,3938,3310,7248
68,68162,2028-12-31,3972,3301,7273
68,68162,2029-12-31,4001,3308,7309
68,68162,2030-12-31,4030,3289,7319
68,68162,2031-12-31,4063,3299,7362
68,68162,2032-12-31,4084,3296,7380
68,68162,2033-12-31,4114,3288,7402
68,68162,2034-12-31,4131,3284,7415
68,68162,2035-12-31,4153,3269,7422
68,68167,1985-12-31,5086,11075,16161
68,68167,1986-12-31,5146,10889,16035
68,68167,1987-12-31,5205,10635,15840
68,68167,1988-12-31,5255,10331,15586
68,68167,1989-12-31,5330,9991,15321
68,68167,1990-12-31,5387,9735,15122
68,68167,1991-12-31,5452,9497,14949
68,68167,1992-12-31,5519,9230,14749
68,68167,1993-12-31,5597,9590,15187
68,68167,1994-12-31,5658,9419,15077
68,68167,1995-12-31,5727,9223,14950
68,68167,1996-12-31,5800,9040,14840
68,68167,1997-12-31,5922,8862,14784
68,68167,1998-12-31,6024,8675,14699
68,68167,1999-12-31,6093,8484,14577
68,68167,2000-12-31,6174,8298,14472
68,68167,2001-12-31,6232,8124,14356
68,68167,2002-12-31,6290,7944,14234
68,68167,2003-12-31,6345,7740,14085
68,68167,2004-12-31,6411,7554,13965
68,68167,2005-12-31,6466,7347,13813
68,68167,2006-12-31,6525,7158,13683
68,68167,2007-12-31,6578,6974,13552
68,68167,2008-12-31,6642,6788,13430
68,68167,2009-12-31,6690,6609,13299
68,68167,2010-12-31,6758,6417,13175
68,68167,2011-12-31,6807,6225,13032
68,68167,2012-12-31,6863,6049,12912
68,68167,2013-12-31,6925,5854,12779
68,68167,2014-12-31,6937,5658,12595
68,68167,2015-12-31,6950,5501,12451
68,68167,2016-12-31,6976,5354,12330
68,68167,2017-12-31,7109,5209,12318
68,68167,2018-12-31,7218,5052,12270
68,68167,2019-12-31,7326,4930,12256
68,68167,2020-12-31,7434,4838,12272
68,68167,2021-12-31,7585,4823,12408
68,68167,2022-12-31,7710,4793,12503
68,68167,2023-12-31,7831,4761,12592
68,68167,2024-12-31,7921,4726,12647
68,68167,2025-12-31,8002,4713,12715
68,68167,2026-12-31,8086,4687,12773
68,68167,2027-12-31,8164,4675,12839
68,68167,2028-12-31,8224,4659,12883
68,68167,2029-12-31,8306,4650,12956
68,68167,2030-12-31,8360,4657,13017
68,68167,2031-12-31,8426,4653,13079
68,68167,2032-12-31,8471,4655,13126
68,68167,2033-12-31,8525,4645,13170
68,68167,2034-12-31,8576,4643,13219
68,68167,2035-12-31,8619,4635,13254
68,68169,1985-12-31,442,3299,3741
68,68169,1986-12-31,447,3220,3667
68,68169,1987-12-31,456,3159,3615
68,68169,1988-12-31,494,3124,3618
68,68169,1989-12-31,476,3096,3572
68,68169,1990-12-31,503,3023,3526
68,68169,1991-12-31,521,2965,3486
68,68169,1992-12-31,528,2908,3436
68,68169,1993-12-31,543,3021,3564
68,68169,1994-12-31,544,2989,3533
68,68169,1995-12-31,551,2961,3512
68,68169,1996-12-31,542,2915,3457
68,68169,1997-12-31,551,2875,3426
68,68169,1998-12-31,570,2860,3430
68,68169,1999-12-31,549,2798,3347
68,68169,2000-12-31,569,2791,3360
68,68169,2001-12-31,615,2728,3343
68,68169,2002-12-31,555,2704,3259
68,68169,2003-12-31,551,2683,3234
68,68169,2004-12-31,570,2644,3214
68,68169,2005-12-31,580,2590,3170
68,68169,2006-12-31,571,2588,3159
68,68169,2007-12-31,586,2529,3115
68,68169,2008-12-31,597,2457,3054
68,68169,2009-12-31,608,2427,3035
68,68169,2010-12-31,618,2431,3049
68,68169,2011-12-31,623,2396,3019
68,68169,2012-12-31,647,2378,3025
68,68169,2013-12-31,659,2346,3005
68,68169,2014-12-31,668,2319,2987
68,68169,2015-12-31,679,2249,2928
68,68169,2016-12-31,684,2184,2868
68,68169,2017-12-31,696,2166,2862
68,68169,2018-12-31,716,2172,2888
68,68169,2019-12-31,730,2153,2883
68,68169,2020-12-31,742,2146,2888
68,68169,2021-12-31,781,2139,2920
68,68169,2022-12-31,816,2126,2942
68,68169,2023-12-31,851,2112,2963
68,68169,2024-12-31,869,2090,2959
68,68169,2025-12-31,879,2080,2959
68,68169,2026-12-31,880,2063,2943
68,68169,2027-12-31,888,2056,2944
68,68169,2028-12-31,900,2060,2960
68,68169,2029-12-31,907,2060,2967
68,68169,2030-12-31,917,2065,2982
68,68169,2031-12-31,927,2057,2984
68,68169,2032-12-31,934,2059,2993
68,68169,2033-12-31,941,2061,3002
68,68169,2034-12-31,949,2056,3005
68,68169,2035-12-31,948,2052,3000
68,68176,1985-12-31,451,3432,3883
68,68176,1986-12-31,476,3351,3827
68,68176,1987-12-31,463,3279,3742
68,68176,1988-12-31,457,3233,3690
68,68176,1989-12-31,510,3192,3702
68,68176,1990-12-31,538,3110,3648
68,68176,1991-12-31,546,3037,3583
68,68176,1992-12-31,562,2982,3544
68,68176,1993-12-31,575,3066,3641
68,68176,1994-12-31,584,3028,3612
68,68176,1995-12-31,599,2986,3585
68,68176,1996-12-31,610,2931,3541
68,68176,1997-12-31,614,2885,3499
68,68176,1998-12-31,602,2822,3424
68,68176,1999-12-31,620,2777,3397
68,68176,2000-12-31,647,2791,3438
68,68176,2001-12-31,635,2740,3375
68,68176,2002-12-31,651,2718,3369
68,68176,2003-12-31,625,2675,3300
68,68176,2004-12-31,671,2622,3293
68,68176,2005-12-31,648,2571,3219
68,68176,2006-12-31,685,2567,3252
68,68176,2007-12-31,712,2465,3177
68,68176,2008-12-31,724,2446,3170
68,68176,2009-12-31,740,2425,3165
68,68176,2010-12-31,760,2384,3144
68,68176,2011-12-31,777,2345,3122
68,68176,2012-12-31,770,2315,3085
68,68176,2013-12-31,771,2277,3048
68,68176,2014-12-31,781,2245,3026
68,68176,2015-12-31,786,2198,2984
68,68176,2016-12-31,787,2152,2939
68,68176,2017-12-31,791,2062,2853
68,68176,2018-12-31,810,2065,2875
68,68176,2019-12-31,830,2035,2865
68,68176,2020-12-31,848,2018,2866
68,68176,2021-12-31,886,2012,2898
68,68176,2022-12-31,921,1999,2920
68,68176,2023-12-31,955,1986,2941
68,68176,2024-12-31,980,1969,2949
68,68176,2025-12-31,987,1957,2944
68,68176,2026-12-31,987,1954,2941
68,68176,2027-12-31,1007,1952,2959
68,68176,2028-12-31,1015,1939,2954
68,68176,2029-12-31,1021,1940,2961
68,68176,2030-12-31,1030,1939,2969
68,68176,2031-12-31,1031,1947,2978
68,68176,2032-12-31,1035,1937,2972
68,68176,2033-12-31,1050,1935,2985
68,68176,2034-12-31,1050,1929,2979
68,68176,2035-12-31,1062,1918,2980
68,68179,1985-12-31,547,6270,6817
68,68179,1986-12-31,540,6229,6769
68,68179,1987-12-31,546,6074,6620
68,68179,1988-12-31,548,5949,6497
68,68179,1989-12-31,558,5871,6429
68,68179,1990-12-31,540,5714,6254
68,68179,1991-12-31,540,5615,6155
68,68179,1992-12-31,555,5531,6086
68,68179,1993-12-31,583,5792,6375
68,68179,1994-12-31,567,5723,6290
68,68179,1995-12-31,559,5687,6246
68,68179,1996-12-31,557,5645,6202
68,68179,1997-12-31,571,5571,6142
68,68179,1998-12-31,563,5549,6112
68,68179,1999-12-31,603,5484,6087
68,68179,2000-12-31,583,5442,6025
68,68179,2001-12-31,574,5360,5934
68,68179,2002-12-31,551,5283,5834
68,68179,2003-12-31,581,5220,5801
68,68179,2004-12-31,607,5150,5757
68,68179,2005-12-31,621,5091,5712
68,68179,2006-12-31,570,5042,5612
68,68179,2007-12-31,570,4994,5564
68,68179,2008-12-31,582,4945,5527
68,68179,2009-12-31,562,4892,5454
68,68179,2010-12-31,576,4833,5409
68,68179,2011-12-31,575,4786,5361
68,68179,2012-12-31,581,4738,5319
68,68179,2013-12-31,590,4681,5271
68,68179,2014-12-31,593,4615,5208
68,68179,2015-12-31,599,4557,5156
68,68179,2016-12-31,610,4557,5167
68,68179,2017-12-31,619,4463,5082
68,68179,2018-12-31,637,4438,5075
68,68179,2019-12-31,640,4444,5084
68,68179,2020-12-31,645,4448,5093
68,68179,2021-12-31,715,4434,5149
68,68179,2022-12-31,782,4407,5189
68,68179,2023-12-31,849,4377,5226
68,68179,2024-12-31,865,4358,5223
68,68179,2025-12-31,894,4330,5224
68,68179,2026-12-31,898,4312,5210
68,68179,2027-12-31,904,4297,5201
68,68179,2028-12-31,914,4287,5201
68,68179,2029-12-31,925,4283,5208
68,68179,2030-12-31,935,4276,5211
68,68179,2031-12-31,934,4274,5208
68,68179,2032-12-31,937,4271,5208
68,68179,2033-12-31,941,4261,5202
68,68179,2034-12-31,945,4271,5216
68,68179,2035-12-31,951,4253,5204
68,68190,1985-12-31,4031,12767,16798
68,68190,1986-12-31,4337,12976,17313
68,68190,1987-12-31,4621,13051,17672
68,68190,1988-12-31,4910,13127,18037
68,68190,1989-12-31,5210,13161,18371
68,68190,1990-12-31,5508,13235,18743
68,68190,1991-12-31,5805,13306,19111
68,68190,1992-12-31,6116,13385,19501
68,68190,1993-12-31,6411,14289,20700
68,68190,1994-12-31,6714,14492,21206
68,68190,1995-12-31,7017,14689,21706
68,68190,1996-12-31,7338,14885,22223
68,68190,1997-12-31,7667,15089,22756
68,68190,1998-12-31,8013,15282,23295
68,68190,1999-12-31,8315,15464,23779
68,68190,2000-12-31,8626,15667,24293
68,68190,2001-12-31,8936,15841,24777
68,68190,2002-12-31,9233,16001,25234
68,68190,2003-12-31,9529,16171,25700
68,68190,2004-12-31,9819,16351,26170
68,68190,2005-12-31,10122,16539,26661
68,68190,2006-12-31,10417,16693,27110
68,68190,2007-12-31,10709,16867,27576
68,68190,2008-12-31,10999,17022,28021
68,68190,2009-12-31,11297,17186,28483
68,68190,2010-12-31,11586,17326,28912
68,68190,2011-12-31,11883,17509,29392
68,68190,2012-12-31,12177,17664,29841
68,68190,2013-12-31,12437,17840,30277
68,68190,2014-12-31,12670,18029,30699
68,68190,2015-12-31,12945,18214,31159
68,68190,2016-12-31,13256,18404,31660
68,68190,2017-12-31,13574,18662,32236
68,68190,2018-12-31,13943,19004,32947
68,68190,2019-12-31,14658,19092,33750
68,68190,2020-12-31,15273,19130,34403
68,68190,2021-12-31,15720,19069,34789
68,68190,2022-12-31,16103,18953,35056
68,68190,2023-12-31,16481,18826,35307
68,68190,2024-12-31,16839,18714,35553
68,68190,2025-12-31,17175,18612,35787
68,68190,2026-12-31,17482,18531,36013
68,68190,2027-12-31,17761,18474,36235
68,68190,2028-12-31,18048,18442,36490
68,68190,2029-12-31,18276,18402,36678
68,68190,2030-12-31,18510,18401,36911
68,68190,2031-12-31,18714,18398,37112
68,68190,2032-12-31,18904,18390,37294
68,68190,2033-12-31,19087,18390,37477
68,68190,2034-12-31,19260,18360,37620
68,68190,2035-12-31,19408,18311,37719
68,68207,1985-12-31,2137,4971,7108
68,68207,1986-12-31,2149,4942,7091
68,68207,1987-12-31,2159,4786,6945
68,68207,1988-12-31,2164,4690,6854
68,68207,1989-12-31,2195,4630,6825
68,68207,1990-12-31,2226,4523,6749
68,68207,1991-12-31,2256,4412,6668
68,68207,1992-12-31,2273,4283,6556
68,68207,1993-12-31,2304,4472,6776
68,68207,1994-12-31,2343,4415,6758
68,68207,1995-12-31,2360,4331,6691
68,68207,1996-12-31,2407,4297,6704
68,68207,1997-12-31,2425,4227,6652
68,68207,1998-12-31,2437,4192,6629
68,68207,1999-12-31,2457,4118,6575
68,68207,2000-12-31,2482,4043,6525
68,68207,2001-12-31,2490,3974,6464
68,68207,2002-12-31,2494,3906,6400
68,68207,2003-12-31,2513,3837,6350
68,68207,2004-12-31,2534,3763,6297
68,68207,2005-12-31,2577,3718,6295
68,68207,2006-12-31,2579,3642,6221
68,68207,2007-12-31,2587,3591,6178
68,68207,2008-12-31,2611,3552,6163
68,68207,2009-12-31,2609,3487,6096
68,68207,2010-12-31,2628,3422,6050
68,68207,2011-12-31,2662,3369,6031
68,68207,2012-12-31,2679,3308,5987
68,68207,2013-12-31,2707,3251,5958
68,68207,2014-12-31,2726,3179,5905
68,68207,2015-12-31,2717,3121,5838
68,68207,2016-12-31,2716,3087,5803
68,68207,2017-12-31,2726,3001,5727
68,68207,2018-12-31,2780,2958,5738
68,68207,2019-12-31,2818,2920,5738
68,68207,2020-12-31,2856,2901,5757
68,68207,2021-12-31,2929,2892,5821
68,68207,2022-12-31,2991,2874,5865
68,68207,2023-12-31,3052,2855,5907
68,68207,2024-12-31,3089,2851,5940
68,68207,2025-12-31,3118,2835,5953
68,68207,2026-12-31,3151,2813,5964
68,68207,2027-12-31,3189,2800,5989
68,68207,2028-12-31,3212,2797,6009
68,68207,2029-12-31,3236,2799,6035
68,68207,2030-12-31,3258,2791,6049
68,68207,2031-12-31,3279,2805,6084
68,68207,2032-12-31,3300,2796,6096
68,68207,2033-12-31,3330,2787,6117
68,68207,2034-12-31,3342,2776,6118
68,68207,2035-12-31,3361,2768,6129
68,68209,1985-12-31,182,1932,2114
68,68209,1986-12-31,185,1941,2126
68,68209,1987-12-31,214,1951,2165
68,68209,1988-12-31,218,1959,2177
68,68209,1989-12-31,214,1983,2197
68,68209,1990-12-31,233,1987,2220
68,68209,1991-12-31,239,1970,2209
68,68209,1992-12-31,352,1951,2303
68,68209,1993-12-31,366,2063,2429
68,68209,1994-12-31,371,2072,2443
68,68209,1995-12-31,378,2076,2454
68,68209,1996-12-31,392,2075,2467
68,68209,1997-12-31,400,2121,2521
68,68209,1998-12-31,439,2145,2584
68,68209,1999-12-31,444,2157,2601
68,68209,2000-12-31,449,2173,2622
68,68209,2001-12-31,472,2191,2663
68,68209,2002-12-31,481,2203,2684
68,68209,2003-12-31,488,2218,2706
68,68209,2004-12-31,497,2236,2733
68,68209,2005-12-31,498,2254,2752
68,68209,2006-12-31,541,2276,2817
68,68209,2007-12-31,547,2282,2829
68,68209,2008-12-31,544,2296,2840
68,68209,2009-12-31,520,2326,2846
68,68209,2010-12-31,533,2353,2886
68,68209,2011-12-31,552,2353,2905
68,68209,2012-12-31,578,2356,2934
68,68209,2013-12-31,602,2375,2977
68,68209,2014-12-31,618,2441,3059
68,68209,2015-12-31,647,2449,3096
68,68209,2016-12-31,661,2447,3108
68,68209,2017-12-31,671,2452,3123
68,68209,2018-12-31,687,2472,3159
68,68209,2019-12-31,713,2520,3233
68,68209,2020-12-31,734,2560,3294
68,68209,2021-12-31,778,2552,3330
68,68209,2022-12-31,819,2537,3356
68,68209,2023-12-31,860,2520,3380
68,68209,2024-12-31,880,2497,3377
68,68209,2025-12-31,893,2492,3385
68,68209,2026-12-31,900,2484,3384
68,68209,2027-12-31,912,2479,3391
68,68209,2028-12-31,919,2472,3391
68,68209,2029-12-31,931,2467,3398
68,68209,2030-12-31,941,2461,3402
68,68209,2031-12-31,945,2463,3408
68,68209,2032-12-31,955,2467,3422
68,68209,2033-12-31,957,2465,3422
68,68209,2034-12-31,965,2461,3426
68,68209,2035-12-31,967,2450,3417
68,68211,1985-12-31,2411,1636,4047
68,68211,1986-12-31,2419,1607,4026
68,68211,1987-12-31,2445,1582,4027
68,68211,1988-12-31,2431,1572,4003
68,68211,1989-12-31,2435,1554,3989
68,68211,1990-12-31,2495,1526,4021
68,68211,1991-12-31,2515,1498,4013
68,68211,1992-12-31,2498,1443,3941
68,68211,1993-12-31,2515,1457,3972
68,68211,1994-12-31,2549,1433,3982
68,68211,1995-12-31,2605,1420,4025
68,68211,1996-12-31,2649,1385,4034
68,68211,1997-12-31,2645,1329,3974
68,68211,1998-12-31,2618,1302,3920
68,68211,1999-12-31,2619,1280,3899
68,68211,2000-12-31,2639,1256,3895
68,68211,2001-12-31,2663,1240,3903
68,68211,2002-12-31,2639,1227,3866
68,68211,2003-12-31,2656,1204,3860
68,68211,2004-12-31,2663,1173,3836
68,68211,2005-12-31,2737,1138,3875
68,68211,2006-12-31,2738,1125,3863
68,68211,2007-12-31,2709,1117,3826
68,68211,2008-12-31,2683,1105,3788
68,68211,2009-12-31,2698,1073,3771
68,68211,2010-12-31,2722,1079,3801
68,68211,2011-12-31,2732,1036,3768
68,68211,2012-12-31,2763,1026,3789
68,68211,2013-12-31,2767,1001,3768
68,68211,2014-12-31,2757,980,3737
68,68211,2015-12-31,2744,924,3668
68,68211,2016-12-31,2722,877,3599
68,68211,2017-12-31,2746,875,3621
68,68211,2018-12-31,2798,881,3679
68,68211,2019-12-31,2814,869,3683
68,68211,2020-12-31,2840,859,3699
68,68211,2021-12-31,2884,856,3740
68,68211,2022-12-31,2918,851,3769
68,68211,2023-12-31,2950,845,3795
68,68211,2024-12-31,2981,844,3825
68,68211,2025-12-31,3002,836,3838
68,68211,2026-12-31,3038,830,3868
68,68211,2027-12-31,3067,827,3894
68,68211,2028-12-31,3097,831,3928
68,68211,2029-12-31,3122,824,3946
68,68211,2030-12-31,3138,826,3964
68,68211,2031-12-31,3169,826,3995
68,68211,2032-12-31,3187,825,4012
68,68211,2033-12-31,3200,831,4031
68,68211,2034-12-31,3217,831,4048
68,68211,2035-12-31,3242,827,4069
68,68217,1985-12-31,367,6602,6969
68,68217,1986-12-31,378,6539,6917
68,68217,1987-12-31,391,6419,6810
68,68217,1988-12-31,405,6270,6675
68,68217,1989-12-31,417,6133,6550
68,68217,1990-12-31,445,6024,6469
68,68217,1991-12-31,453,5903,6356
68,68217,1992-12-31,460,5793,6253
68,68217,1993-12-31,465,6016,6481
68,68217,1994-12-31,486,5939,6425
68,68217,1995-12-31,492,5881,6373
68,68217,1996-12-31,497,5814,6311
68,68217,1997-12-31,496,5752,6248
68,68217,1998-12-31,501,5689,6190
68,68217,1999-12-31,565,5622,6187
68,68217,2000-12-31,566,5571,6137
68,68217,2001-12-31,596,5486,6082
68,68217,2002-12-31,604,5390,5994
68,68217,2003-12-31,618,5302,5920
68,68217,2004-12-31,622,5222,5844
68,68217,2005-12-31,633,5142,5775
68,68217,2006-12-31,648,5085,5733
68,68217,2007-12-31,655,5021,5676
68,68217,2008-12-31,651,4961,5612
68,68217,2009-12-31,648,4899,5547
68,68217,2010-12-31,661,4815,5476
68,68217,2011-12-31,663,4728,5391
68,68217,2012-12-31,673,4701,5374
68,68217,2013-12-31,671,4620,5291
68,68217,2014-12-31,672,4542,5214
68,68217,2015-12-31,683,4478,5161
68,68217,2016-12-31,693,4432,5125
68,68217,2017-12-31,699,4331,5030
68,68217,2018-12-31,723,4292,5015
68,68217,2019-12-31,742,4267,5009
68,68217,2020-12-31,759,4265,5024
68,68217,2021-12-31,829,4251,5080
68,68217,2022-12-31,893,4225,5118
68,68217,2023-12-31,958,4197,5155
68,68217,2024-12-31,997,4169,5166
68,68217,2025-12-31,1014,4158,5172
68,68217,2026-12-31,1017,4137,5154
68,68217,2027-12-31,1019,4128,5147
68,68217,2028-12-31,1026,4110,5136
68,68217,2029-12-31,1037,4113,5150
68,68217,2030-12-31,1042,4110,5152
68,68217,2031-12-31,1049,4116,5165
68,68217,2032-12-31,1060,4111,5171
68,68217,2033-12-31,1067,4105,5172
68,68217,2034-12-31,1072,4096,5168
68,68217,2035-12-31,1081,4090,5171
68,68229,1985-12-31,2014,6888,8902
68,68229,1986-12-31,2091,6936,9027
68,68229,1987-12-31,2159,6937,9096
68,68229,1988-12-31,2226,6830,9056
68,68229,1989-12-31,2289,6808,9097
68,68229,1990-12-31,2388,6803,9191
68,68229,1991-12-31,2470,6792,9262
68,68229,1992-12-31,2546,6757,9303
68,68229,1993-12-31,2616,7176,9792
68,68229,1994-12-31,2704,7229,9933
68,68229,1995-12-31,2830,7263,10093
68,68229,1996-12-31,2916,7303,10219
68,68229,1997-12-31,2986,7359,10345
68,68229,1998-12-31,3083,7397,10480
68,68229,1999-12-31,3151,7431,10582
68,68229,2000-12-31,3219,7470,10689
68,68229,2001-12-31,3301,7514,10815
68,68229,2002-12-31,3369,7549,10918
68,68229,2003-12-31,3449,7589,11038
68,68229,2004-12-31,3525,7611,11136
68,68229,2005-12-31,3593,7618,11211
68,68229,2006-12-31,3673,7647,11320
68,68229,2007-12-31,3765,7677,11442
68,68229,2008-12-31,3822,7715,11537
68,68229,2009-12-31,3890,7744,11634
68,68229,2010-12-31,3983,7796,11779
68,68229,2011-12-31,4066,7770,11836
68,68229,2012-12-31,4109,7796,11905
68,68229,2013-12-31,4165,7812,11977
68,68229,2014-12-31,4226,7853,12079
68,68229,2015-12-31,4301,7844,12145
68,68229,2016-12-31,4379,7951,12330
68,68229,2017-12-31,4475,8020,12495
68,68229,2018-12-31,4577,8140,12717
68,68229,2019-12-31,4715,8313,13028
68,68229,2020-12-31,4834,8449,13283
68,68229,2021-12-31,5008,8424,13432
68,68229,2022-12-31,5163,8372,13535
68,68229,2023-12-31,5315,8317,13632
68,68229,2024-12-31,5406,8257,13663
68,68229,2025-12-31,5461,8218,13679
68,68229,2026-12-31,5529,8182,13711
68,68229,2027-12-31,5590,8166,13756
68,68229,2028-12-31,5634,8127,13761
68,68229,2029-12-31,5689,8120,13809
68,68229,2030-12-31,5733,8117,13850
68,68229,2031-12-31,5757,8128,13885
68,68229,2032-12-31,5803,8117,13920
68,68229,2033-12-31,5834,8109,13943
68,68229,2034-12-31,5860,8124,13984
68,68229,2035-12-31,5894,8096,13990
68,68235,1985-12-31,0,0,0
68,68235,1986-12-31,2105,11395,13500
68,68235,1987-12-31,2108,11506,13614
68,68235,1988-12-31,2147,11595,13742
68,68235,1989-12-31,2175,11699,13874
68,68235,1990-12-31,2197,11798,13995
68,68235,1991-12-31,2230,11908,14138
68,68235,1992-12-31,2242,12012,14254
68,68235,1993-12-31,2264,12861,15125
68,68235,1994-12-31,2311,13076,15387
68,68235,1995-12-31,2336,13299,15635
68,68235,1996-12-31,2355,13515,15870
68,68235,1997-12-31,2411,13743,16154
68,68235,1998-12-31,2425,13958,16383
68,68235,1999-12-31,2447,14164,16611
68,68235,2000-12-31,2472,14364,16836
68,68235,2001-12-31,2490,14575,17065
68,68235,2002-12-31,2502,14753,17255
68,68235,2003-12-31,2534,14951,17485
68,68235,2004-12-31,2552,15161,17713
68,68235,2005-12-31,2575,15363,17938
68,68235,2006-12-31,2586,15550,18136
68,68235,2007-12-31,2608,15743,18351
68,68235,2008-12-31,2629,15919,18548
68,68235,2009-12-31,2665,16095,18760
68,68235,2010-12-31,2660,16275,18935
68,68235,2011-12-31,2706,16473,19179
68,68235,2012-12-31,2719,16651,19370
68,68235,2013-12-31,2730,16864,19594
68,68235,2014-12-31,2751,17052,19803
68,68235,2015-12-31,2764,17255,20019
68,68235,2016-12-31,2807,17488,20295
68,68235,2017-12-31,2822,17757,20579
68,68235,2018-12-31,2821,18095,20916
68,68235,2019-12-31,3000,18415,21415
68,68235,2020-12-31,3174,18646,21820
68,68235,2021-12-31,3471,18591,22062
68,68235,2022-12-31,3753,18477,22230
68,68235,2023-12-31,4035,18354,22389
68,68235,2024-12-31,4231,18246,22477
68,68235,2025-12-31,4360,18169,22529
68,68235,2026-12-31,4445,18087,22532
68,68235,2027-12-31,4513,18029,22542
68,68235,2028-12-31,4556,17983,22539
68,68235,2029-12-31,4601,17971,22572
68,68235,2030-12-31,4634,17967,22601
68,68235,2031-12-31,4676,17957,22633
68,68235,2032-12-31,4697,17971,22668
68,68235,2033-12-31,4728,17965,22693
68,68235,2034-12-31,4751,17915,22666
68,68235,2035-12-31,4785,17885,22670
68,68245,1985-12-31,268,2517,2785
68,68245,1986-12-31,295,2440,2735
68,68245,1987-12-31,296,2396,2692
68,68245,1988-12-31,302,2361,2663
68,68245,1989-12-31,317,2317,2634
68,68245,1990-12-31,330,2297,2627
68,68245,1991-12-31,341,2226,2567
68,68245,1992-12-31,350,2182,2532
68,68245,1993-12-31,389,2249,2638
68,68245,1994-12-31,406,2219,2625
68,68245,1995-12-31,391,2176,2567
68,68245,1996-12-31,405,2109,2514
68,68245,1997-12-31,421,2089,2510
68,68245,1998-12-31,444,2060,2504
68,68245,1999-12-31,485,2069,2554
68,68245,2000-12-31,448,2023,2471
68,68245,2001-12-31,450,1991,2441
68,68245,2002-12-31,464,1991,2455
68,68245,2003-12-31,475,1955,2430
68,68245,2004-12-31,492,1930,2422
68,68245,2005-12-31,520,1875,2395
68,68245,2006-12-31,546,1886,2432
68,68245,2007-12-31,564,1814,2378
68,68245,2008-12-31,536,1754,2290
68,68245,2009-12-31,547,1723,2270
68,68245,2010-12-31,566,1702,2268
68,68245,2011-12-31,576,1675,2251
68,68245,2012-12-31,591,1685,2276
68,68245,2013-12-31,604,1633,2237
68,68245,2014-12-31,624,1588,2212
68,68245,2015-12-31,639,1555,2194
68,68245,2016-12-31,646,1505,2151
68,68245,2017-12-31,656,1481,2137
68,68245,2018-12-31,677,1490,2167
68,68245,2019-12-31,697,1422,2119
68,68245,2020-12-31,715,1370,2085
68,68245,2021-12-31,742,1366,2108
68,68245,2022-12-31,767,1357,2124
68,68245,2023-12-31,791,1348,2139
68,68245,2024-12-31,801,1337,2138
68,68245,2025-12-31,810,1329,2139
68,68245,2026-12-31,817,1330,2147
68,68245,2027-12-31,824,1322,2146
68,68245,2028-12-31,836,1313,2149
68,68245,2029-12-31,843,1310,2153
68,68245,2030-12-31,849,1316,2165
68,68245,2031-12-31,860,1310,2170
68,68245,2032-12-31,859,1315,2174
68,68245,2033-12-31,867,1322,2189
68,68245,2034-12-31,868,1319,2187
68,68245,2035-12-31,872,1307,2179
68,68250,1985-12-31,0,0,0
68,68250,1986-12-31,0,0,0
68,68250,1987-12-31,0,0,0
68,68250,1988-12-31,0,0,0
68,68250,1989-12-31,0,0,0
68,68250,1990-12-31,0,0,0
68,68250,1991-12-31,0,0,0
68,68250,1992-12-31,0,0,0
68,68250,1993-12-31,428,5611,6039
68,68250,1994-12-31,458,5582,6040
68,68250,1995-12-31,477,5554,6031
68,68250,1996-12-31,518,5530,6048
68,68250,1997-12-31,521,5498,6019
68,68250,1998-12-31,489,5413,5902
68,68250,1999-12-31,535,5362,5897
68,68250,2000-12-31,547,5334,5881
68,68250,2001-12-31,571,5277,5848
68,68250,2002-12-31,541,5227,5768
68,68250,2003-12-31,553,5165,5718
68,68250,2004-12-31,569,5115,5684
68,68250,2005-12-31,587,5081,5668
68,68250,2006-12-31,575,5020,5595
68,68250,2007-12-31,610,5011,5621
68,68250,2008-12-31,608,4969,5577
68,68250,2009-12-31,634,4922,5556
68,68250,2010-12-31,647,4887,5534
68,68250,2011-12-31,648,4846,5494
68,68250,2012-12-31,674,4799,5473
68,68250,2013-12-31,687,4741,5428
68,68250,2014-12-31,692,4691,5383
68,68250,2015-12-31,693,4643,5336
68,68250,2016-12-31,694,4617,5311
68,68250,2017-12-31,700,4572,5272
68,68250,2018-12-31,712,4567,5279
68,68250,2019-12-31,733,4672,5405
68,68250,2020-12-31,752,4755,5507
68,68250,2021-12-31,827,4741,5568
68,68250,2022-12-31,898,4712,5610
68,68250,2023-12-31,970,4680,5650
68,68250,2024-12-31,997,4660,5657
68,68250,2025-12-31,1018,4619,5637
68,68250,2026-12-31,1029,4605,5634
68,68250,2027-12-31,1037,4588,5625
68,68250,2028-12-31,1042,4595,5637
68,68250,2029-12-31,1055,4581,5636
68,68250,2030-12-31,1064,4581,5645
68,68250,2031-12-31,1069,4583,5652
68,68250,2032-12-31,1078,4586,5664
68,68250,2033-12-31,1079,4564,5643
68,68250,2034-12-31,1086,4571,5657
68,68250,2035-12-31,1089,4552,5641
68,68255,1985-12-31,3311,9573,12884
68,68255,1986-12-31,3415,9478,12893
68,68255,1987-12-31,3514,9323,12837
68,68255,1988-12-31,3625,9122,12747
68,68255,1989-12-31,3757,8947,12704
68,68255,1990-12-31,3864,8765,12629
68,68255,1991-12-31,3979,8624,12603
68,68255,1992-12-31,4092,8477,12569
68,68255,1993-12-31,4201,8816,13017
68,68255,1994-12-31,4334,8744,13078
68,68255,1995-12-31,4403,8666,13069
68,68255,1996-12-31,4573,8597,13170
68,68255,1997-12-31,4724,8504,13228
68,68255,1998-12-31,4820,8416,13236
68,68255,1999-12-31,4953,8329,13282
68,68255,2000-12-31,5085,8242,13327
68,68255,2001-12-31,5184,8132,13316
68,68255,2002-12-31,5300,8059,13359
68,68255,2003-12-31,5409,8001,13410
68,68255,2004-12-31,5517,7905,13422
68,68255,2005-12-31,5631,7759,13390
68,68255,2006-12-31,5737,7672,13409
68,68255,2007-12-31,5842,7584,13426
68,68255,2008-12-31,5944,7492,13436
68,68255,2009-12-31,6063,7384,13447
68,68255,2010-12-31,6164,7319,13483
68,68255,2011-12-31,6275,7223,13498
68,68255,2012-12-31,6381,7096,13477
68,68255,2013-12-31,6487,6986,13473
68,68255,2014-12-31,6545,6884,13429
68,68255,2015-12-31,6630,6783,13413
68,68255,2016-12-31,6696,6708,13404
68,68255,2017-12-31,6812,6731,13543
68,68255,2018-12-31,7037,6676,13713
68,68255,2019-12-31,7242,6640,13882
68,68255,2020-12-31,7415,6623,14038
68,68255,2021-12-31,7591,6602,14193
68,68255,2022-12-31,7740,6562,14302
68,68255,2023-12-31,7886,6518,14404
68,68255,2024-12-31,7996,6485,14481
68,68255,2025-12-31,8098,6454,14552
68,68255,2026-12-31,8186,6418,14604
68,68255,2027-12-31,8267,6396,14663
68,68255,2028-12-31,8341,6384,14725
68,68255,2029-12-31,8408,6377,14785
68,68255,2030-12-31,8461,6388,14849
68,68255,2031-12-31,8524,6393,14917
68,68255,2032-12-31,8587,6378,14965
68,68255,2033-12-31,8637,6383,15020
68,68255,2034-12-31,8676,6378,15054
68,68255,2035-12-31,8727,6356,15083
68,68264,1985-12-31,177,2766,2943
68,68264,1986-12-31,179,2693,2872
68,68264,1987-12-31,176,2659,2835
68,68264,1988-12-31,168,2625,2793
68,68264,1989-12-31,202,2609,2811
68,68264,1990-12-31,204,2569,2773
68,68264,1991-12-31,207,2537,2744
68,68264,1992-12-31,207,2489,2696
68,68264,1993-12-31,210,2552,2762
68,68264,1994-12-31,228,2541,2769
68,68264,1995-12-31,273,2492,2765
68,68264,1996-12-31,293,2469,2762
68,68264,1997-12-31,291,2448,2739
68,68264,1998-12-31,304,2460,2764
68,68264,1999-12-31,333,2459,2792
68,68264,2000-12-31,356,2406,2762
68,68264,2001-12-31,373,2386,2759
68,68264,2002-12-31,379,2368,2747
68,68264,2003-12-31,411,2335,2746
68,68264,2004-12-31,368,2316,2684
68,68264,2005-12-31,378,2299,2677
68,68264,2006-12-31,419,2274,2693
68,68264,2007-12-31,451,2278,2729
68,68264,2008-12-31,457,2265,2722
68,68264,2009-12-31,465,2219,2684
68,68264,2010-12-31,468,2177,2645
68,68264,2011-12-31,472,2144,2616
68,68264,2012-12-31,478,2120,2598
68,68264,2013-12-31,485,2099,2584
68,68264,2014-12-31,498,2077,2575
68,68264,2015-12-31,501,2056,2557
68,68264,2016-12-31,506,2029,2535
68,68264,2017-12-31,511,2017,2528
68,68264,2018-12-31,526,2026,2552
68,68264,2019-12-31,546,2021,2567
68,68264,2020-12-31,562,2021,2583
68,68264,2021-12-31,597,2015,2612
68,68264,2022-12-31,630,2002,2632
68,68264,2023-12-31,661,1989,2650
68,68264,2024-12-31,678,1975,2653
68,68264,2025-12-31,691,1963,2654
68,68264,2026-12-31,697,1957,2654
68,68264,2027-12-31,701,1951,2652
68,68264,2028-12-31,707,1950,2657
68,68264,2029-12-31,711,1942,2653
68,68264,2030-12-31,715,1939,2654
68,68264,2031-12-31,717,1942,2659
68,68264,2032-12-31,718,1936,2654
68,68264,2033-12-31,718,1938,2656
68,68264,2034-12-31,722,1934,2656
68,68264,2035-12-31,730,1936,2666
68,68266,1985-12-31,450,4500,4950
68,68266,1986-12-31,439,4406,4845
68,68266,1987-12-31,478,4315,4793
68,68266,1988-12-31,458,4231,4689
68,68266,1989-12-31,518,4159,4677
68,68266,1990-12-31,537,4066,4603
68,68266,1991-12-31,509,3962,4471
68,68266,1992-12-31,538,3866,4404
68,68266,1993-12-31,543,4018,4561
68,68266,1994-12-31,571,3983,4554
68,68266,1995-12-31,580,3916,4496
68,68266,1996-12-31,598,3852,4450
68,68266,1997-12-31,584,3801,4385
68,68266,1998-12-31,624,3762,4386
68,68266,1999-12-31,610,3704,4314
68,68266,2000-12-31,635,3614,4249
68,68266,2001-12-31,640,3564,4204
68,68266,2002-12-31,637,3512,4149
68,68266,2003-12-31,657,3436,4093
68,68266,2004-12-31,670,3377,4047
68,68266,2005-12-31,664,3337,4001
68,68266,2006-12-31,665,3264,3929
68,68266,2007-12-31,684,3208,3892
68,68266,2008-12-31,701,3128,3829
68,68266,2009-12-31,720,3113,3833
68,68266,2010-12-31,733,3041,3774
68,68266,2011-12-31,743,2969,3712
68,68266,2012-12-31,763,2924,3687
68,68266,2013-12-31,779,2875,3654
68,68266,2014-12-31,791,2832,3623
68,68266,2015-12-31,808,2789,3597
68,68266,2016-12-31,824,2747,3571
68,68266,2017-12-31,832,2614,3446
68,68266,2018-12-31,849,2612,3461
68,68266,2019-12-31,875,2569,3444
68,68266,2020-12-31,897,2548,3445
68,68266,2021-12-31,943,2540,3483
68,68266,2022-12-31,986,2524,3510
68,68266,2023-12-31,1027,2508,3535
68,68266,2024-12-31,1044,2492,3536
68,68266,2025-12-31,1061,2473,3534
68,68266,2026-12-31,1064,2470,3534
68,68266,2027-12-31,1082,2463,3545
68,68266,2028-12-31,1096,2458,3554
68,68266,2029-12-31,1103,2452,3555
68,68266,2030-12-31,1113,2451,3564
68,68266,2031-12-31,1120,2445,3565
68,68266,2032-12-31,1128,2443,3571
68,68266,2033-12-31,1129,2456,3585
68,68266,2034-12-31,1138,2446,3584
68,68266,2035-12-31,1138,2441,3579
68,68271,1985-12-31,651,6186,6837
68,68271,1986-12-31,671,6124,6795
68,68271,1987-12-31,685,5993,6678
68,68271,1988-12-31,706,5894,6600
68,68271,1989-12-31,726,5794,6520
68,68271,1990-12-31,735,5652,6387
68,68271,1991-12-31,753,5535,6288
68,68271,1992-12-31,760,5456,6216
68,68271,1993-12-31,785,5694,6479
68,68271,1994-12-31,800,5636,6436
68,68271,1995-12-31,851,5605,6456
68,68271,1996-12-31,877,5545,6422
68,68271,1997-12-31,875,5483,6358
68,68271,1998-12-31,894,5453,6347
68,68271,1999-12-31,917,5433,6350
68,68271,2000-12-31,911,5355,6266
68,68271,2001-12-31,925,5302,6227
68,68271,2002-12-31,939,5214,6153
68,68271,2003-12-31,971,5146,6117
68,68271,2004-12-31,985,5070,6055
68,68271,2005-12-31,1004,5007,6011
68,68271,2006-12-31,1004,4974,5978
68,68271,2007-12-31,1052,4937,5989
68,68271,2008-12-31,1061,4860,5921
68,68271,2009-12-31,1081,4790,5871
68,68271,2010-12-31,1084,4748,5832
68,68271,2011-12-31,1103,4699,5802
68,68271,2012-12-31,1144,4645,5789
68,68271,2013-12-31,1170,4588,5758
68,68271,2014-12-31,1171,4534,5705
68,68271,2015-12-31,1181,4486,5667
68,68271,2016-12-31,1189,4448,5637
68,68271,2017-12-31,1201,4362,5563
68,68271,2018-12-31,1218,4344,5562
68,68271,2019-12-31,1255,4314,5569
68,68271,2020-12-31,1286,4303,5589
68,68271,2021-12-31,1362,4289,5651
68,68271,2022-12-31,1431,4263,5694
68,68271,2023-12-31,1500,4235,5735
68,68271,2024-12-31,1526,4212,5738
68,68271,2025-12-31,1556,4185,5741
68,68271,2026-12-31,1576,4171,5747
68,68271,2027-12-31,1584,4152,5736
68,68271,2028-12-31,1607,4139,5746
68,68271,2029-12-31,1613,4147,5760
68,68271,2030-12-31,1622,4140,5762
68,68271,2031-12-31,1637,4133,5770
68,68271,2032-12-31,1645,4145,5790
68,68271,2033-12-31,1656,4129,5785
68,68271,2034-12-31,1671,4132,5803
68,68271,2035-12-31,1678,4116,5794
68,68276,1985-12-31,128561,5872,134433
68,68276,1986-12-31,132648,6084,138732
68,68276,1987-12-31,137131,6202,143333
68,68276,1988-12-31,141671,6300,147971
68,68276,1989-12-31,146244,6419,152663
68,68276,1990-12-31,150875,6568,157443
68,68276,1991-12-31,155582,6671,162253
68,68276,1992-12-31,160370,6793,167163
68,68276,1993-12-31,165160,7343,172503
68,68276,1994-12-31,170059,7533,177592
68,68276,1995-12-31,175041,7733,182774
68,68276,1996-12-31,180018,7923,187941
68,68276,1997-12-31,185011,8109,193120
68,68276,1998-12-31,189942,8288,198230
68,68276,1999-12-31,194757,8479,203236
68,68276,2000-12-31,199534,8656,208190
68,68276,2001-12-31,204192,8839,213031
68,68276,2002-12-31,208825,9026,217851
68,68276,2003-12-31,213350,9198,222548
68,68276,2004-12-31,217885,9398,227283
68,68276,2005-12-31,222370,9538,231908
68,68276,2006-12-31,226962,9706,236668
68,68276,2007-12-31,231497,9895,241392
68,68276,2008-12-31,235935,10061,245996
68,68276,2009-12-31,240318,10199,250517
68,68276,2010-12-31,244673,10359,255032
68,68276,2011-12-31,248849,10531,259380
68,68276,2012-12-31,252921,10680,263601
68,68276,2013-12-31,256921,10848,267769
68,68276,2014-12-31,260837,11022,271859
68,68276,2015-12-31,264800,11196,275996
68,68276,2016-12-31,269155,11398,280553
68,68276,2017-12-31,273920,11588,285508
68,68276,2018-12-31,280025,11910,291935
68,68276,2019-12-31,288483,12247,300730
68,68276,2020-12-31,295724,12172,307896
68,68276,2021-12-31,299123,12242,311365
68,68276,2022-12-31,301563,12182,313745
68,68276,2023-12-31,303879,12102,315981
68,68276,2024-12-31,306982,12038,319020
68,68276,2025-12-31,310237,11982,322219
68,68276,2026-12-31,313363,11927,325290
68,68276,2027-12-31,316339,11888,328227
68,68276,2028-12-31,319130,11867,330997
68,68276,2029-12-31,321738,11849,333587
68,68276,2030-12-31,324112,11851,335963
68,68276,2031-12-31,326309,11847,338156
68,68276,2032-12-31,328384,11846,340230
68,68276,2033-12-31,330364,11835,342199
68,68276,2034-12-31,332196,11821,344017
68,68276,2035-12-31,333912,11792,345704
68,68296,1985-12-31,603,3090,3693
68,68296,1986-12-31,623,3013,3636
68,68296,1987-12-31,664,2973,3637
68,68296,1988-12-31,664,2918,3582
68,68296,1989-12-31,672,2907,3579
68,68296,1990-12-31,664,2855,3519
68,68296,1991-12-31,689,2803,3492
68,68296,1992-12-31,703,2729,3432
68,68296,1993-12-31,657,2793,3450
68,68296,1994-12-31,694,2779,3473
68,68296,1995-12-31,677,2752,3429
68,68296,1996-12-31,685,2717,3402
68,68296,1997-12-31,690,2677,3367
68,68296,1998-12-31,747,2654,3401
68,68296,1999-12-31,736,2619,3355
68,68296,2000-12-31,714,2575,3289
68,68296,2001-12-31,758,2557,3315
68,68296,2002-12-31,761,2513,3274
68,68296,2003-12-31,742,2489,3231
68,68296,2004-12-31,696,2467,3163
68,68296,2005-12-31,727,2448,3175
68,68296,2006-12-31,726,2412,3138
68,68296,2007-12-31,725,2388,3113
68,68296,2008-12-31,730,2360,3090
68,68296,2009-12-31,732,2330,3062
68,68296,2010-12-31,741,2294,3035
68,68296,2011-12-31,755,2270,3025
68,68296,2012-12-31,754,2244,2998
68,68296,2013-12-31,773,2231,3004
68,68296,2014-12-31,785,2214,2999
68,68296,2015-12-31,790,2190,2980
68,68296,2016-12-31,790,2110,2900
68,68296,2017-12-31,800,2060,2860
68,68296,2018-12-31,812,2074,2886
68,68296,2019-12-31,824,2059,2883
68,68296,2020-12-31,838,2053,2891
68,68296,2021-12-31,877,2046,2923
68,68296,2022-12-31,911,2034,2945
68,68296,2023-12-31,946,2020,2966
68,68296,2024-12-31,964,2009,2973
68,68296,2025-12-31,974,2002,2976
68,68296,2026-12-31,977,1997,2974
68,68296,2027-12-31,994,1987,2981
68,68296,2028-12-31,1001,1980,2981
68,68296,2029-12-31,1012,1975,2987
68,68296,2030-12-31,1024,1976,3000
68,68296,2031-12-31,1026,1981,3007
68,68296,2032-12-31,1030,1974,3004
68,68296,2033-12-31,1041,1976,3017
68,68296,2034-12-31,1043,1968,3011
68,68296,2035-12-31,1045,1965,3010
68,68298,1985-12-31,388,5011,5399
68,68298,1986-12-31,402,4950,5352
68,68298,1987-12-31,401,4837,5238
68,68298,1988-12-31,411,4758,5169
68,68298,1989-12-31,447,4696,5143
68,68298,1990-12-31,437,4586,5023
68,68298,1991-12-31,445,4460,4905
68,68298,1992-12-31,436,4392,4828
68,68298,1993-12-31,452,4594,5046
68,68298,1994-12-31,472,4527,4999
68,68298,1995-12-31,455,4464,4919
68,68298,1996-12-31,466,4435,4901
68,68298,1997-12-31,465,4382,4847
68,68298,1998-12-31,491,4337,4828
68,68298,1999-12-31,506,4287,4793
68,68298,2000-12-31,516,4242,4758
68,68298,2001-12-31,513,4167,4680
68,68298,2002-12-31,532,4116,4648
68,68298,2003-12-31,537,4077,4614
68,68298,2004-12-31,542,4022,4564
68,68298,2005-12-31,544,3958,4502
68,68298,2006-12-31,568,3923,4491
68,68298,2007-12-31,564,3879,4443
68,68298,2008-12-31,589,3838,4427
68,68298,2009-12-31,596,3793,4389
68,68298,2010-12-31,554,3742,4296
68,68298,2011-12-31,565,3685,4250
68,68298,2012-12-31,574,3625,4199
68,68298,2013-12-31,586,3583,4169
68,68298,2014-12-31,605,3551,4156
68,68298,2015-12-31,614,3504,4118
68,68298,2016-12-31,628,3479,4107
68,68298,2017-12-31,637,3382,4019
68,68298,2018-12-31,653,3368,4021
68,68298,2019-12-31,669,3339,4008
68,68298,2020-12-31,681,3332,4013
68,68298,2021-12-31,736,3321,4057
68,68298,2022-12-31,787,3301,4088
68,68298,2023-12-31,839,3279,4118
68,68298,2024-12-31,863,3266,4129
68,68298,2025-12-31,874,3240,4114
68,68298,2026-12-31,888,3237,4125
68,68298,2027-12-31,890,3220,4110
68,68298,2028-12-31,896,3210,4106
68,68298,2029-12-31,898,3198,4096
68,68298,2030-12-31,908,3205,4113
68,68298,2031-12-31,916,3202,4118
68,68298,2032-12-31,927,3212,4139
68,68298,2033-12-31,933,3192,4125
68,68298,2034-12-31,934,3200,4134
68,68298,2035-12-31,936,3192,4128
68,68307,1985-12-31,36318,12037,48355
68,68307,1986-12-31,39291,12266,51557
68,68307,1987-12-31,42372,12406,54778
68,68307,1988-12-31,45474,12496,57970
68,68307,1989-12-31,48590,12547,61137
68,68307,1990-12-31,51734,12672,64406
68,68307,1991-12-31,54903,12785,67688
68,68307,1992-12-31,58118,12887,71005
68,68307,1993-12-31,61356,13813,75169
68,68307,1994-12-31,64620,14054,78674
68,68307,1995-12-31,67930,14273,82203
68,68307,1996-12-31,71256,14512,85768
68,68307,1997-12-31,74593,14751,89344
68,68307,1998-12-31,77925,14969,92894
68,68307,1999-12-31,81200,15182,96382
68,68307,2000-12-31,84487,15401,99888
68,68307,2001-12-31,87726,15598,103324
68,68307,2002-12-31,90933,15803,106736
68,68307,2003-12-31,94092,16013,110105
68,68307,2004-12-31,97278,16218,113496
68,68307,2005-12-31,100434,16434,116868
68,68307,2006-12-31,103645,16611,120256
68,68307,2007-12-31,106803,16801,123604
68,68307,2008-12-31,109938,16997,126935
68,68307,2009-12-31,113049,17178,130227
68,68307,2010-12-31,116146,17372,133518
68,68307,2011-12-31,119147,17574,136721
68,68307,2012-12-31,122077,17766,139843
68,68307,2013-12-31,124996,17986,142982
68,68307,2014-12-31,127871,18184,146055
68,68307,2015-12-31,130766,18405,149171
68,68307,2016-12-31,133829,18649,152478
68,68307,2017-12-31,137141,18916,156057
68,68307,2018-12-31,141107,19296,160403
68,68307,2019-12-31,147364,19479,166843
68,68307,2020-12-31,152582,19322,171904
68,68307,2021-12-31,154580,19261,173841
68,68307,2022-12-31,156027,19143,175170
68,68307,2023-12-31,157403,19015,176418
68,68307,2024-12-31,159168,18904,178072
68,68307,2025-12-31,160875,18811,179686
68,68307,2026-12-31,162535,18721,181256
68,68307,2027-12-31,164092,18670,182762
68,68307,2028-12-31,165523,18641,184164
68,68307,2029-12-31,166857,18610,185467
68,68307,2030-12-31,168097,18594,186691
68,68307,2031-12-31,169252,18605,187857
68,68307,2032-12-31,170327,18595,188922
68,68307,2033-12-31,171342,18587,189929
68,68307,2034-12-31,172301,18549,190850
68,68307,2035-12-31,173197,18517,191714
68,68318,1985-12-31,1290,6588,7878
68,68318,1986-12-31,1340,6530,7870
68,68318,1987-12-31,1332,6370,7702
68,68318,1988-12-31,1334,6245,7579
68,68318,1989-12-31,1339,6105,7444
68,68318,1990-12-31,1346,6002,7348
68,68318,1991-12-31,1359,5867,7226
68,68318,1992-12-31,1368,5773,7141
68,68318,1993-12-31,1378,6017,7395
68,68318,1994-12-31,1396,5963,7359
68,68318,1995-12-31,1392,5905,7297
68,68318,1996-12-31,1395,5854,7249
68,68318,1997-12-31,1449,5796,7245
68,68318,1998-12-31,1435,5708,7143
68,68318,1999-12-31,1420,5638,7058
68,68318,2000-12-31,1436,5564,7000
68,68318,2001-12-31,1441,5501,6942
68,68318,2002-12-31,1431,5437,6868
68,68318,2003-12-31,1432,5361,6793
68,68318,2004-12-31,1457,5304,6761
68,68318,2005-12-31,1456,5244,6700
68,68318,2006-12-31,1460,5121,6581
68,68318,2007-12-31,1472,5077,6549
68,68318,2008-12-31,1458,5019,6477
68,68318,2009-12-31,1473,4946,6419
68,68318,2010-12-31,1484,4885,6369
68,68318,2011-12-31,1493,4826,6319
68,68318,2012-12-31,1506,4774,6280
68,68318,2013-12-31,1503,4723,6226
68,68318,2014-12-31,1486,4638,6124
68,68318,2015-12-31,1489,4562,6051
68,68318,2016-12-31,1480,4519,5999
68,68318,2017-12-31,1493,4480,5973
68,68318,2018-12-31,1508,4408,5916
68,68318,2019-12-31,1550,4350,5900
68,68318,2020-12-31,1586,4323,5909
68,68318,2021-12-31,1665,4309,5974
68,68318,2022-12-31,1737,4283,6020
68,68318,2023-12-31,1809,4254,6063
68,68318,2024-12-31,1841,4230,6071
68,68318,2025-12-31,1877,4198,6075
68,68318,2026-12-31,1894,4190,6084
68,68318,2027-12-31,1909,4183,6092
68,68318,2028-12-31,1926,4175,6101
68,68318,2029-12-31,1936,4163,6099
68,68318,2030-12-31,1959,4166,6125
68,68318,2031-12-31,1973,4156,6129
68,68318,2032-12-31,1984,4165,6149
68,68318,2033-12-31,1998,4155,6153
68,68318,2034-12-31,2005,4143,6148
68,68318,2035-12-31,2015,4135,6150
68,68320,1985-12-31,1414,5593,7007
68,68320,1986-12-31,1425,5519,6944
68,68320,1987-12-31,1440,5371,6811
68,68320,1988-12-31,1450,5236,6686
68,68320,1989-12-31,1448,5114,6562
68,68320,1990-12-31,1499,4984,6483
68,68320,1991-12-31,1530,4834,6364
68,68320,1992-12-31,1523,4727,6250
68,68320,1993-12-31,1531,4891,6422
68,68320,1994-12-31,1553,4809,6362
68,68320,1995-12-31,1566,4725,6291
68,68320,1996-12-31,1547,4636,6183
68,68320,1997-12-31,1526,4550,6076
68,68320,1998-12-31,1554,4490,6044
68,68320,1999-12-31,1556,4399,5955
68,68320,2000-12-31,1577,4336,5913
68,68320,2001-12-31,1582,4198,5780
68,68320,2002-12-31,1591,4102,5693
68,68320,2003-12-31,1592,4022,5614
68,68320,2004-12-31,1608,3935,5543
68,68320,2005-12-31,1580,3860,5440
68,68320,2006-12-31,1577,3804,5381
68,68320,2007-12-31,1589,3697,5286
68,68320,2008-12-31,1589,3607,5196
68,68320,2009-12-31,1598,3525,5123
68,68320,2010-12-31,1601,3452,5053
68,68320,2011-12-31,1628,3373,5001
68,68320,2012-12-31,1624,3301,4925
68,68320,2013-12-31,1633,3204,4837
68,68320,2014-12-31,1638,3122,4760
68,68320,2015-12-31,1632,3044,4676
68,68320,2016-12-31,1641,2983,4624
68,68320,2017-12-31,1663,2887,4550
68,68320,2018-12-31,1693,2818,4511
68,68320,2019-12-31,1698,2775,4473
68,68320,2020-12-31,1711,2757,4468
68,68320,2021-12-31,1769,2748,4517
68,68320,2022-12-31,1821,2731,4552
68,68320,2023-12-31,1871,2713,4584
68,68320,2024-12-31,1896,2705,4601
68,68320,2025-12-31,1914,2690,4604
68,68320,2026-12-31,1936,2673,4609
68,68320,2027-12-31,1963,2667,4630
68,68320,2028-12-31,1972,2658,4630
68,68320,2029-12-31,1991,2654,4645
68,68320,2030-12-31,2008,2654,4662
68,68320,2031-12-31,2020,2649,4669
68,68320,2032-12-31,2037,2651,4688
68,68320,2033-12-31,2042,2647,4689
68,68320,2034-12-31,2058,2648,4706
68,68320,2035-12-31,2065,2637,4702
68,68322,1985-12-31,350,2019,2369
68,68322,1986-12-31,376,1951,2327
68,68322,1987-12-31,362,1926,2288
68,68322,1988-12-31,370,1922,2292
68,68322,1989-12-31,411,1918,2329
68,68322,1990-12-31,422,1911,2333
68,68322,1991-12-31,418,1882,2300
68,68322,1992-12-31,414,1837,2251
68,68322,1993-12-31,422,1889,2311
68,68322,1994-12-31,457,1868,2325
68,68322,1995-12-31,425,1857,2282
68,68322,1996-12-31,430,1854,2284
68,68322,1997-12-31,446,1847,2293
68,68322,1998-12-31,479,1875,2354
68,68322,1999-12-31,495,1857,2352
68,68322,2000-12-31,509,1843,2352
68,68322,2001-12-31,517,1836,2353
68,68322,2002-12-31,485,1825,2310
68,68322,2003-12-31,510,1819,2329
68,68322,2004-12-31,511,1812,2323
68,68322,2005-12-31,518,1801,2319
68,68322,2006-12-31,530,1817,2347
68,68322,2007-12-31,551,1835,2386
68,68322,2008-12-31,561,1809,2370
68,68322,2009-12-31,573,1785,2358
68,68322,2010-12-31,581,1773,2354
68,68322,2011-12-31,589,1750,2339
68,68322,2012-12-31,596,1742,2338
68,68322,2013-12-31,603,1728,2331
68,68322,2014-12-31,616,1719,2335
68,68322,2015-12-31,623,1703,2326
68,68322,2016-12-31,634,1699,2333
68,68322,2017-12-31,646,1709,2355
68,68322,2018-12-31,665,1710,2375
68,68322,2019-12-31,682,1712,2394
68,68322,2020-12-31,697,1716,2413
68,68322,2021-12-31,729,1711,2440
68,68322,2022-12-31,758,1700,2458
68,68322,2023-12-31,787,1689,2476
68,68322,2024-12-31,804,1677,2481
68,68322,2025-12-31,812,1667,2479
68,68322,2026-12-31,820,1662,2482
68,68322,2027-12-31,828,1654,2482
68,68322,2028-12-31,834,1655,2489
68,68322,2029-12-31,843,1647,2490
68,68322,2030-12-31,850,1651,2501
68,68322,2031-12-31,866,1646,2512
68,68322,2032-12-31,860,1650,2510
68,68322,2033-12-31,870,1645,2515
68,68322,2034-12-31,879,1649,2528
68,68322,2035-12-31,878,1648,2526
68,68324,1985-12-31,674,5535,6209
68,68324,1986-12-31,702,5508,6210
68,68324,1987-12-31,741,5325,6066
68,68324,1988-12-31,731,5218,5949
68,68324,1989-12-31,740,5146,5886
68,68324,1990-12-31,758,4956,5714
68,68324,1991-12-31,769,4856,5625
68,68324,1992-12-31,778,4760,5538
68,68324,1993-12-31,780,4955,5735
68,68324,1994-12-31,806,4877,5683
68,68324,1995-12-31,806,4790,5596
68,68324,1996-12-31,817,4748,5565
68,68324,1997-12-31,826,4672,5498
68,68324,1998-12-31,818,4598,5416
68,68324,1999-12-31,864,4524,5388
68,68324,2000-12-31,844,4448,5292
68,68324,2001-12-31,854,4380,5234
68,68324,2002-12-31,856,4278,5134
68,68324,2003-12-31,871,4208,5079
68,68324,2004-12-31,896,4132,5028
68,68324,2005-12-31,870,4067,4937
68,68324,2006-12-31,896,4018,4914
68,68324,2007-12-31,923,3938,4861
68,68324,2008-12-31,946,3876,4822
68,68324,2009-12-31,962,3808,4770
68,68324,2010-12-31,961,3742,4703
68,68324,2011-12-31,935,3674,4609
68,68324,2012-12-31,920,3593,4513
68,68324,2013-12-31,935,3536,4471
68,68324,2014-12-31,946,3474,4420
68,68324,2015-12-31,967,3396,4363
68,68324,2016-12-31,989,3350,4339
68,68324,2017-12-31,1007,3260,4267
68,68324,2018-12-31,1027,3203,4230
68,68324,2019-12-31,1043,3157,4200
68,68324,2020-12-31,1052,3139,4191
68,68324,2021-12-31,1108,3129,4237
68,68324,2022-12-31,1160,3110,4270
68,68324,2023-12-31,1211,3089,4300
68,68324,2024-12-31,1230,3072,4302
68,68324,2025-12-31,1254,3044,4298
68,68324,2026-12-31,1264,3030,4294
68,68324,2027-12-31,1272,3033,4305
68,68324,2028-12-31,1283,3014,4297
68,68324,2029-12-31,1299,3006,4305
68,68324,2030-12-31,1304,3011,4315
68,68324,2031-12-31,1314,3008,4322
68,68324,2032-12-31,1320,3013,4333
68,68324,2033-12-31,1328,3006,4334
68,68324,2034-12-31,1334,3007,4341
68,68324,2035-12-31,1347,2996,4343
68,68327,1985-12-31,1371,2185,3556
68,68327,1986-12-31,1425,2161,3586
68,68327,1987-12-31,1468,2142,3610
68,68327,1988-12-31,1523,2122,3645
68,68327,1989-12-31,1595,2127,3722
68,68327,1990-12-31,1653,2130,3783
68,68327,1991-12-31,1693,2093,3786
68,68327,1992-12-31,1757,2052,3809
68,68327,1993-12-31,1810,2116,3926
68,68327,1994-12-31,1865,2108,3973
68,68327,1995-12-31,1932,2096,4028
68,68327,1996-12-31,1976,2103,4079
68,68327,1997-12-31,2031,2110,4141
68,68327,1998-12-31,2067,2102,4169
68,68327,1999-12-31,2139,2091,4230
68,68327,2000-12-31,2169,2088,4257
68,68327,2001-12-31,2225,2094,4319
68,68327,2002-12-31,2285,2088,4373
68,68327,2003-12-31,2321,2071,4392
68,68327,2004-12-31,2378,2094,4472
68,68327,2005-12-31,2423,2077,4500
68,68327,2006-12-31,2477,2070,4547
68,68327,2007-12-31,2517,2070,4587
68,68327,2008-12-31,2567,2061,4628
68,68327,2009-12-31,2638,2075,4713
68,68327,2010-12-31,2679,2082,4761
68,68327,2011-12-31,2716,2049,4765
68,68327,2012-12-31,2769,2057,4826
68,68327,2013-12-31,2837,2094,4931
68,68327,2014-12-31,2884,2078,4962
68,68327,2015-12-31,2892,2059,4951
68,68327,2016-12-31,2926,2042,4968
68,68327,2017-12-31,2995,2037,5032
68,68327,2018-12-31,3071,2043,5114
68,68327,2019-12-31,3164,2058,5222
68,68327,2020-12-31,3243,2066,5309
68,68327,2021-12-31,3309,2059,5368
68,68327,2022-12-31,3362,2047,5409
68,68327,2023-12-31,3414,2033,5447
68,68327,2024-12-31,3460,2017,5477
68,68327,2025-12-31,3494,2002,5496
68,68327,2026-12-31,3537,2001,5538
68,68327,2027-12-31,3570,1993,5563
68,68327,2028-12-31,3609,1986,5595
68,68327,2029-12-31,3631,1987,5618
68,68327,2030-12-31,3663,1989,5652
68,68327,2031-12-31,3690,1994,5684
68,68327,2032-12-31,3709,1986,5695
68,68327,2033-12-31,3732,1987,5719
68,68327,2034-12-31,3753,1984,5737
68,68327,2035-12-31,3776,1978,5754
68,68344,1985-12-31,383,1960,2343
68,68344,1986-12-31,402,1937,2339
68,68344,1987-12-31,406,1891,2297
68,68344,1988-12-31,410,1869,2279
68,68344,1989-12-31,405,1858,2263
68,68344,1990-12-31,454,1852,2306
68,68344,1991-12-31,444,1804,2248
68,68344,1992-12-31,449,1786,2235
68,68344,1993-12-31,450,1872,2322
68,68344,1994-12-31,482,1876,2358
68,68344,1995-12-31,452,1859,2311
68,68344,1996-12-31,460,1858,2318
68,68344,1997-12-31,502,1840,2342
68,68344,1998-12-31,539,1808,2347
68,68344,1999-12-31,540,1776,2316
68,68344,2000-12-31,544,1792,2336
68,68344,2001-12-31,536,1759,2295
68,68344,2002-12-31,547,1773,2320
68,68344,2003-12-31,564,1758,2322
68,68344,2004-12-31,528,1729,2257
68,68344,2005-12-31,567,1734,2301
68,68344,2006-12-31,560,1722,2282
68,68344,2007-12-31,591,1714,2305
68,68344,2008-12-31,581,1707,2288
68,68344,2009-12-31,611,1708,2319
68,68344,2010-12-31,621,1690,2311
68,68344,2011-12-31,638,1686,2324
68,68344,2012-12-31,644,1677,2321
68,68344,2013-12-31,641,1665,2306
68,68344,2014-12-31,644,1665,2309
68,68344,2015-12-31,642,1661,2303
68,68344,2016-12-31,646,1664,2310
68,68344,2017-12-31,651,1660,2311
68,68344,2018-12-31,657,1671,2328
68,68344,2019-12-31,677,1672,2349
68,68344,2020-12-31,694,1676,2370
68,68344,2021-12-31,725,1671,2396
68,68344,2022-12-31,755,1660,2415
68,68344,2023-12-31,783,1649,2432
68,68344,2024-12-31,795,1640,2435
68,68344,2025-12-31,806,1627,2433
68,68344,2026-12-31,827,1620,2447
68,68344,2027-12-31,828,1612,2440
68,68344,2028-12-31,833,1616,2449
68,68344,2029-12-31,839,1614,2453
68,68344,2030-12-31,845,1599,2444
68,68344,2031-12-31,854,1604,2458
68,68344,2032-12-31,862,1607,2469
68,68344,2033-12-31,860,1608,2468
68,68344,2034-12-31,860,1599,2459
68,68344,2035-12-31,870,1600,2470
68,68368,1985-12-31,697,3395,4092
68,68368,1986-12-31,705,3320,4025
68,68368,1987-12-31,697,3277,3974
68,68368,1988-12-31,694,3252,3946
68,68368,1989-12-31,707,3229,3936
68,68368,1990-12-31,687,3183,3870
68,68368,1991-12-31,698,3080,3778
68,68368,1992-12-31,699,3015,3714
68,68368,1993-12-31,687,3169,3856
68,68368,1994-12-31,710,3110,3820
68,68368,1995-12-31,690,3093,3783
68,68368,1996-12-31,710,3080,3790
68,68368,1997-12-31,704,3078,3782
68,68368,1998-12-31,696,3059,3755
68,68368,1999-12-31,681,3011,3692
68,68368,2000-12-31,695,2987,3682
68,68368,2001-12-31,687,2967,3654
68,68368,2002-12-31,706,2945,3651
68,68368,2003-12-31,732,2936,3668
68,68368,2004-12-31,741,2929,3670
68,68368,2005-12-31,734,2900,3634
68,68368,2006-12-31,740,2876,3616
68,68368,2007-12-31,739,2856,3595
68,68368,2008-12-31,729,2835,3564
68,68368,2009-12-31,716,2819,3535
68,68368,2010-12-31,705,2803,3508
68,68368,2011-12-31,699,2789,3488
68,68368,2012-12-31,699,2744,3443
68,68368,2013-12-31,690,2730,3420
68,68368,2014-12-31,695,2701,3396
68,68368,2015-12-31,695,2671,3366
68,68368,2016-12-31,700,2627,3327
68,68368,2017-12-31,706,2606,3312
68,68368,2018-12-31,719,2623,3342
68,68368,2019-12-31,723,2614,3337
68,68368,2020-12-31,729,2610,3339
68,68368,2021-12-31,774,2602,3376
68,68368,2022-12-31,816,2586,3402
68,68368,2023-12-31,857,2569,3426
68,68368,2024-12-31,871,2558,3429
68,68368,2025-12-31,878,2541,3419
68,68368,2026-12-31,894,2528,3422
68,68368,2027-12-31,909,2525,3434
68,68368,2028-12-31,915,2517,3432
68,68368,2029-12-31,920,2510,3430
68,68368,2030-12-31,924,2509,3433
68,68368,2031-12-31,929,2510,3439
68,68368,2032-12-31,936,2505,3441
68,68368,2033-12-31,945,2501,3446
68,68368,2034-12-31,951,2493,3444
68,68368,2035-12-31,949,2504,3453
68,68370,1985-12-31,84,1267,1351
68,68370,1986-12-31,84,1263,1347
68,68370,1987-12-31,83,1244,1327
68,68370,1988-12-31,84,1232,1316
68,68370,1989-12-31,87,1261,1348
68,68370,1990-12-31,85,1259,1344
68,68370,1991-12-31,83,1251,1334
68,68370,1992-12-31,81,1222,1303
68,68370,1993-12-31,79,1265,1344
68,68370,1994-12-31,77,1256,1333
68,68370,1995-12-31,75,1252,1327
68,68370,1996-12-31,74,1245,1319
68,68370,1997-12-31,72,1231,1303
68,68370,1998-12-31,71,1218,1289
68,68370,1999-12-31,70,1223,1293
68,68370,2000-12-31,69,1223,1292
68,68370,2001-12-31,68,1217,1285
68,68370,2002-12-31,68,1212,1280
68,68370,2003-12-31,66,1210,1276
68,68370,2004-12-31,79,1224,1303
68,68370,2005-12-31,80,1202,1282
68,68370,2006-12-31,75,1201,1276
68,68370,2007-12-31,76,1197,1273
68,68370,2008-12-31,72,1196,1268
68,68370,2009-12-31,69,1193,1262
68,68370,2010-12-31,108,1197,1305
68,68370,2011-12-31,100,1208,1308
68,68370,2012-12-31,106,1203,1309
68,68370,2013-12-31,98,1207,1305
68,68370,2014-12-31,95,1203,1298
68,68370,2015-12-31,96,1195,1291
68,68370,2016-12-31,110,1196,1306
68,68370,2017-12-31,108,1200,1308
68,68370,2018-12-31,99,1215,1314
68,68370,2019-12-31,103,1222,1325
68,68370,2020-12-31,107,1229,1336
68,68370,2021-12-31,126,1225,1351
68,68370,2022-12-31,144,1217,1361
68,68370,2023-12-31,162,1209,1371
68,68370,2024-12-31,130,1197,1327
68,68370,2025-12-31,134,1186,1320
68,68370,2026-12-31,149,1178,1327
68,68370,2027-12-31,160,1178,1338
68,68370,2028-12-31,164,1178,1342
68,68370,2029-12-31,166,1187,1353
68,68370,2030-12-31,167,1188,1355
68,68370,2031-12-31,172,1183,1355
68,68370,2032-12-31,170,1187,1357
68,68370,2033-12-31,168,1183,1351
68,68370,2034-12-31,167,1172,1339
68,68370,2035-12-31,166,1168,1334
68,68377,1985-12-31,1135,7495,8630
68,68377,1986-12-31,1196,7389,8585
68,68377,1987-12-31,1194,7235,8429
68,68377,1988-12-31,1197,7046,8243
68,68377,1989-12-31,1237,6896,8133
68,68377,1990-12-31,1245,6748,7993
68,68377,1991-12-31,1297,6611,7908
68,68377,1992-12-31,1303,6466,7769
68,68377,1993-12-31,1328,6723,8051
68,68377,1994-12-31,1312,6650,7962
68,68377,1995-12-31,1355,6535,7890
68,68377,1996-12-31,1359,6445,7804
68,68377,1997-12-31,1381,6378,7759
68,68377,1998-12-31,1403,6282,7685
68,68377,1999-12-31,1397,6188,7585
68,68377,2000-12-31,1432,6113,7545
68,68377,2001-12-31,1487,6024,7511
68,68377,2002-12-31,1484,5925,7409
68,68377,2003-12-31,1472,5814,7286
68,68377,2004-12-31,1489,5717,7206
68,68377,2005-12-31,1508,5605,7113
68,68377,2006-12-31,1524,5527,7051
68,68377,2007-12-31,1527,5461,6988
68,68377,2008-12-31,1585,5344,6929
68,68377,2009-12-31,1596,5250,6846
68,68377,2010-12-31,1594,5162,6756
68,68377,2011-12-31,1606,5079,6685
68,68377,2012-12-31,1604,5011,6615
68,68377,2013-12-31,1611,4926,6537
68,68377,2014-12-31,1618,4836,6454
68,68377,2015-12-31,1635,4723,6358
68,68377,2016-12-31,1655,4644,6299
68,68377,2017-12-31,1669,4607,6276
68,68377,2018-12-31,1696,4502,6198
68,68377,2019-12-31,1746,4428,6174
68,68377,2020-12-31,1789,4389,6178
68,68377,2021-12-31,1871,4375,6246
68,68377,2022-12-31,1946,4348,6294
68,68377,2023-12-31,2020,4319,6339
68,68377,2024-12-31,2051,4299,6350
68,68377,2025-12-31,2082,4277,6359
68,68377,2026-12-31,2106,4258,6364
68,68377,2027-12-31,2122,4242,6364
68,68377,2028-12-31,2151,4233,6384
68,68377,2029-12-31,2156,4229,6385
68,68377,2030-12-31,2181,4220,6401
68,68377,2031-12-31,2192,4231,6423
68,68377,2032-12-31,2204,4211,6415
68,68377,2033-12-31,2222,4214,6436
68,68377,2034-12-31,2233,4201,6434
68,68377,2035-12-31,2245,4199,6444
68,68385,1985-12-31,1382,9369,10751
68,68385,1986-12-31,1427,9309,10736
68,68385,1987-12-31,1488,9170,10658
68,68385,1988-12-31,1534,9000,10534
68,68385,1989-12-31,1584,8841,10425
68,68385,1990-12-31,1645,8686,10331
68,68385,1991-12-31,1701,8568,10269
68,68385,1992-12-31,1763,8446,10209
68,68385,1993-12-31,1819,8816,10635
68,68385,1994-12-31,1890,8770,10660
68,68385,1995-12-31,1976,8708,10684
68,68385,1996-12-31,2039,8644,10683
68,68385,1997-12-31,2079,8578,10657
68,68385,1998-12-31,2123,8515,10638
68,68385,1999-12-31,2200,8449,10649
68,68385,2000-12-31,2243,8376,10619
68,68385,2001-12-31,2284,8323,10607
68,68385,2002-12-31,2342,8244,10586
68,68385,2003-12-31,2410,8176,10586
68,68385,2004-12-31,2443,8110,10553
68,68385,2005-12-31,2496,8007,10503
68,68385,2006-12-31,2545,7937,10482
68,68385,2007-12-31,2612,7878,10490
68,68385,2008-12-31,2654,7811,10465
68,68385,2009-12-31,2709,7735,10444
68,68385,2010-12-31,2761,7676,10437
68,68385,2011-12-31,2814,7601,10415
68,68385,2012-12-31,2874,7491,10365
68,68385,2013-12-31,2903,7410,10313
68,68385,2014-12-31,3003,7320,10323
68,68385,2015-12-31,3052,7256,10308
68,68385,2016-12-31,3084,7167,10251
68,68385,2017-12-31,3122,7167,10289
68,68385,2018-12-31,3182,7202,10384
68,68385,2019-12-31,3288,7194,10482
68,68385,2020-12-31,3382,7206,10588
68,68385,2021-12-31,3522,7183,10705
68,68385,2022-12-31,3648,7139,10787
68,68385,2023-12-31,3772,7092,10864
68,68385,2024-12-31,3852,7062,10914
68,68385,2025-12-31,3905,7013,10918
68,68385,2026-12-31,3959,6990,10949
68,68385,2027-12-31,4003,6961,10964
68,68385,2028-12-31,4032,6945,10977
68,68385,2029-12-31,4068,6937,11005
68,68385,2030-12-31,4090,6929,11019
68,68385,2031-12-31,4117,6942,11059
68,68385,2032-12-31,4147,6946,11093
68,68385,2033-12-31,4174,6933,11107
68,68385,2034-12-31,4202,6919,11121
68,68385,2035-12-31,4228,6898,11126
68,68397,1985-12-31,683,6625,7308
68,68397,1986-12-31,721,6592,7313
68,68397,1987-12-31,728,6424,7152
68,68397,1988-12-31,730,6295,7025
68,68397,1989-12-31,742,6122,6864
68,68397,1990-12-31,740,5981,6721
68,68397,1991-12-31,709,5882,6591
68,68397,1992-12-31,721,5785,6506
68,68397,1993-12-31,727,5994,6721
68,68397,1994-12-31,746,5933,6679
68,68397,1995-12-31,749,5858,6607
68,68397,1996-12-31,756,5805,6561
68,68397,1997-12-31,751,5743,6494
68,68397,1998-12-31,733,5619,6352
68,68397,1999-12-31,734,5584,6318
68,68397,2000-12-31,717,5516,6233
68,68397,2001-12-31,700,5446,6146
68,68397,2002-12-31,710,5335,6045
68,68397,2003-12-31,712,5247,5959
68,68397,2004-12-31,727,5175,5902
68,68397,2005-12-31,750,5075,5825
68,68397,2006-12-31,741,5023,5764
68,68397,2007-12-31,731,4943,5674
68,68397,2008-12-31,724,4877,5601
68,68397,2009-12-31,726,4834,5560
68,68397,2010-12-31,720,4760,5480
68,68397,2011-12-31,721,4690,5411
68,68397,2012-12-31,720,4616,5336
68,68397,2013-12-31,719,4535,5254
68,68397,2014-12-31,723,4462,5185
68,68397,2015-12-31,724,4372,5096
68,68397,2016-12-31,727,4344,5071
68,68397,2017-12-31,732,4262,4994
68,68397,2018-12-31,756,4197,4953
68,68397,2019-12-31,761,4160,4921
68,68397,2020-12-31,768,4149,4917
68,68397,2021-12-31,835,4136,4971
68,68397,2022-12-31,898,4111,5009
68,68397,2023-12-31,962,4083,5045
68,68397,2024-12-31,982,4064,5046
68,68397,2025-12-31,1000,4041,5041
68,68397,2026-12-31,1013,4028,5041
68,68397,2027-12-31,1023,4006,5029
68,68397,2028-12-31,1030,4009,5039
68,68397,2029-12-31,1036,3998,5034
68,68397,2030-12-31,1040,3998,5038
68,68397,2031-12-31,1057,3991,5048
68,68397,2032-12-31,1060,3988,5048
68,68397,2033-12-31,1064,3981,5045
68,68397,2034-12-31,1070,3982,5052
68,68397,2035-12-31,1082,3966,5048
68,68406,1985-12-31,4668,16795,21463
68,68406,1986-12-31,5158,16876,22034
68,68406,1987-12-31,5695,16805,22500
68,68406,1988-12-31,6240,16731,22971
68,68406,1989-12-31,6753,16571,23324
68,68406,1990-12-31,7306,16541,23847
68,68406,1991-12-31,7847,16449,24296
68,68406,1992-12-31,8402,16397,24799
68,68406,1993-12-31,8942,17353,26295
68,68406,1994-12-31,9505,17430,26935
68,68406,1995-12-31,10069,17521,27590
68,68406,1996-12-31,10621,17589,28210
68,68406,1997-12-31,11183,17681,28864
68,68406,1998-12-31,11779,17752,29531
68,68406,1999-12-31,12362,17821,30183
68,68406,2000-12-31,12947,17863,30810
68,68406,2001-12-31,13496,17963,31459
68,68406,2002-12-31,14073,17992,32065
68,68406,2003-12-31,14616,18035,32651
68,68406,2004-12-31,15170,18081,33251
68,68406,2005-12-31,15719,18139,33858
68,68406,2006-12-31,16262,18183,34445
68,68406,2007-12-31,16818,18228,35046
68,68406,2008-12-31,17348,18267,35615
68,68406,2009-12-31,17879,18305,36184
68,68406,2010-12-31,18427,18351,36778
68,68406,2011-12-31,18982,18411,37393
68,68406,2012-12-31,19483,18446,37929
68,68406,2013-12-31,19926,18531,38457
68,68406,2014-12-31,20453,18575,39028
68,68406,2015-12-31,20929,18681,39610
68,68406,2016-12-31,21460,18717,40177
68,68406,2017-12-31,21999,18881,40880
68,68406,2018-12-31,22732,19103,41835
68,68406,2019-12-31,23825,19320,43145
68,68406,2020-12-31,24701,19468,44169
68,68406,2021-12-31,25257,19410,44667
68,68406,2022-12-31,25717,19291,45008
68,68406,2023-12-31,26166,19163,45329
68,68406,2024-12-31,26573,19052,45625
68,68406,2025-12-31,26950,18968,45918
68,68406,2026-12-31,27300,18909,46209
68,68406,2027-12-31,27618,18822,46440
68,68406,2028-12-31,27912,18784,46696
68,68406,2029-12-31,28168,18754,46922
68,68406,2030-12-31,28416,18751,47167
68,68406,2031-12-31,28630,18747,47377
68,68406,2032-12-31,28841,18753,47594
68,68406,2033-12-31,29026,18727,47753
68,68406,2034-12-31,29211,18708,47919
68,68406,2035-12-31,29373,18657,48030
68,68418,1985-12-31,869,7736,8605
68,68418,1986-12-31,871,7874,8745
68,68418,1987-12-31,879,7950,8829
68,68418,1988-12-31,940,8037,8977
68,68418,1989-12-31,983,8095,9078
68,68418,1990-12-31,983,8156,9139
68,68418,1991-12-31,1003,8241,9244
68,68418,1992-12-31,1037,8304,9341
68,68418,1993-12-31,1064,8897,9961
68,68418,1994-12-31,1074,9054,10128
68,68418,1995-12-31,1106,9208,10314
68,68418,1996-12-31,1129,9352,10481
68,68418,1997-12-31,1140,9496,10636
68,68418,1998-12-31,1135,9629,10764
68,68418,1999-12-31,1177,9771,10948
68,68418,2000-12-31,1220,9921,11141
68,68418,2001-12-31,1256,10066,11322
68,68418,2002-12-31,1269,10182,11451
68,68418,2003-12-31,1301,10328,11629
68,68418,2004-12-31,1328,10476,11804
68,68418,2005-12-31,1357,10600,11957
68,68418,2006-12-31,1369,10732,12101
68,68418,2007-12-31,1358,10877,12235
68,68418,2008-12-31,1386,11024,12410
68,68418,2009-12-31,1391,11114,12505
68,68418,2010-12-31,1409,11214,12623
68,68418,2011-12-31,1461,11353,12814
68,68418,2012-12-31,1476,11451,12927
68,68418,2013-12-31,1508,11582,13090
68,68418,2014-12-31,1527,11718,13245
68,68418,2015-12-31,1549,11877,13426
68,68418,2016-12-31,1583,12010,13593
68,68418,2017-12-31,1613,12213,13826
68,68418,2018-12-31,1643,12463,14106
68,68418,2019-12-31,1693,12792,14485
68,68418,2020-12-31,1735,13052,14787
68,68418,2021-12-31,1941,13013,14954
68,68418,2022-12-31,2134,12934,15068
68,68418,2023-12-31,2328,12847,15175
68,68418,2024-12-31,2407,12766,15173
68,68418,2025-12-31,2449,12711,15160
68,68418,2026-12-31,2486,12664,15150
68,68418,2027-12-31,2503,12624,15127
68,68418,2028-12-31,2533,12590,15123
68,68418,2029-12-31,2549,12588,15137
68,68418,2030-12-31,2573,12584,15157
68,68418,2031-12-31,2592,12582,15174
68,68418,2032-12-31,2607,12579,15186
68,68418,2033-12-31,2625,12581,15206
68,68418,2034-12-31,2632,12555,15187
68,68418,2035-12-31,2652,12531,15183
68,68425,1985-12-31,191,4407,4598
68,68425,1986-12-31,201,4291,4492
68,68425,1987-12-31,203,4203,4406
68,68425,1988-12-31,190,4089,4279
68,68425,1989-12-31,226,4018,4244
68,68425,1990-12-31,217,3890,4107
68,68425,1991-12-31,229,3776,4005
68,68425,1992-12-31,236,3661,3897
68,68425,1993-12-31,234,3794,4028
68,68425,1994-12-31,246,3689,3935
68,68425,1995-12-31,260,3610,3870
68,68425,1996-12-31,269,3550,3819
68,68425,1997-12-31,269,3459,3728
68,68425,1998-12-31,276,3372,3648
68,68425,1999-12-31,284,3328,3612
68,68425,2000-12-31,266,3225,3491
68,68425,2001-12-31,278,3145,3423
68,68425,2002-12-31,256,3050,3306
68,68425,2003-12-31,261,2993,3254
68,68425,2004-12-31,263,2915,3178
68,68425,2005-12-31,257,2846,3103
68,68425,2006-12-31,280,2781,3061
68,68425,2007-12-31,268,2703,2971
68,68425,2008-12-31,277,2624,2901
68,68425,2009-12-31,296,2558,2854
68,68425,2010-12-31,287,2482,2769
68,68425,2011-12-31,281,2416,2697
68,68425,2012-12-31,289,2347,2636
68,68425,2013-12-31,285,2261,2546
68,68425,2014-12-31,281,2156,2437
68,68425,2015-12-31,277,2105,2382
68,68425,2016-12-31,277,2046,2323
68,68425,2017-12-31,275,1934,2209
68,68425,2018-12-31,280,1891,2171
68,68425,2019-12-31,284,1841,2125
68,68425,2020-12-31,289,1815,2104
68,68425,2021-12-31,318,1809,2127
68,68425,2022-12-31,346,1798,2144
68,68425,2023-12-31,373,1786,2159
68,68425,2024-12-31,392,1781,2173
68,68425,2025-12-31,397,1771,2168
68,68425,2026-12-31,396,1767,2163
68,68425,2027-12-31,397,1755,2152
68,68425,2028-12-31,397,1747,2144
68,68425,2029-12-31,401,1744,2145
68,68425,2030-12-31,404,1744,2148
68,68425,2031-12-31,408,1749,2157
68,68425,2032-12-31,409,1742,2151
68,68425,2033-12-31,408,1743,2151
68,68425,2034-12-31,411,1741,2152
68,68425,2035-12-31,414,1739,2153
68,68432,1985-12-31,11516,3768,15284
68,68432,1986-12-31,11685,3726,15411
68,68432,1987-12-31,11879,3650,15529
68,68432,1988-12-31,12081,3611,15692
68,68432,1989-12-31,12276,3595,15871
68,68432,1990-12-31,12485,3529,16014
68,68432,1991-12-31,12679,3453,16132
68,68432,1992-12-31,12912,3377,16289
68,68432,1993-12-31,13136,3539,16675
68,68432,1994-12-31,13348,3509,16857
68,68432,1995-12-31,13590,3490,17080
68,68432,1996-12-31,13811,3464,17275
68,68432,1997-12-31,14014,3440,17454
68,68432,1998-12-31,14233,3411,17644
68,68432,1999-12-31,14450,3361,17811
68,68432,2000-12-31,14691,3329,18020
68,68432,2001-12-31,14897,3291,18188
68,68432,2002-12-31,15107,3266,18373
68,68432,2003-12-31,15307,3233,18540
68,68432,2004-12-31,15503,3204,18707
68,68432,2005-12-31,15683,3193,18876
68,68432,2006-12-31,15872,3161,19033
68,68432,2007-12-31,16073,3122,19195
68,68432,2008-12-31,16248,3111,19359
68,68432,2009-12-31,16429,3081,19510
68,68432,2010-12-31,16619,3084,19703
68,68432,2011-12-31,16795,3071,19866
68,68432,2012-12-31,16967,3011,19978
68,68432,2013-12-31,17071,2955,20026
68,68432,2014-12-31,17199,2914,20113
68,68432,2015-12-31,17385,2890,20275
68,68432,2016-12-31,17561,2861,20422
68,68432,2017-12-31,17742,2854,20596
68,68432,2018-12-31,18091,2854,20945
68,68432,2019-12-31,18445,2894,21339
68,68432,2020-12-31,18770,2902,21672
68,68432,2021-12-31,19016,2896,21912
68,68432,2022-12-31,19200,2879,22079
68,68432,2023-12-31,19377,2860,22237
68,68432,2024-12-31,19570,2846,22416
68,68432,2025-12-31,19770,2822,22592
68,68432,2026-12-31,19956,2816,22772
68,68432,2027-12-31,20139,2807,22946
68,68432,2028-12-31,20318,2801,23119
68,68432,2029-12-31,20482,2801,23283
68,68432,2030-12-31,20619,2805,23424
68,68432,2031-12-31,20762,2799,23561
68,68432,2032-12-31,20895,2796,23691
68,68432,2033-12-31,21019,2792,23811
68,68432,2034-12-31,21123,2781,23904
68,68432,2035-12-31,21241,2779,24020
68,68444,1985-12-31,1078,4729,5807
68,68444,1986-12-31,1094,4690,5784
68,68444,1987-12-31,1130,4597,5727
68,68444,1988-12-31,1134,4524,5658
68,68444,1989-12-31,1170,4484,5654
68,68444,1990-12-31,1186,4391,5577
68,68444,1991-12-31,1202,4301,5503
68,68444,1992-12-31,1211,4239,5450
68,68444,1993-12-31,1231,4421,5652
68,68444,1994-12-31,1218,4388,5606
68,68444,1995-12-31,1232,4348,5580
68,68444,1996-12-31,1241,4319,5560
68,68444,1997-12-31,1245,4304,5549
68,68444,1998-12-31,1256,4252,5508
68,68444,1999-12-31,1277,4221,5498
68,68444,2000-12-31,1277,4176,5453
68,68444,2001-12-31,1300,4117,5417
68,68444,2002-12-31,1311,4073,5384
68,68444,2003-12-31,1307,4029,5336
68,68444,2004-12-31,1319,3993,5312
68,68444,2005-12-31,1316,3966,5282
68,68444,2006-12-31,1308,3931,5239
68,68444,2007-12-31,1338,3905,5243
68,68444,2008-12-31,1342,3869,5211
68,68444,2009-12-31,1373,3831,5204
68,68444,2010-12-31,1375,3810,5185
68,68444,2011-12-31,1395,3759,5154
68,68444,2012-12-31,1412,3771,5183
68,68444,2013-12-31,1423,3719,5142
68,68444,2014-12-31,1373,3650,5023
68,68444,2015-12-31,1362,3592,4954
68,68444,2016-12-31,1384,3561,4945
68,68444,2017-12-31,1407,3534,4941
68,68444,2018-12-31,1445,3531,4976
68,68444,2019-12-31,1449,3550,4999
68,68444,2020-12-31,1454,3581,5035
68,68444,2021-12-31,1521,3570,5091
68,68444,2022-12-31,1582,3548,5130
68,68444,2023-12-31,1641,3525,5166
68,68444,2024-12-31,1652,3503,5155
68,68444,2025-12-31,1684,3494,5178
68,68444,2026-12-31,1698,3465,5163
68,68444,2027-12-31,1716,3461,5177
68,68444,2028-12-31,1735,3453,5188
68,68444,2029-12-31,1743,3451,5194
68,68444,2030-12-31,1760,3444,5204
68,68444,2031-12-31,1767,3446,5213
68,68444,2032-12-31,1788,3449,5237
68,68444,2033-12-31,1793,3435,5228
68,68444,2034-12-31,1803,3435,5238
68,68444,2035-12-31,1818,3427,5245
68,68464,1985-12-31,2711,9313,12024
68,68464,1986-12-31,2735,9225,11960
68,68464,1987-12-31,2769,9095,11864
68,68464,1988-12-31,2828,8876,11704
68,68464,1989-12-31,2853,8677,11530
68,68464,1990-12-31,2899,8518,11417
68,68464,1991-12-31,2942,8370,11312
68,68464,1992-12-31,2987,8218,11205
68,68464,1993-12-31,3039,8575,11614
68,68464,1994-12-31,3090,8497,11587
68,68464,1995-12-31,3162,8418,11580
68,68464,1996-12-31,3219,8323,11542
68,68464,1997-12-31,3273,8240,11513
68,68464,1998-12-31,3329,8168,11497
68,68464,1999-12-31,3376,8054,11430
68,68464,2000-12-31,3417,7983,11400
68,68464,2001-12-31,3461,7886,11347
68,68464,2002-12-31,3500,7803,11303
68,68464,2003-12-31,3543,7706,11249
68,68464,2004-12-31,3583,7603,11186
68,68464,2005-12-31,3634,7490,11124
68,68464,2006-12-31,3667,7413,11080
68,68464,2007-12-31,3692,7276,10968
68,68464,2008-12-31,3727,7217,10944
68,68464,2009-12-31,3770,7104,10874
68,68464,2010-12-31,3821,7025,10846
68,68464,2011-12-31,3852,6949,10801
68,68464,2012-12-31,3898,6843,10741
68,68464,2013-12-31,3940,6733,10673
68,68464,2014-12-31,3982,6620,10602
68,68464,2015-12-31,4018,6525,10543
68,68464,2016-12-31,4053,6478,10531
68,68464,2017-12-31,4052,6447,10499
68,68464,2018-12-31,4135,6392,10527
68,68464,2019-12-31,4211,6365,10576
68,68464,2020-12-31,4281,6366,10647
68,68464,2021-12-31,4419,6346,10765
68,68464,2022-12-31,4540,6307,10847
68,68464,2023-12-31,4659,6265,10924
68,68464,2024-12-31,4729,6230,10959
68,68464,2025-12-31,4783,6194,10977
68,68464,2026-12-31,4832,6169,11001
68,68464,2027-12-31,4881,6156,11037
68,68464,2028-12-31,4917,6143,11060
68,68464,2029-12-31,4963,6134,11097
68,68464,2030-12-31,4989,6141,11130
68,68464,2031-12-31,5028,6142,11170
68,68464,2032-12-31,5061,6132,11193
68,68464,2033-12-31,5091,6126,11217
68,68464,2034-12-31,5120,6128,11248
68,68464,2035-12-31,5142,6111,11253
68,68468,1985-12-31,513,6971,7484
68,68468,1986-12-31,521,6873,7394
68,68468,1987-12-31,524,6698,7222
68,68468,1988-12-31,520,6521,7041
68,68468,1989-12-31,540,6344,6884
68,68468,1990-12-31,529,6199,6728
68,68468,1991-12-31,539,6042,6581
68,68468,1992-12-31,544,5885,6429
68,68468,1993-12-31,547,6086,6633
68,68468,1994-12-31,571,5971,6542
68,68468,1995-12-31,561,5906,6467
68,68468,1996-12-31,527,5799,6326
68,68468,1997-12-31,539,5705,6244
68,68468,1998-12-31,559,5599,6158
68,68468,1999-12-31,612,5504,6116
68,68468,2000-12-31,606,5399,6005
68,68468,2001-12-31,596,5268,5864
68,68468,2002-12-31,604,5161,5765
68,68468,2003-12-31,608,5050,5658
68,68468,2004-12-31,593,4939,5532
68,68468,2005-12-31,600,4832,5432
68,68468,2006-12-31,599,4751,5350
68,68468,2007-12-31,607,4627,5234
68,68468,2008-12-31,634,4505,5139
68,68468,2009-12-31,624,4424,5048
68,68468,2010-12-31,616,4325,4941
68,68468,2011-12-31,605,4219,4824
68,68468,2012-12-31,604,4122,4726
68,68468,2013-12-31,599,4021,4620
68,68468,2014-12-31,596,3917,4513
68,68468,2015-12-31,596,3793,4389
68,68468,2016-12-31,600,3714,4314
68,68468,2017-12-31,605,3635,4240
68,68468,2018-12-31,620,3517,4137
68,68468,2019-12-31,626,3479,4105
68,68468,2020-12-31,632,3474,4106
68,68468,2021-12-31,688,3463,4151
68,68468,2022-12-31,741,3442,4183
68,68468,2023-12-31,794,3419,4213
68,68468,2024-12-31,816,3402,4218
68,68468,2025-12-31,827,3384,4211
68,68468,2026-12-31,825,3368,4193
68,68468,2027-12-31,837,3359,4196
68,68468,2028-12-31,847,3350,4197
68,68468,2029-12-31,849,3345,4194
68,68468,2030-12-31,857,3344,4201
68,68468,2031-12-31,861,3337,4198
68,68468,2032-12-31,871,3338,4209
68,68468,2033-12-31,879,3353,4232
68,68468,2034-12-31,882,3340,4222
68,68468,2035-12-31,892,3327,4219
68,68498,1985-12-31,358,4627,4985
68,68498,1986-12-31,354,4643,4997
68,68498,1987-12-31,367,4585,4952
68,68498,1988-12-31,376,4565,4941
68,68498,1989-12-31,398,4563,4961
68,68498,1990-12-31,406,4518,4924
68,68498,1991-12-31,425,4463,4888
68,68498,1992-12-31,438,4447,4885
68,68498,1993-12-31,449,4663,5112
68,68498,1994-12-31,461,4676,5137
68,68498,1995-12-31,473,4690,5163
68,68498,1996-12-31,488,4695,5183
68,68498,1997-12-31,497,4736,5233
68,68498,1998-12-31,523,4723,5246
68,68498,1999-12-31,549,4739,5288
68,68498,2000-12-31,567,4738,5305
68,68498,2001-12-31,567,4767,5334
68,68498,2002-12-31,610,4720,5330
68,68498,2003-12-31,614,4697,5311
68,68498,2004-12-31,601,4675,5276
68,68498,2005-12-31,622,4711,5333
68,68498,2006-12-31,636,4741,5377
68,68498,2007-12-31,663,4703,5366
68,68498,2008-12-31,676,4725,5401
68,68498,2009-12-31,687,4747,5434
68,68498,2010-12-31,698,4771,5469
68,68498,2011-12-31,707,4785,5492
68,68498,2012-12-31,729,4795,5524
68,68498,2013-12-31,742,4785,5527
68,68498,2014-12-31,760,4773,5533
68,68498,2015-12-31,774,4764,5538
68,68498,2016-12-31,785,4785,5570
68,68498,2017-12-31,790,4813,5603
68,68498,2018-12-31,809,4852,5661
68,68498,2019-12-31,833,4907,5740
68,68498,2020-12-31,853,4957,5810
68,68498,2021-12-31,932,4942,5874
68,68498,2022-12-31,1007,4912,5919
68,68498,2023-12-31,1082,4879,5961
68,68498,2024-12-31,1108,4842,5950
68,68498,2025-12-31,1124,4830,5954
68,68498,2026-12-31,1145,4797,5942
68,68498,2027-12-31,1157,4788,5945
68,68498,2028-12-31,1163,4775,5938
68,68498,2029-12-31,1177,4773,5950
68,68498,2030-12-31,1179,4772,5951
68,68498,2031-12-31,1186,4770,5956
68,68498,2032-12-31,1200,4766,5966
68,68498,2033-12-31,1204,4768,5972
68,68498,2034-12-31,1211,4750,5961
68,68498,2035-12-31,1210,4748,5958
68,68500,1985-12-31,2534,6011,8545
68,68500,1986-12-31,2594,6027,8621
68,68500,1987-12-31,2672,5981,8653
68,68500,1988-12-31,2730,5884,8614
68,68500,1989-12-31,2784,5811,8595
68,68500,1990-12-31,2858,5757,8615
68,68500,1991-12-31,2921,5719,8640
68,68500,1992-12-31,2990,5697,8687
68,68500,1993-12-31,3078,5969,9047
68,68500,1994-12-31,3136,5989,9125
68,68500,1995-12-31,3221,6012,9233
68,68500,1996-12-31,3304,6013,9317
68,68500,1997-12-31,3393,6005,9398
68,68500,1998-12-31,3500,6025,9525
68,68500,1999-12-31,3566,6030,9596
68,68500,2000-12-31,3629,6033,9662
68,68500,2001-12-31,3679,6034,9713
68,68500,2002-12-31,3759,6036,9795
68,68500,2003-12-31,3828,5997,9825
68,68500,2004-12-31,3890,5980,9870
68,68500,2005-12-31,3950,5962,9912
68,68500,2006-12-31,4007,5969,9976
68,68500,2007-12-31,4077,5976,10053
68,68500,2008-12-31,4159,5966,10125
68,68500,2009-12-31,4199,5981,10180
68,68500,2010-12-31,4274,5972,10246
68,68500,2011-12-31,4335,5994,10329
68,68500,2012-12-31,4441,5981,10422
68,68500,2013-12-31,4504,5920,10424
68,68500,2014-12-31,4538,5959,10497
68,68500,2015-12-31,4581,5928,10509
68,68500,2016-12-31,4630,5900,10530
68,68500,2017-12-31,4701,5965,10666
68,68500,2018-12-31,4791,6009,10800
68,68500,2019-12-31,4936,6068,11004
68,68500,2020-12-31,5060,6115,11175
68,68500,2021-12-31,5202,6097,11299
68,68500,2022-12-31,5325,6060,11385
68,68500,2023-12-31,5447,6019,11466
68,68500,2024-12-31,5532,5983,11515
68,68500,2025-12-31,5615,5957,11572
68,68500,2026-12-31,5675,5928,11603
68,68500,2027-12-31,5720,5905,11625
68,68500,2028-12-31,5769,5895,11664
68,68500,2029-12-31,5828,5893,11721
68,68500,2030-12-31,5860,5886,11746
68,68500,2031-12-31,5903,5884,11787
68,68500,2032-12-31,5943,5892,11835
68,68500,2033-12-31,5977,5880,11857
68,68500,2034-12-31,6014,5873,11887
68,68500,2035-12-31,6054,5850,11904
68,68502,1985-12-31,988,7010,7998
68,68502,1986-12-31,1005,6921,7926
68,68502,1987-12-31,1027,6699,7726
68,68502,1988-12-31,1029,6465,7494
68,68502,1989-12-31,1052,6287,7339
68,68502,1990-12-31,1065,6066,7131
68,68502,1991-12-31,1077,5968,7045
68,68502,1992-12-31,1092,5838,6930
68,68502,1993-12-31,1098,5970,7068
68,68502,1994-12-31,1106,5861,6967
68,68502,1995-12-31,1119,5741,6860
68,68502,1996-12-31,1124,5597,6721
68,68502,1997-12-31,1133,5544,6677
68,68502,1998-12-31,1136,5410,6546
68,68502,1999-12-31,1135,5225,6360
68,68502,2000-12-31,1126,5091,6217
68,68502,2001-12-31,1125,4965,6090
68,68502,2002-12-31,1137,4856,5993
68,68502,2003-12-31,1150,4770,5920
68,68502,2004-12-31,1151,4612,5763
68,68502,2005-12-31,1123,4498,5621
68,68502,2006-12-31,1122,4380,5502
68,68502,2007-12-31,1127,4254,5381
68,68502,2008-12-31,1131,4132,5263
68,68502,2009-12-31,1138,3999,5137
68,68502,2010-12-31,1143,3896,5039
68,68502,2011-12-31,1143,3785,4928
68,68502,2012-12-31,1148,3649,4797
68,68502,2013-12-31,1156,3537,4693
68,68502,2014-12-31,1165,3419,4584
68,68502,2015-12-31,1183,3309,4492
68,68502,2016-12-31,1196,3181,4377
68,68502,2017-12-31,1212,3088,4300
68,68502,2018-12-31,1232,2951,4183
68,68502,2019-12-31,1246,2865,4111
68,68502,2020-12-31,1261,2821,4082
68,68502,2021-12-31,1315,2812,4127
68,68502,2022-12-31,1364,2795,4159
68,68502,2023-12-31,1412,2776,4188
68,68502,2024-12-31,1435,2770,4205
68,68502,2025-12-31,1444,2753,4197
68,68502,2026-12-31,1451,2732,4183
68,68502,2027-12-31,1469,2726,4195
68,68502,2028-12-31,1485,2719,4204
68,68502,2029-12-31,1510,2716,4226
68,68502,2030-12-31,1521,2713,4234
68,68502,2031-12-31,1529,2712,4241
68,68502,2032-12-31,1540,2720,4260
68,68502,2033-12-31,1546,2719,4265
68,68502,2034-12-31,1553,2713,4266
68,68502,2035-12-31,1563,2702,4265
68,68522,1985-12-31,292,757,1049
68,68522,1986-12-31,326,753,1079
68,68522,1987-12-31,265,753,1018
68,68522,1988-12-31,369,765,1134
68,68522,1989-12-31,307,766,1073
68,68522,1990-12-31,343,760,1103
68,68522,1991-12-31,348,763,1111
68,68522,1992-12-31,296,773,1069
68,68522,1993-12-31,307,775,1082
68,68522,1994-12-31,374,835,1209
68,68522,1995-12-31,330,816,1146
68,68522,1996-12-31,413,828,1241
68,68522,1997-12-31,415,805,1220
68,68522,1998-12-31,350,814,1164
68,68522,1999-12-31,368,839,1207
68,68522,2000-12-31,384,846,1230
68,68522,2001-12-31,381,819,1200
68,68522,2002-12-31,388,828,1216
68,68522,2003-12-31,393,830,1223
68,68522,2004-12-31,413,827,1240
68,68522,2005-12-31,418,843,1261
68,68522,2006-12-31,409,855,1264
68,68522,2007-12-31,420,841,1261
68,68522,2008-12-31,404,849,1253
68,68522,2009-12-31,393,878,1271
68,68522,2010-12-31,440,867,1307
68,68522,2011-12-31,471,862,1333
68,68522,2012-12-31,469,861,1330
68,68522,2013-12-31,477,857,1334
68,68522,2014-12-31,477,886,1363
68,68522,2015-12-31,460,921,1381
68,68522,2016-12-31,455,906,1361
68,68522,2017-12-31,458,894,1352
68,68522,2018-12-31,467,894,1361
68,68522,2019-12-31,481,905,1386
68,68522,2020-12-31,493,914,1407
68,68522,2021-12-31,512,911,1423
68,68522,2022-12-31,527,906,1433
68,68522,2023-12-31,544,900,1444
68,68522,2024-12-31,560,889,1449
68,68522,2025-12-31,561,883,1444
68,68522,2026-12-31,567,877,1444
68,68522,2027-12-31,573,876,1449
68,68522,2028-12-31,575,877,1452
68,68522,2029-12-31,587,874,1461
68,68522,2030-12-31,585,875,1460
68,68522,2031-12-31,591,874,1465
68,68522,2032-12-31,592,874,1466
68,68522,2033-12-31,595,872,1467
68,68522,2034-12-31,596,875,1471
68,68522,2035-12-31,594,871,1465
68,68524,1985-12-31,348,1626,1974
68,68524,1986-12-31,346,1622,1968
68,68524,1987-12-31,351,1616,1967
68,68524,1988-12-31,372,1619,1991
68,68524,1989-12-31,410,1621,2031
68,68524,1990-12-31,419,1615,2034
68,68524,1991-12-31,448,1626,2074
68,68524,1992-12-31,465,1589,2054
68,68524,1993-12-31,451,1655,2106
68,68524,1994-12-31,468,1637,2105
68,68524,1995-12-31,513,1657,2170
68,68524,1996-12-31,475,1657,2132
68,68524,1997-12-31,534,1658,2192
68,68524,1998-12-31,530,1671,2201
68,68524,1999-12-31,524,1663,2187
68,68524,2000-12-31,526,1660,2186
68,68524,2001-12-31,532,1677,2209
68,68524,2002-12-31,567,1677,2244
68,68524,2003-12-31,587,1680,2267
68,68524,2004-12-31,590,1680,2270
68,68524,2005-12-31,643,1684,2327
68,68524,2006-12-31,653,1712,2365
68,68524,2007-12-31,661,1716,2377
68,68524,2008-12-31,672,1709,2381
68,68524,2009-12-31,681,1704,2385
68,68524,2010-12-31,695,1706,2401
68,68524,2011-12-31,705,1709,2414
68,68524,2012-12-31,719,1768,2487
68,68524,2013-12-31,734,1767,2501
68,68524,2014-12-31,739,1765,2504
68,68524,2015-12-31,749,1755,2504
68,68524,2016-12-31,754,1748,2502
68,68524,2017-12-31,760,1748,2508
68,68524,2018-12-31,779,1756,2535
68,68524,2019-12-31,803,1781,2584
68,68524,2020-12-31,823,1803,2626
68,68524,2021-12-31,857,1798,2655
68,68524,2022-12-31,888,1787,2675
68,68524,2023-12-31,919,1775,2694
68,68524,2024-12-31,933,1756,2689
68,68524,2025-12-31,954,1756,2710
68,68524,2026-12-31,961,1753,2714
68,68524,2027-12-31,964,1739,2703
68,68524,2028-12-31,973,1730,2703
68,68524,2029-12-31,983,1723,2706
68,68524,2030-12-31,991,1729,2720
68,68524,2031-12-31,1000,1726,2726
68,68524,2032-12-31,1004,1726,2730
68,68524,2033-12-31,1016,1727,2743
68,68524,2034-12-31,1024,1718,2742
68,68524,2035-12-31,1024,1719,2743
68,68533,1985-12-31,367,2511,2878
68,68533,1986-12-31,361,2515,2876
68,68533,1987-12-31,401,2480,2881
68,68533,1988-12-31,436,2528,2964
68,68533,1989-12-31,458,2557,3015
68,68533,1990-12-31,519,2581,3100
68,68533,1991-12-31,540,2564,3104
68,68533,1992-12-31,571,2572,3143
68,68533,1993-12-31,588,2704,3292
68,68533,1994-12-31,623,2730,3353
68,68533,1995-12-31,661,2752,3413
68,68533,1996-12-31,708,2763,3471
68,68533,1997-12-31,718,2785,3503
68,68533,1998-12-31,734,2820,3554
68,68533,1999-12-31,740,2852,3592
68,68533,2000-12-31,791,2871,3662
68,68533,2001-12-31,819,2908,3727
68,68533,2002-12-31,842,2923,3765
68,68533,2003-12-31,872,2958,3830
68,68533,2004-12-31,894,2987,3881
68,68533,2005-12-31,920,3023,3943
68,68533,2006-12-31,949,3045,3994
68,68533,2007-12-31,970,3090,4060
68,68533,2008-12-31,995,3067,4062
68,68533,2009-12-31,1020,3134,4154
68,68533,2010-12-31,1051,3191,4242
68,68533,2011-12-31,1070,3242,4312
68,68533,2012-12-31,1105,3271,4376
68,68533,2013-12-31,1162,3294,4456
68,68533,2014-12-31,1178,3314,4492
68,68533,2015-12-31,1184,3332,4516
68,68533,2016-12-31,1208,3351,4559
68,68533,2017-12-31,1230,3366,4596
68,68533,2018-12-31,1251,3403,4654
68,68533,2019-12-31,1306,3467,4773
68,68533,2020-12-31,1354,3515,4869
68,68533,2021-12-31,1419,3505,4924
68,68533,2022-12-31,1478,3483,4961
68,68533,2023-12-31,1537,3460,4997
68,68533,2024-12-31,1573,3438,5011
68,68533,2025-12-31,1615,3418,5033
68,68533,2026-12-31,1637,3411,5048
68,68533,2027-12-31,1659,3399,5058
68,68533,2028-12-31,1681,3391,5072
68,68533,2029-12-31,1683,3387,5070
68,68533,2030-12-31,1705,3375,5080
68,68533,2031-12-31,1714,3382,5096
68,68533,2032-12-31,1725,3381,5106
68,68533,2033-12-31,1728,3381,5109
68,68533,2034-12-31,1741,3380,5121
68,68533,2035-12-31,1750,3361,5111
68,68547,1985-12-31,31983,13946,45929
68,68547,1986-12-31,35047,14493,49540
68,68547,1987-12-31,38188,14922,53110
68,68547,1988-12-31,41352,15303,56655
68,68547,1989-12-31,44548,15643,60191
68,68547,1990-12-31,47775,16034,63809
68,68547,1991-12-31,50986,16416,67402
68,68547,1992-12-31,54265,16779,71044
68,68547,1993-12-31,57576,18215,75791
68,68547,1994-12-31,60907,18769,79676
68,68547,1995-12-31,64281,19303,83584
68,68547,1996-12-31,67675,19857,87532
68,68547,1997-12-31,71086,20408,91494
68,68547,1998-12-31,74480,20942,95422
68,68547,1999-12-31,77830,21487,99317
68,68547,2000-12-31,81190,21990,103180
68,68547,2001-12-31,84509,22498,107007
68,68547,2002-12-31,87787,23005,110792
68,68547,2003-12-31,91032,23481,114513
68,68547,2004-12-31,94294,23967,118261
68,68547,2005-12-31,97528,24476,122004
68,68547,2006-12-31,100825,24959,125784
68,68547,2007-12-31,104073,25458,129531
68,68547,2008-12-31,107288,25957,133245
68,68547,2009-12-31,110481,26448,136929
68,68547,2010-12-31,113659,26948,140607
68,68547,2011-12-31,116731,27440,144171
68,68547,2012-12-31,119753,27923,147676
68,68547,2013-12-31,122771,28408,151179
68,68547,2014-12-31,125724,28901,154625
68,68547,2015-12-31,128713,29422,158135
68,68547,2016-12-31,131892,29955,161847
68,68547,2017-12-31,135210,30607,165817
68,68547,2018-12-31,139273,31352,170625
68,68547,2019-12-31,145443,32143,177586
68,68547,2020-12-31,150483,32476,182959
68,68547,2021-12-31,152641,32379,185020
68,68547,2022-12-31,154254,32181,186435
68,68547,2023-12-31,155796,31967,187763
68,68547,2024-12-31,157545,31788,189333
68,68547,2025-12-31,159253,31619,190872
68,68547,2026-12-31,160865,31496,192361
68,68547,2027-12-31,162396,31401,193797
68,68547,2028-12-31,163834,31329,195163
68,68547,2029-12-31,165176,31284,196460
68,68547,2030-12-31,166396,31285,197681
68,68547,2031-12-31,167513,31303,198816
68,68547,2032-12-31,168594,31280,199874
68,68547,2033-12-31,169595,31264,200859
68,68547,2034-12-31,170551,31213,201764
68,68547,2035-12-31,171429,31156,202585
68,68549,1985-12-31,338,3180,3518
68,68549,1986-12-31,366,3194,3560
68,68549,1987-12-31,385,3185,3570
68,68549,1988-12-31,428,3192,3620
68,68549,1989-12-31,448,3223,3671
68,68549,1990-12-31,452,3211,3663
68,68549,1991-12-31,482,3195,3677
68,68549,1992-12-31,496,3215,3711
68,68549,1993-12-31,546,3380,3926
68,68549,1994-12-31,523,3408,3931
68,68549,1995-12-31,547,3440,3987
68,68549,1996-12-31,598,3487,4085
68,68549,1997-12-31,651,3497,4148
68,68549,1998-12-31,672,3541,4213
68,68549,1999-12-31,662,3540,4202
68,68549,2000-12-31,701,3574,4275
68,68549,2001-12-31,727,3591,4318
68,68549,2002-12-31,747,3613,4360
68,68549,2003-12-31,769,3644,4413
68,68549,2004-12-31,790,3674,4464
68,68549,2005-12-31,789,3705,4494
68,68549,2006-12-31,837,3715,4552
68,68549,2007-12-31,840,3772,4612
68,68549,2008-12-31,864,3793,4657
68,68549,2009-12-31,873,3805,4678
68,68549,2010-12-31,902,3858,4760
68,68549,2011-12-31,937,3882,4819
68,68549,2012-12-31,989,3875,4864
68,68549,2013-12-31,1008,3909,4917
68,68549,2014-12-31,1020,3947,4967
68,68549,2015-12-31,1033,3983,5016
68,68549,2016-12-31,1048,4014,5062
68,68549,2017-12-31,1061,4042,5103
68,68549,2018-12-31,1072,4090,5162
68,68549,2019-12-31,1121,4164,5285
68,68549,2020-12-31,1162,4223,5385
68,68549,2021-12-31,1235,4210,5445
68,68549,2022-12-31,1301,4185,5486
68,68549,2023-12-31,1368,4157,5525
68,68549,2024-12-31,1413,4135,5548
68,68549,2025-12-31,1440,4117,5557
68,68549,2026-12-31,1460,4102,5562
68,68549,2027-12-31,1477,4092,5569
68,68549,2028-12-31,1498,4080,5578
68,68549,2029-12-31,1509,4081,5590
68,68549,2030-12-31,1512,4066,5578
68,68549,2031-12-31,1525,4071,5596
68,68549,2032-12-31,1537,4078,5615
68,68549,2033-12-31,1544,4060,5604
68,68549,2034-12-31,1553,4063,5616
68,68549,2035-12-31,1563,4058,5621
68,68572,1985-12-31,3574,11589,15163
68,68572,1986-12-31,3613,11542,15155
68,68572,1987-12-31,3658,11407,15065
68,68572,1988-12-31,3706,11220,14926
68,68572,1989-12-31,3769,10918,14687
68,68572,1990-12-31,3817,10808,14625
68,68572,1991-12-31,3886,10645,14531
68,68572,1992-12-31,3948,10487,14435
68,68572,1993-12-31,3998,11005,15003
68,68572,1994-12-31,4060,10952,15012
68,68572,1995-12-31,4132,10877,15009
68,68572,1996-12-31,4229,10810,15039
68,68572,1997-12-31,4301,10731,15032
68,68572,1998-12-31,4354,10648,15002
68,68572,1999-12-31,4439,10624,15063
68,68572,2000-12-31,4534,10521,15055
68,68572,2001-12-31,4578,10412,14990
68,68572,2002-12-31,4619,10350,14969
68,68572,2003-12-31,4662,10255,14917
68,68572,2004-12-31,4714,10161,14875
68,68572,2005-12-31,4768,10092,14860
68,68572,2006-12-31,4828,9956,14784
68,68572,2007-12-31,4863,9881,14744
68,68572,2008-12-31,4956,9793,14749
68,68572,2009-12-31,5005,9702,14707
68,68572,2010-12-31,5027,9640,14667
68,68572,2011-12-31,5053,9567,14620
68,68572,2012-12-31,5090,9475,14565
68,68572,2013-12-31,5141,9399,14540
68,68572,2014-12-31,5202,9311,14513
68,68572,2015-12-31,5246,9226,14472
68,68572,2016-12-31,5280,9159,14439
68,68572,2017-12-31,5336,9199,14535
68,68572,2018-12-31,5440,9214,14654
68,68572,2019-12-31,5547,9193,14740
68,68572,2020-12-31,5647,9197,14844
68,68572,2021-12-31,5840,9168,15008
68,68572,2022-12-31,6011,9112,15123
68,68572,2023-12-31,6180,9051,15231
68,68572,2024-12-31,6283,8999,15282
68,68572,2025-12-31,6347,8953,15300
68,68572,2026-12-31,6414,8901,15315
68,68572,2027-12-31,6473,8882,15355
68,68572,2028-12-31,6531,8864,15395
68,68572,2029-12-31,6583,8852,15435
68,68572,2030-12-31,6633,8852,15485
68,68572,2031-12-31,6677,8838,15515
68,68572,2032-12-31,6727,8844,15571
68,68572,2033-12-31,6759,8831,15590
68,68572,2034-12-31,6799,8813,15612
68,68572,2035-12-31,6829,8786,15615
68,68573,1985-12-31,2401,3276,5677
68,68573,1986-12-31,2388,3305,5693
68,68573,1987-12-31,2381,3314,5695
68,68573,1988-12-31,2421,3363,5784
68,68573,1989-12-31,2418,3413,5831
68,68573,1990-12-31,2441,3417,5858
68,68573,1991-12-31,2464,3444,5908
68,68573,1992-12-31,2438,3471,5909
68,68573,1993-12-31,2480,3687,6167
68,68573,1994-12-31,2484,3720,6204
68,68573,1995-12-31,2497,3792,6289
68,68573,1996-12-31,2472,3844,6316
68,68573,1997-12-31,2534,3917,6451
68,68573,1998-12-31,2535,3974,6509
68,68573,1999-12-31,2541,4033,6574
68,68573,2000-12-31,2551,4075,6626
68,68573,2001-12-31,2544,4123,6667
68,68573,2002-12-31,2537,4174,6711
68,68573,2003-12-31,2580,4196,6776
68,68573,2004-12-31,2576,4253,6829
68,68573,2005-12-31,2572,4305,6877
68,68573,2006-12-31,2587,4365,6952
68,68573,2007-12-31,2590,4421,7011
68,68573,2008-12-31,2600,4456,7056
68,68573,2009-12-31,2575,4574,7149
68,68573,2010-12-31,2550,4574,7124
68,68573,2011-12-31,2566,4644,7210
68,68573,2012-12-31,2571,4702,7273
68,68573,2013-12-31,2582,4733,7315
68,68573,2014-12-31,2588,4768,7356
68,68573,2015-12-31,2585,4847,7432
68,68573,2016-12-31,2580,4913,7493
68,68573,2017-12-31,2565,4959,7524
68,68573,2018-12-31,2605,5035,7640
68,68573,2019-12-31,2703,5143,7846
68,68573,2020-12-31,2791,5226,8017
68,68573,2021-12-31,2897,5210,8107
68,68573,2022-12-31,2990,5179,8169
68,68573,2023-12-31,3084,5144,8228
68,68573,2024-12-31,3153,5117,8270
68,68573,2025-12-31,3207,5093,8300
68,68573,2026-12-31,3259,5070,8329
68,68573,2027-12-31,3291,5062,8353
68,68573,2028-12-31,3328,5043,8371
68,68573,2029-12-31,3350,5039,8389
68,68573,2030-12-31,3379,5043,8422
68,68573,2031-12-31,3405,5040,8445
68,68573,2032-12-31,3427,5026,8453
68,68573,2033-12-31,3439,5034,8473
68,68573,2034-12-31,3460,5031,8491
68,68573,2035-12-31,3484,5022,8506
68,68575,1985-12-31,7790,13240,21030
68,68575,1986-12-31,8021,13355,21376
68,68575,1987-12-31,8275,13350,21625
68,68575,1988-12-31,8543,13336,21879
68,68575,1989-12-31,8770,13274,22044
68,68575,1990-12-31,9025,13275,22300
68,68575,1991-12-31,9276,13256,22532
68,68575,1992-12-31,9547,13245,22792
68,68575,1993-12-31,9812,14053,23865
68,68575,1994-12-31,10076,14162,24238
68,68575,1995-12-31,10370,14266,24636
68,68575,1996-12-31,10619,14376,24995
68,68575,1997-12-31,10888,14503,25391
68,68575,1998-12-31,11209,14606,25815
68,68575,1999-12-31,11488,14714,26202
68,68575,2000-12-31,11749,14810,26559
68,68575,2001-12-31,12014,14903,26917
68,68575,2002-12-31,12273,14971,27244
68,68575,2003-12-31,12516,15070,27586
68,68575,2004-12-31,12764,15175,27939
68,68575,2005-12-31,13018,15262,28280
68,68575,2006-12-31,13266,15353,28619
68,68575,2007-12-31,13518,15423,28941
68,68575,2008-12-31,13742,15480,29222
68,68575,2009-12-31,13985,15564,29549
68,68575,2010-12-31,14225,15639,29864
68,68575,2011-12-31,14465,15725,30190
68,68575,2012-12-31,14713,15814,30527
68,68575,2013-12-31,14886,15908,30794
68,68575,2014-12-31,15085,15997,31082
68,68575,2015-12-31,15322,16117,31439
68,68575,2016-12-31,15547,16215,31762
68,68575,2017-12-31,15778,16387,32165
68,68575,2018-12-31,16175,16616,32791
68,68575,2019-12-31,16663,16909,33572
68,68575,2020-12-31,17082,17124,34206
68,68575,2021-12-31,17512,17073,34585
68,68575,2022-12-31,17880,16969,34849
68,68575,2023-12-31,18241,16856,35097
68,68575,2024-12-31,18512,16761,35273
68,68575,2025-12-31,18730,16687,35417
68,68575,2026-12-31,18932,16628,35560
68,68575,2027-12-31,19117,16585,35702
68,68575,2028-12-31,19287,16548,35835
68,68575,2029-12-31,19430,16536,35966
68,68575,2030-12-31,19571,16527,36098
68,68575,2031-12-31,19712,16518,36230
68,68575,2032-12-31,19838,16525,36363
68,68575,2033-12-31,19960,16524,36484
68,68575,2034-12-31,20054,16506,36560
68,68575,2035-12-31,20172,16460,36632
68,68615,1985-12-31,3873,24239,28112
68,68615,1986-12-31,3935,24146,28081
68,68615,1987-12-31,3998,23802,27800
68,68615,1988-12-31,4102,23492,27594
68,68615,1989-12-31,4145,23067,27212
68,68615,1990-12-31,4222,22770,26992
68,68615,1991-12-31,4310,22454,26764
68,68615,1992-12-31,4421,22154,26575
68,68615,1993-12-31,4481,23207,27688
68,68615,1994-12-31,4565,23088,27653
68,68615,1995-12-31,4638,22977,27615
68,68615,1996-12-31,4752,22874,27626
68,68615,1997-12-31,4849,22764,27613
68,68615,1998-12-31,4928,22632,27560
68,68615,1999-12-31,5020,22520,27540
68,68615,2000-12-31,5091,22383,27474
68,68615,2001-12-31,5157,22227,27384
68,68615,2002-12-31,5227,22077,27304
68,68615,2003-12-31,5296,21898,27194
68,68615,2004-12-31,5366,21736,27102
68,68615,2005-12-31,5456,21620,27076
68,68615,2006-12-31,5514,21441,26955
68,68615,2007-12-31,5582,21321,26903
68,68615,2008-12-31,5658,21197,26855
68,68615,2009-12-31,5730,21026,26756
68,68615,2010-12-31,5818,20848,26666
68,68615,2011-12-31,5869,20725,26594
68,68615,2012-12-31,5907,20580,26487
68,68615,2013-12-31,5961,20438,26399
68,68615,2014-12-31,5988,20290,26278
68,68615,2015-12-31,6039,20182,26221
68,68615,2016-12-31,6125,20104,26229
68,68615,2017-12-31,6181,20031,26212
68,68615,2018-12-31,6338,20100,26438
68,68615,2019-12-31,6486,20260,26746
68,68615,2020-12-31,6622,20440,27062
68,68615,2021-12-31,6982,20379,27361
68,68615,2022-12-31,7317,20254,27571
68,68615,2023-12-31,7647,20120,27767
68,68615,2024-12-31,7804,20009,27813
68,68615,2025-12-31,7912,19918,27830
68,68615,2026-12-31,8000,19818,27818
68,68615,2027-12-31,8075,19748,27823
68,68615,2028-12-31,8148,19719,27867
68,68615,2029-12-31,8212,19678,27890
68,68615,2030-12-31,8277,19680,27957
68,68615,2031-12-31,8331,19700,28031
68,68615,2032-12-31,8389,19679,28068
68,68615,2033-12-31,8435,19661,28096
68,68615,2034-12-31,8485,19635,28120
68,68615,2035-12-31,8526,19598,28124
68,68655,1985-12-31,10594,8890,19484
68,68655,1986-12-31,10908,8947,19855
68,68655,1987-12-31,11264,8903,20167
68,68655,1988-12-31,11625,8867,20492
68,68655,1989-12-31,11973,8823,20796
68,68655,1990-12-31,12331,8797,21128
68,68655,1991-12-31,12709,8785,21494
68,68655,1992-12-31,13078,8761,21839
68,68655,1993-12-31,13481,9286,22767
68,68655,1994-12-31,13855,9343,23198
68,68655,1995-12-31,14258,9404,23662
68,68655,1996-12-31,14629,9454,24083
68,68655,1997-12-31,15014,9503,24517
68,68655,1998-12-31,15394,9556,24950
68,68655,1999-12-31,15782,9601,25383
68,68655,2000-12-31,16200,9648,25848
68,68655,2001-12-31,16560,9696,26256
68,68655,2002-12-31,16938,9749,26687
68,68655,2003-12-31,17310,9796,27106
68,68655,2004-12-31,17672,9852,27524
68,68655,2005-12-31,18021,9873,27894
68,68655,2006-12-31,18379,9918,28297
68,68655,2007-12-31,18745,9962,28707
68,68655,2008-12-31,19075,10001,29076
68,68655,2009-12-31,19425,10005,29430
68,68655,2010-12-31,19751,10042,29793
68,68655,2011-12-31,20075,10080,30155
68,68655,2012-12-31,20387,10123,30510
68,68655,2013-12-31,20655,10149,30804
68,68655,2014-12-31,20992,10168,31160
68,68655,2015-12-31,21278,10228,31506
68,68655,2016-12-31,21614,10299,31913
68,68655,2017-12-31,22019,10374,32393
68,68655,2018-12-31,22512,10543,33055
68,68655,2019-12-31,23192,10695,33887
68,68655,2020-12-31,23775,10781,34556
68,68655,2021-12-31,24196,10749,34945
68,68655,2022-12-31,24529,10683,35212
68,68655,2023-12-31,24851,10612,35463
68,68655,2024-12-31,25160,10550,35710
68,68655,2025-12-31,25437,10504,35941
68,68655,2026-12-31,25709,10465,36174
68,68655,2027-12-31,25956,10438,36394
68,68655,2028-12-31,26187,10401,36588
68,68655,2029-12-31,26398,10404,36802
68,68655,2030-12-31,26604,10393,36997
68,68655,2031-12-31,26769,10404,37173
68,68655,2032-12-31,26954,10405,37359
68,68655,2033-12-31,27112,10397,37509
68,68655,2034-12-31,27265,10383,37648
68,68655,2035-12-31,27394,10361,37755
68,68669,1985-12-31,2520,10416,12936
68,68669,1986-12-31,2538,10305,12843
68,68669,1987-12-31,2540,10074,12614
68,68669,1988-12-31,2548,9794,12342
68,68669,1989-12-31,2567,9520,12087
68,68669,1990-12-31,2594,9305,11899
68,68669,1991-12-31,2623,9094,11717
68,68669,1992-12-31,2660,8886,11546
68,68669,1993-12-31,2697,9238,11935
68,68669,1994-12-31,2709,9045,11754
68,68669,1995-12-31,2740,8939,11679
68,68669,1996-12-31,2761,8800,11561
68,68669,1997-12-31,2788,8629,11417
68,68669,1998-12-31,2822,8497,11319
68,68669,1999-12-31,2832,8344,11176
68,68669,2000-12-31,2852,8187,11039
68,68669,2001-12-31,2864,8051,10915
68,68669,2002-12-31,2875,7901,10776
68,68669,2003-12-31,2892,7766,10658
68,68669,2004-12-31,2908,7567,10475
68,68669,2005-12-31,2930,7410,10340
68,68669,2006-12-31,2935,7258,10193
68,68669,2007-12-31,2967,7107,10074
68,68669,2008-12-31,2996,6958,9954
68,68669,2009-12-31,2996,6815,9811
68,68669,2010-12-31,2999,6664,9663
68,68669,2011-12-31,3006,6502,9508
68,68669,2012-12-31,3019,6342,9361
68,68669,2013-12-31,3035,6188,9223
68,68669,2014-12-31,3064,6036,9100
68,68669,2015-12-31,3084,5905,8989
68,68669,2016-12-31,3101,5784,8885
68,68669,2017-12-31,3056,5701,8757
68,68669,2018-12-31,3121,5562,8683
68,68669,2019-12-31,3149,5464,8613
68,68669,2020-12-31,3183,5413,8596
68,68669,2021-12-31,3295,5396,8691
68,68669,2022-12-31,3395,5363,8758
68,68669,2023-12-31,3493,5327,8820
68,68669,2024-12-31,3539,5296,8835
68,68669,2025-12-31,3581,5273,8854
68,68669,2026-12-31,3613,5248,8861
68,68669,2027-12-31,3649,5243,8892
68,68669,2028-12-31,3682,5218,8900
68,68669,2029-12-31,3709,5217,8926
68,68669,2030-12-31,3742,5207,8949
68,68669,2031-12-31,3764,5209,8973
68,68669,2032-12-31,3785,5203,8988
68,68669,2033-12-31,3814,5200,9014
68,68669,2034-12-31,3828,5193,9021
68,68669,2035-12-31,3857,5190,9047
68,68673,1985-12-31,148,3489,3637
68,68673,1986-12-31,196,3470,3666
68,68673,1987-12-31,163,3399,3562
68,68673,1988-12-31,150,3361,3511
68,68673,1989-12-31,208,3339,3547
68,68673,1990-12-31,206,3268,3474
68,68673,1991-12-31,215,3227,3442
68,68673,1992-12-31,217,3183,3400
68,68673,1993-12-31,224,3279,3503
68,68673,1994-12-31,177,3258,3435
68,68673,1995-12-31,186,3239,3425
68,68673,1996-12-31,198,3215,3413
68,68673,1997-12-31,236,3191,3427
68,68673,1998-12-31,232,3145,3377
68,68673,1999-12-31,223,3120,3343
68,68673,2000-12-31,248,3087,3335
68,68673,2001-12-31,240,3062,3302
68,68673,2002-12-31,250,3033,3283
68,68673,2003-12-31,255,3010,3265
68,68673,2004-12-31,256,2982,3238
68,68673,2005-12-31,252,2962,3214
68,68673,2006-12-31,248,2949,3197
68,68673,2007-12-31,253,2918,3171
68,68673,2008-12-31,248,2891,3139
68,68673,2009-12-31,242,2884,3126
68,68673,2010-12-31,269,2854,3123
68,68673,2011-12-31,255,2834,3089
68,68673,2012-12-31,287,2848,3135
68,68673,2013-12-31,286,2785,3071
68,68673,2014-12-31,282,2747,3029
68,68673,2015-12-31,268,2713,2981
68,68673,2016-12-31,259,2685,2944
68,68673,2017-12-31,257,2672,2929
68,68673,2018-12-31,277,2673,2950
68,68673,2019-12-31,285,2672,2957
68,68673,2020-12-31,293,2679,2972
68,68673,2021-12-31,334,2671,3005
68,68673,2022-12-31,374,2654,3028
68,68673,2023-12-31,413,2636,3049
68,68673,2024-12-31,418,2610,3028
68,68673,2025-12-31,427,2608,3035
68,68673,2026-12-31,428,2596,3024
68,68673,2027-12-31,438,2583,3021
68,68673,2028-12-31,436,2585,3021
68,68673,2029-12-31,448,2575,3023
68,68673,2030-12-31,450,2574,3024
68,68673,2031-12-31,456,2576,3032
68,68673,2032-12-31,461,2571,3032
68,68673,2033-12-31,467,2585,3052
68,68673,2034-12-31,467,2575,3042
68,68673,2035-12-31,469,2559,3028
68,68679,1985-12-31,22394,7630,30024
68,68679,1986-12-31,23100,7624,30724
68,68679,1987-12-31,23890,7551,31441
68,68679,1988-12-31,24694,7430,32124
68,68679,1989-12-31,25496,7334,32830
68,68679,1990-12-31,26298,7245,33543
68,68679,1991-12-31,27131,7177,34308
68,68679,1992-12-31,27974,7108,35082
68,68679,1993-12-31,28819,7452,36271
68,68679,1994-12-31,29667,7431,37098
68,68679,1995-12-31,30540,7430,37970
68,68679,1996-12-31,31415,7409,38824
68,68679,1997-12-31,32291,7397,39688
68,68679,1998-12-31,33169,7367,40536
68,68679,1999-12-31,34025,7354,41379
68,68679,2000-12-31,34831,7340,42171
68,68679,2001-12-31,35675,7308,42983
68,68679,2002-12-31,36495,7292,43787
68,68679,2003-12-31,37308,7277,44585
68,68679,2004-12-31,38116,7249,45365
68,68679,2005-12-31,38898,7187,46085
68,68679,2006-12-31,39710,7165,46875
68,68679,2007-12-31,40514,7143,47657
68,68679,2008-12-31,41305,7123,48428
68,68679,2009-12-31,42081,7103,49184
68,68679,2010-12-31,42849,7055,49904
68,68679,2011-12-31,43568,7018,50586
68,68679,2012-12-31,44223,6988,51211
68,68679,2013-12-31,44982,6953,51935
68,68679,2014-12-31,45644,6930,52574
68,68679,2015-12-31,46329,6890,53219
68,68679,2016-12-31,47108,6901,54009
68,68679,2017-12-31,47971,6897,54868
68,68679,2018-12-31,49050,6987,56037
68,68679,2019-12-31,50576,7456,58032
68,68679,2020-12-31,51874,7796,59670
68,68679,2021-12-31,52569,7773,60342
68,68679,2022-12-31,53079,7725,60804
68,68679,2023-12-31,53563,7674,61237
68,68679,2024-12-31,54127,7616,61743
68,68679,2025-12-31,54716,7594,62310
68,68679,2026-12-31,55269,7554,62823
68,68679,2027-12-31,55805,7529,63334
68,68679,2028-12-31,56283,7512,63795
68,68679,2029-12-31,56750,7502,64252
68,68679,2030-12-31,57159,7513,64672
68,68679,2031-12-31,57555,7499,65054
68,68679,2032-12-31,57905,7506,65411
68,68679,2033-12-31,58272,7493,65765
68,68679,2034-12-31,58599,7487,66086
68,68679,2035-12-31,58887,7473,66360
68,68682,1985-12-31,636,3197,3833
68,68682,1986-12-31,643,3136,3779
68,68682,1987-12-31,646,3055,3701
68,68682,1988-12-31,640,3002,3642
68,68682,1989-12-31,661,2949,3610
68,68682,1990-12-31,700,2872,3572
68,68682,1991-12-31,670,2771,3441
68,68682,1992-12-31,682,2684,3366
68,68682,1993-12-31,692,2758,3450
68,68682,1994-12-31,696,2706,3402
68,68682,1995-12-31,698,2627,3325
68,68682,1996-12-31,699,2569,3268
68,68682,1997-12-31,699,2511,3210
68,68682,1998-12-31,719,2469,3188
68,68682,1999-12-31,726,2443,3169
68,68682,2000-12-31,727,2353,3080
68,68682,2001-12-31,731,2324,3055
68,68682,2002-12-31,747,2277,3024
68,68682,2003-12-31,750,2228,2978
68,68682,2004-12-31,741,2135,2876
68,68682,2005-12-31,738,2107,2845
68,68682,2006-12-31,742,2056,2798
68,68682,2007-12-31,727,1999,2726
68,68682,2008-12-31,729,1908,2637
68,68682,2009-12-31,742,1883,2625
68,68682,2010-12-31,739,1847,2586
68,68682,2011-12-31,753,1783,2536
68,68682,2012-12-31,749,1741,2490
68,68682,2013-12-31,763,1697,2460
68,68682,2014-12-31,775,1634,2409
68,68682,2015-12-31,783,1597,2380
68,68682,2016-12-31,789,1492,2281
68,68682,2017-12-31,795,1428,2223
68,68682,2018-12-31,819,1422,2241
68,68682,2019-12-31,828,1387,2215
68,68682,2020-12-31,838,1370,2208
68,68682,2021-12-31,866,1366,2232
68,68682,2022-12-31,892,1357,2249
68,68682,2023-12-31,918,1348,2266
68,68682,2024-12-31,921,1324,2245
68,68682,2025-12-31,930,1325,2255
68,68682,2026-12-31,947,1322,2269
68,68682,2027-12-31,965,1319,2284
68,68682,2028-12-31,966,1325,2291
68,68682,2029-12-31,965,1318,2283
68,68682,2030-12-31,985,1315,2300
68,68682,2031-12-31,984,1319,2303
68,68682,2032-12-31,991,1317,2308
68,68682,2033-12-31,995,1320,2315
68,68682,2034-12-31,1002,1315,2317
68,68682,2035-12-31,1005,1310,2315
68,68684,1985-12-31,750,6286,7036
68,68684,1986-12-31,739,6209,6948
68,68684,1987-12-31,751,6027,6778
68,68684,1988-12-31,751,5896,6647
68,68684,1989-12-31,763,5764,6527
68,68684,1990-12-31,763,5603,6366
68,68684,1991-12-31,776,5468,6244
68,68684,1992-12-31,775,5371,6146
68,68684,1993-12-31,779,5557,6336
68,68684,1994-12-31,791,5472,6263
68,68684,1995-12-31,772,5382,6154
68,68684,1996-12-31,786,5311,6097
68,68684,1997-12-31,777,5252,6029
68,68684,1998-12-31,785,5159,5944
68,68684,1999-12-31,798,5073,5871
68,68684,2000-12-31,802,4985,5787
68,68684,2001-12-31,822,4898,5720
68,68684,2002-12-31,827,4804,5631
68,68684,2003-12-31,837,4700,5537
68,68684,2004-12-31,850,4592,5442
68,68684,2005-12-31,870,4531,5401
68,68684,2006-12-31,879,4440,5319
68,68684,2007-12-31,862,4370,5232
68,68684,2008-12-31,853,4285,5138
68,68684,2009-12-31,844,4214,5058
68,68684,2010-12-31,839,4118,4957
68,68684,2011-12-31,851,4032,4883
68,68684,2012-12-31,845,3953,4798
68,68684,2013-12-31,841,3882,4723
68,68684,2014-12-31,854,3805,4659
68,68684,2015-12-31,855,3716,4571
68,68684,2016-12-31,864,3628,4492
68,68684,2017-12-31,868,3580,4448
68,68684,2018-12-31,889,3478,4367
68,68684,2019-12-31,895,3418,4313
68,68684,2020-12-31,903,3386,4289
68,68684,2021-12-31,961,3375,4336
68,68684,2022-12-31,1015,3355,4370
68,68684,2023-12-31,1069,3332,4401
68,68684,2024-12-31,1092,3312,4404
68,68684,2025-12-31,1103,3290,4393
68,68684,2026-12-31,1113,3282,4395
68,68684,2027-12-31,1123,3268,4391
68,68684,2028-12-31,1133,3266,4399
68,68684,2029-12-31,1147,3266,4413
68,68684,2030-12-31,1159,3259,4418
68,68684,2031-12-31,1173,3255,4428
68,68684,2032-12-31,1171,3248,4419
68,68684,2033-12-31,1165,3250,4415
68,68684,2034-12-31,1184,3247,4431
68,68684,2035-12-31,1197,3237,4434
68,68686,1985-12-31,426,3894,4320
68,68686,1986-12-31,428,3769,4197
68,68686,1987-12-31,464,3707,4171
68,68686,1988-12-31,469,3623,4092
68,68686,1989-12-31,447,3576,4023
68,68686,1990-12-31,449,3462,3911
68,68686,1991-12-31,447,3375,3822
68,68686,1992-12-31,446,3256,3702
68,68686,1993-12-31,471,3355,3826
68,68686,1994-12-31,476,3312,3788
68,68686,1995-12-31,479,3257,3736
68,68686,1996-12-31,474,3214,3688
68,68686,1997-12-31,496,3149,3645
68,68686,1998-12-31,565,3066,3631
68,68686,1999-12-31,541,2995,3536
68,68686,2000-12-31,513,2933,3446
68,68686,2001-12-31,522,2877,3399
68,68686,2002-12-31,513,2821,3334
68,68686,2003-12-31,522,2765,3287
68,68686,2004-12-31,529,2712,3241
68,68686,2005-12-31,525,2648,3173
68,68686,2006-12-31,540,2595,3135
68,68686,2007-12-31,562,2536,3098
68,68686,2008-12-31,564,2487,3051
68,68686,2009-12-31,598,2411,3009
68,68686,2010-12-31,539,2357,2896
68,68686,2011-12-31,559,2314,2873
68,68686,2012-12-31,551,2230,2781
68,68686,2013-12-31,558,2178,2736
68,68686,2014-12-31,570,2135,2705
68,68686,2015-12-31,589,2070,2659
68,68686,2016-12-31,603,2043,2646
68,68686,2017-12-31,614,1912,2526
68,68686,2018-12-31,629,1902,2531
68,68686,2019-12-31,645,1849,2494
68,68686,2020-12-31,658,1820,2478
68,68686,2021-12-31,691,1814,2505
68,68686,2022-12-31,722,1803,2525
68,68686,2023-12-31,752,1791,2543
68,68686,2024-12-31,765,1779,2544
68,68686,2025-12-31,771,1767,2538
68,68686,2026-12-31,773,1759,2532
68,68686,2027-12-31,785,1758,2543
68,68686,2028-12-31,798,1757,2555
68,68686,2029-12-31,804,1748,2552
68,68686,2030-12-31,807,1751,2558
68,68686,2031-12-31,812,1754,2566
68,68686,2032-12-31,817,1749,2566
68,68686,2033-12-31,820,1744,2564
68,68686,2034-12-31,831,1747,2578
68,68686,2035-12-31,828,1748,2576
68,68689,1985-12-31,9520,45803,55323
68,68689,1986-12-31,9573,29033,38606
68,68689,1987-12-31,9657,28504,38161
68,68689,1988-12-31,9742,28019,37761
68,68689,1989-12-31,9831,27388,37219
68,68689,1990-12-31,9920,26925,36845
68,68689,1991-12-31,10016,26448,36464
68,68689,1992-12-31,10116,25982,36098
68,68689,1993-12-31,10213,27111,37324
68,68689,1994-12-31,10323,26872,37195
68,68689,1995-12-31,10423,26639,37062
68,68689,1996-12-31,10514,26406,36920
68,68689,1997-12-31,10612,26167,36779
68,68689,1998-12-31,10735,25925,36660
68,68689,1999-12-31,10853,25679,36532
68,68689,2000-12-31,10963,25411,36374
68,68689,2001-12-31,11069,25109,36178
68,68689,2002-12-31,11119,24826,35945
68,68689,2003-12-31,11199,24527,35726
68,68689,2004-12-31,11276,24240,35516
68,68689,2005-12-31,11358,23991,35349
68,68689,2006-12-31,11435,23702,35137
68,68689,2007-12-31,11512,23435,34947
68,68689,2008-12-31,11578,23163,34741
68,68689,2009-12-31,11642,22884,34526
68,68689,2010-12-31,11696,22602,34298
68,68689,2011-12-31,11782,22343,34125
68,68689,2012-12-31,11852,22079,33931
68,68689,2013-12-31,11897,21819,33716
68,68689,2014-12-31,11901,21550,33451
68,68689,2015-12-31,11945,21303,33248
68,68689,2016-12-31,12016,21088,33104
68,68689,2017-12-31,12094,20917,33011
68,68689,2018-12-31,12288,20845,33133
68,68689,2019-12-31,12485,20929,33414
68,68689,2020-12-31,12681,20912,33593
68,68689,2021-12-31,13119,20846,33965
68,68689,2022-12-31,13506,20718,34224
68,68689,2023-12-31,13888,20580,34468
68,68689,2024-12-31,14096,20459,34555
68,68689,2025-12-31,14260,20352,34612
68,68689,2026-12-31,14403,20278,34681
68,68689,2027-12-31,14544,20205,34749
68,68689,2028-12-31,14665,20161,34826
68,68689,2029-12-31,14786,20137,34923
68,68689,2030-12-31,14900,20129,35029
68,68689,2031-12-31,14997,20149,35146
68,68689,2032-12-31,15100,20135,35235
68,68689,2033-12-31,15172,20099,35271
68,68689,2034-12-31,15254,20078,35332
68,68689,2035-12-31,15357,20034,35391
68,68705,1985-12-31,141,2171,2312
68,68705,1986-12-31,143,2156,2299
68,68705,1987-12-31,220,2100,2320
68,68705,1988-12-31,207,2104,2311
68,68705,1989-12-31,234,2091,2325
68,68705,1990-12-31,155,2083,2238
68,68705,1991-12-31,216,2046,2262
68,68705,1992-12-31,216,2028,2244
68,68705,1993-12-31,220,2120,2340
68,68705,1994-12-31,228,2144,2372
68,68705,1995-12-31,168,2138,2306
68,68705,1996-12-31,189,2149,2338
68,68705,1997-12-31,205,2138,2343
68,68705,1998-12-31,237,2131,2368
68,68705,1999-12-31,252,2135,2387
68,68705,2000-12-31,216,2135,2351
68,68705,2001-12-31,224,2119,2343
68,68705,2002-12-31,231,2097,2328
68,68705,2003-12-31,238,2094,2332
68,68705,2004-12-31,239,2092,2331
68,68705,2005-12-31,240,2101,2341
68,68705,2006-12-31,241,2104,2345
68,68705,2007-12-31,241,2110,2351
68,68705,2008-12-31,281,2125,2406
68,68705,2009-12-31,272,2123,2395
68,68705,2010-12-31,262,2122,2384
68,68705,2011-12-31,284,2119,2403
68,68705,2012-12-31,270,2123,2393
68,68705,2013-12-31,265,2120,2385
68,68705,2014-12-31,249,2123,2372
68,68705,2015-12-31,241,2118,2359
68,68705,2016-12-31,244,2122,2366
68,68705,2017-12-31,239,2118,2357
68,68705,2018-12-31,265,2136,2401
68,68705,2019-12-31,273,2152,2425
68,68705,2020-12-31,280,2168,2448
68,68705,2021-12-31,313,2162,2475
68,68705,2022-12-31,346,2148,2494
68,68705,2023-12-31,378,2134,2512
68,68705,2024-12-31,383,2116,2499
68,68705,2025-12-31,389,2107,2496
68,68705,2026-12-31,387,2095,2482
68,68705,2027-12-31,392,2090,2482
68,68705,2028-12-31,399,2077,2476
68,68705,2029-12-31,403,2083,2486
68,68705,2030-12-31,407,2081,2488
68,68705,2031-12-31,410,2078,2488
68,68705,2032-12-31,412,2073,2485
68,68705,2033-12-31,411,2078,2489
68,68705,2034-12-31,411,2072,2483
68,68705,2035-12-31,423,2059,2482
68,68720,1985-12-31,352,4459,4811
68,68720,1986-12-31,346,4399,4745
68,68720,1987-12-31,401,4310,4711
68,68720,1988-12-31,403,4217,4620
68,68720,1989-12-31,388,4148,4536
68,68720,1990-12-31,394,4040,4434
68,68720,1991-12-31,397,3968,4365
68,68720,1992-12-31,409,3884,4293
68,68720,1993-12-31,423,3994,4417
68,68720,1994-12-31,456,3941,4397
68,68720,1995-12-31,461,3900,4361
68,68720,1996-12-31,487,3842,4329
68,68720,1997-12-31,519,3792,4311
68,68720,1998-12-31,508,3732,4240
68,68720,1999-12-31,537,3686,4223
68,68720,2000-12-31,512,3622,4134
68,68720,2001-12-31,527,3541,4068
68,68720,2002-12-31,589,3482,4071
68,68720,2003-12-31,592,3424,4016
68,68720,2004-12-31,580,3365,3945
68,68720,2005-12-31,576,3306,3882
68,68720,2006-12-31,586,3258,3844
68,68720,2007-12-31,604,3214,3818
68,68720,2008-12-31,629,3172,3801
68,68720,2009-12-31,655,3104,3759
68,68720,2010-12-31,669,3080,3749
68,68720,2011-12-31,673,2975,3648
68,68720,2012-12-31,691,2917,3608
68,68720,2013-12-31,699,2881,3580
68,68720,2014-12-31,709,2829,3538
68,68720,2015-12-31,720,2794,3514
68,68720,2016-12-31,728,2723,3451
68,68720,2017-12-31,740,2640,3380
68,68720,2018-12-31,768,2621,3389
68,68720,2019-12-31,791,2602,3393
68,68720,2020-12-31,811,2600,3411
68,68720,2021-12-31,857,2592,3449
68,68720,2022-12-31,899,2576,3475
68,68720,2023-12-31,941,2559,3500
68,68720,2024-12-31,959,2539,3498
68,68720,2025-12-31,972,2533,3505
68,68720,2026-12-31,983,2518,3501
68,68720,2027-12-31,1002,2517,3519
68,68720,2028-12-31,1011,2502,3513
68,68720,2029-12-31,1013,2501,3514
68,68720,2030-12-31,1021,2500,3521
68,68720,2031-12-31,1020,2496,3516
68,68720,2032-12-31,1030,2492,3522
68,68720,2033-12-31,1032,2496,3528
68,68720,2034-12-31,1027,2494,3521
68,68720,2035-12-31,1037,2484,3521
68,68745,1985-12-31,1386,8579,9965
68,68745,1986-12-31,1420,8571,9991
68,68745,1987-12-31,1472,8466,9938
68,68745,1988-12-31,1480,8350,9830
68,68745,1989-12-31,1501,8237,9738
68,68745,1990-12-31,1531,8159,9690
68,68745,1991-12-31,1544,8076,9620
68,68745,1992-12-31,1566,7986,9552
68,68745,1993-12-31,1595,8387,9982
68,68745,1994-12-31,1643,8376,10019
68,68745,1995-12-31,1681,8352,10033
68,68745,1996-12-31,1702,8341,10043
68,68745,1997-12-31,1692,8319,10011
68,68745,1998-12-31,1702,8307,10009
68,68745,1999-12-31,1753,8272,10025
68,68745,2000-12-31,1828,8254,10082
68,68745,2001-12-31,1832,8238,10070
68,68745,2002-12-31,1860,8210,10070
68,68745,2003-12-31,1870,8187,10057
68,68745,2004-12-31,1878,8171,10049
68,68745,2005-12-31,1886,8121,10007
68,68745,2006-12-31,1916,8073,9989
68,68745,2007-12-31,1943,8050,9993
68,68745,2008-12-31,1990,8035,10025
68,68745,2009-12-31,2011,7990,10001
68,68745,2010-12-31,2044,7971,10015
68,68745,2011-12-31,2049,7916,9965
68,68745,2012-12-31,2063,7881,9944
68,68745,2013-12-31,2071,7824,9895
68,68745,2014-12-31,2093,7789,9882
68,68745,2015-12-31,2106,7766,9872
68,68745,2016-12-31,2119,7765,9884
68,68745,2017-12-31,2147,7795,9942
68,68745,2018-12-31,2185,7857,10042
68,68745,2019-12-31,2250,7888,10138
68,68745,2020-12-31,2305,7921,10226
68,68745,2021-12-31,2445,7894,10339
68,68745,2022-12-31,2573,7845,10418
68,68745,2023-12-31,2699,7793,10492
68,68745,2024-12-31,2763,7749,10512
68,68745,2025-12-31,2792,7709,10501
68,68745,2026-12-31,2832,7669,10501
68,68745,2027-12-31,2855,7652,10507
68,68745,2028-12-31,2885,7631,10516
68,68745,2029-12-31,2901,7615,10516
68,68745,2030-12-31,2928,7628,10556
68,68745,2031-12-31,2952,7620,10572
68,68745,2032-12-31,2974,7616,10590
68,68745,2033-12-31,2990,7609,10599
68,68745,2034-12-31,3004,7604,10608
68,68745,2035-12-31,3016,7603,10619
68,68755,1985-12-31,15357,5459,20816
68,68755,1986-12-31,15629,5475,21104
68,68755,1987-12-31,15949,5459,21408
68,68755,1988-12-31,16282,5392,21674
68,68755,1989-12-31,16611,5364,21975
68,68755,1990-12-31,16938,5327,22265
68,68755,1991-12-31,17281,5301,22582
68,68755,1992-12-31,17647,5256,22903
68,68755,1993-12-31,17994,5552,23546
68,68755,1994-12-31,18347,5576,23923
68,68755,1995-12-31,18712,5599,24311
68,68755,1996-12-31,19112,5620,24732
68,68755,1997-12-31,19486,5634,25120
68,68755,1998-12-31,19820,5661,25481
68,68755,1999-12-31,20157,5674,25831
68,68755,2000-12-31,20508,5700,26208
68,68755,2001-12-31,20848,5711,26559
68,68755,2002-12-31,21205,5713,26918
68,68755,2003-12-31,21544,5703,27247
68,68755,2004-12-31,21879,5703,27582
68,68755,2005-12-31,22201,5700,27901
68,68755,2006-12-31,22528,5722,28250
68,68755,2007-12-31,22853,5734,28587
68,68755,2008-12-31,23174,5751,28925
68,68755,2009-12-31,23476,5774,29250
68,68755,2010-12-31,23769,5790,29559
68,68755,2011-12-31,24039,5797,29836
68,68755,2012-12-31,24277,5810,30087
68,68755,2013-12-31,24521,5801,30322
68,68755,2014-12-31,24806,5772,30578
68,68755,2015-12-31,25076,5825,30901
68,68755,2016-12-31,25373,5835,31208
68,68755,2017-12-31,25741,5874,31615
68,68755,2018-12-31,26232,5926,32158
68,68755,2019-12-31,27041,5924,32965
68,68755,2020-12-31,27736,5892,33628
68,68755,2021-12-31,28134,5873,34007
68,68755,2022-12-31,28430,5837,34267
68,68755,2023-12-31,28713,5798,34511
68,68755,2024-12-31,29008,5763,34771
68,68755,2025-12-31,29282,5739,35021
68,68755,2026-12-31,29557,5718,35275
68,68755,2027-12-31,29835,5688,35523
68,68755,2028-12-31,30088,5676,35764
68,68755,2029-12-31,30324,5680,36004
68,68755,2030-12-31,30553,5669,36222
68,68755,2031-12-31,30759,5673,36432
68,68755,2032-12-31,30957,5658,36615
68,68755,2033-12-31,31160,5671,36831
68,68755,2034-12-31,31337,5659,36996
68,68755,2035-12-31,31485,5639,37124
68,68770,1985-12-31,1743,9268,11011
68,68770,1986-12-31,1753,9245,10998
68,68770,1987-12-31,1755,9155,10910
68,68770,1988-12-31,1767,8985,10752
68,68770,1989-12-31,1794,8834,10628
68,68770,1990-12-31,1820,8694,10514
68,68770,1991-12-31,1825,8590,10415
68,68770,1992-12-31,1821,8501,10322
68,68770,1993-12-31,1883,8934,10817
68,68770,1994-12-31,1864,8897,10761
68,68770,1995-12-31,1897,8857,10754
68,68770,1996-12-31,1940,8810,10750
68,68770,1997-12-31,1935,8766,10701
68,68770,1998-12-31,1947,8740,10687
68,68770,1999-12-31,1966,8689,10655
68,68770,2000-12-31,1967,8650,10617
68,68770,2001-12-31,1978,8610,10588
68,68770,2002-12-31,1983,8552,10535
68,68770,2003-12-31,1995,8510,10505
68,68770,2004-12-31,1999,8466,10465
68,68770,2005-12-31,2017,8377,10394
68,68770,2006-12-31,2013,8344,10357
68,68770,2007-12-31,2026,8266,10292
68,68770,2008-12-31,2044,8252,10296
68,68770,2009-12-31,2044,8168,10212
68,68770,2010-12-31,2065,8086,10151
68,68770,2011-12-31,2078,8021,10099
68,68770,2012-12-31,2102,7985,10087
68,68770,2013-12-31,2112,7964,10076
68,68770,2014-12-31,2098,7909,10007
68,68770,2015-12-31,2062,7865,9927
68,68770,2016-12-31,2068,7840,9908
68,68770,2017-12-31,2088,7830,9918
68,68770,2018-12-31,2136,7895,10031
68,68770,2019-12-31,2157,7929,10086
68,68770,2020-12-31,2182,7976,10158
68,68770,2021-12-31,2329,7941,10270
68,68770,2022-12-31,2461,7888,10349
68,68770,2023-12-31,2589,7834,10423
68,68770,2024-12-31,2645,7779,10424
68,68770,2025-12-31,2673,7742,10415
68,68770,2026-12-31,2704,7707,10411
68,68770,2027-12-31,2731,7677,10408
68,68770,2028-12-31,2756,7651,10407
68,68770,2029-12-31,2783,7638,10421
68,68770,2030-12-31,2795,7646,10441
68,68770,2031-12-31,2819,7632,10451
68,68770,2032-12-31,2835,7638,10473
68,68770,2033-12-31,2849,7618,10467
68,68770,2034-12-31,2869,7616,10485
68,68770,2035-12-31,2881,7595,10476
68,68773,1985-12-31,482,12104,12586
68,68773,1986-12-31,476,13678,14154
68,68773,1987-12-31,464,15069,15533
68,68773,1988-12-31,494,16450,16944
68,68773,1989-12-31,504,17650,18154
68,68773,1990-12-31,495,18983,19478
68,68773,1991-12-31,520,20282,20802
68,68773,1992-12-31,517,21543,22060
68,68773,1993-12-31,502,10330,10832
68,68773,1994-12-31,513,10178,10691
68,68773,1995-12-31,519,10027,10546
68,68773,1996-12-31,494,9880,10374
68,68773,1997-12-31,494,9737,10231
68,68773,1998-12-31,516,9592,10108
68,68773,1999-12-31,513,9437,9950
68,68773,2000-12-31,513,9297,9810
68,68773,2001-12-31,523,9141,9664
68,68773,2002-12-31,526,8992,9518
68,68773,2003-12-31,534,8844,9378
68,68773,2004-12-31,530,8707,9237
68,68773,2005-12-31,537,8502,9039
68,68773,2006-12-31,547,8353,8900
68,68773,2007-12-31,508,8200,8708
68,68773,2008-12-31,498,8025,8523
68,68773,2009-12-31,506,7878,8384
68,68773,2010-12-31,507,7753,8260
68,68773,2011-12-31,500,7570,8070
68,68773,2012-12-31,513,7391,7904
68,68773,2013-12-31,513,7231,7744
68,68773,2014-12-31,512,7095,7607
68,68773,2015-12-31,513,6959,7472
68,68773,2016-12-31,522,6803,7325
68,68773,2017-12-31,527,6767,7294
68,68773,2018-12-31,550,6652,7202
68,68773,2019-12-31,550,6553,7103
68,68773,2020-12-31,550,6514,7064
68,68773,2021-12-31,649,6493,7142
68,68773,2022-12-31,743,6454,7197
68,68773,2023-12-31,837,6411,7248
68,68773,2024-12-31,879,6372,7251
68,68773,2025-12-31,891,6331,7222
68,68773,2026-12-31,896,6318,7214
68,68773,2027-12-31,902,6306,7208
68,68773,2028-12-31,909,6282,7191
68,68773,2029-12-31,918,6266,7184
68,68773,2030-12-31,927,6262,7189
68,68773,2031-12-31,933,6269,7202
68,68773,2032-12-31,938,6263,7201
68,68773,2033-12-31,947,6260,7207
68,68773,2034-12-31,948,6253,7201
68,68773,2035-12-31,950,6232,7182
68,68780,1985-12-31,613,4163,4776
68,68780,1986-12-31,649,4092,4741
68,68780,1987-12-31,637,4055,4692
68,68780,1988-12-31,641,3986,4627
68,68780,1989-12-31,699,3955,4654
68,68780,1990-12-31,691,3868,4559
68,68780,1991-12-31,676,3800,4476
68,68780,1992-12-31,691,3697,4388
68,68780,1993-12-31,693,3879,4572
68,68780,1994-12-31,703,3839,4542
68,68780,1995-12-31,705,3811,4516
68,68780,1996-12-31,716,3786,4502
68,68780,1997-12-31,726,3746,4472
68,68780,1998-12-31,736,3704,4440
68,68780,1999-12-31,748,3678,4426
68,68780,2000-12-31,744,3640,4384
68,68780,2001-12-31,762,3607,4369
68,68780,2002-12-31,787,3567,4354
68,68780,2003-12-31,777,3534,4311
68,68780,2004-12-31,776,3507,4283
68,68780,2005-12-31,783,3470,4253
68,68780,2006-12-31,795,3452,4247
68,68780,2007-12-31,822,3417,4239
68,68780,2008-12-31,836,3390,4226
68,68780,2009-12-31,849,3338,4187
68,68780,2010-12-31,822,3290,4112
68,68780,2011-12-31,813,3272,4085
68,68780,2012-12-31,815,3243,4058
68,68780,2013-12-31,820,3205,4025
68,68780,2014-12-31,839,3184,4023
68,68780,2015-12-31,862,3162,4024
68,68780,2016-12-31,887,3153,4040
68,68780,2017-12-31,900,3046,3946
68,68780,2018-12-31,909,3066,3975
68,68780,2019-12-31,925,3052,3977
68,68780,2020-12-31,934,3053,3987
68,68780,2021-12-31,988,3043,4031
68,68780,2022-12-31,1037,3025,4062
68,68780,2023-12-31,1086,3005,4091
68,68780,2024-12-31,1108,2987,4095
68,68780,2025-12-31,1120,2971,4091
68,68780,2026-12-31,1129,2957,4086
68,68780,2027-12-31,1143,2945,4088
68,68780,2028-12-31,1150,2945,4095
68,68780,2029-12-31,1162,2943,4105
68,68780,2030-12-31,1162,2934,4096
68,68780,2031-12-31,1169,2933,4102
68,68780,2032-12-31,1178,2934,4112
68,68780,2033-12-31,1196,2934,4130
68,68780,2034-12-31,1206,2930,4136
68,68780,2035-12-31,1209,2930,4139
68,68820,1985-12-31,318,5333,5651
68,68820,1986-12-31,334,5390,5724
68,68820,1987-12-31,323,5406,5729
68,68820,1988-12-31,413,5372,5785
68,68820,1989-12-31,387,5385,5772
68,68820,1990-12-31,425,5388,5813
68,68820,1991-12-31,403,5363,5766
68,68820,1992-12-31,408,5363,5771
68,68820,1993-12-31,401,5698,6099
68,68820,1994-12-31,378,5743,6121
68,68820,1995-12-31,399,5767,6166
68,68820,1996-12-31,447,5872,6319
68,68820,1997-12-31,379,5905,6284
68,68820,1998-12-31,446,5956,6402
68,68820,1999-12-31,386,6014,6400
68,68820,2000-12-31,426,6050,6476
68,68820,2001-12-31,430,6110,6540
68,68820,2002-12-31,442,6151,6593
68,68820,2003-12-31,460,6169,6629
68,68820,2004-12-31,488,6198,6686
68,68820,2005-12-31,499,6215,6714
68,68820,2006-12-31,491,6251,6742
68,68820,2007-12-31,484,6296,6780
68,68820,2008-12-31,483,6342,6825
68,68820,2009-12-31,485,6405,6890
68,68820,2010-12-31,497,6453,6950
68,68820,2011-12-31,498,6495,6993
68,68820,2012-12-31,496,6521,7017
68,68820,2013-12-31,496,6531,7027
68,68820,2014-12-31,503,6547,7050
68,68820,2015-12-31,504,6557,7061
68,68820,2016-12-31,508,6648,7156
68,68820,2017-12-31,517,6736,7253
68,68820,2018-12-31,538,6835,7373
68,68820,2019-12-31,554,7008,7562
68,68820,2020-12-31,568,7150,7718
68,68820,2021-12-31,676,7129,7805
68,68820,2022-12-31,780,7085,7865
68,68820,2023-12-31,883,7038,7921
68,68820,2024-12-31,918,6992,7910
68,68820,2025-12-31,939,6954,7893
68,68820,2026-12-31,953,6926,7879
68,68820,2027-12-31,966,6914,7880
68,68820,2028-12-31,973,6903,7876
68,68820,2029-12-31,976,6884,7860
68,68820,2030-12-31,984,6886,7870
68,68820,2031-12-31,996,6883,7879
68,68820,2032-12-31,998,6879,7877
68,68820,2033-12-31,1002,6861,7863
68,68820,2034-12-31,1010,6859,7869
68,68820,2035-12-31,1014,6848,7862
68,68855,1985-12-31,1107,3470,4577
68,68855,1986-12-31,1133,3480,4613
68,68855,1987-12-31,1176,3433,4609
68,68855,1988-12-31,1217,3430,4647
68,68855,1989-12-31,1266,3433,4699
68,68855,1990-12-31,1317,3396,4713
68,68855,1991-12-31,1365,3361,4726
68,68855,1992-12-31,1406,3354,4760
68,68855,1993-12-31,1443,3493,4936
68,68855,1994-12-31,1504,3519,5023
68,68855,1995-12-31,1543,3521,5064
68,68855,1996-12-31,1558,3523,5081
68,68855,1997-12-31,1608,3534,5142
68,68855,1998-12-31,1649,3547,5196
68,68855,1999-12-31,1684,3543,5227
68,68855,2000-12-31,1709,3537,5246
68,68855,2001-12-31,1756,3546,5302
68,68855,2002-12-31,1796,3552,5348
68,68855,2003-12-31,1838,3545,5383
68,68855,2004-12-31,1859,3566,5425
68,68855,2005-12-31,1909,3577,5486
68,68855,2006-12-31,1939,3604,5543
68,68855,2007-12-31,1990,3621,5611
68,68855,2008-12-31,2043,3635,5678
68,68855,2009-12-31,2057,3637,5694
68,68855,2010-12-31,2059,3649,5708
68,68855,2011-12-31,2101,3654,5755
68,68855,2012-12-31,2145,3652,5797
68,68855,2013-12-31,2187,3648,5835
68,68855,2014-12-31,2228,3640,5868
68,68855,2015-12-31,2265,3639,5904
68,68855,2016-12-31,2310,3637,5947
68,68855,2017-12-31,2350,3651,6001
68,68855,2018-12-31,2408,3676,6084
68,68855,2019-12-31,2481,3741,6222
68,68855,2020-12-31,2543,3793,6336
68,68855,2021-12-31,2624,3782,6406
68,68855,2022-12-31,2696,3759,6455
68,68855,2023-12-31,2767,3734,6501
68,68855,2024-12-31,2812,3709,6521
68,68855,2025-12-31,2845,3694,6539
68,68855,2026-12-31,2874,3670,6544
68,68855,2027-12-31,2908,3664,6572
68,68855,2028-12-31,2935,3658,6593
68,68855,2029-12-31,2955,3658,6613
68,68855,2030-12-31,2975,3654,6629
68,68855,2031-12-31,2996,3648,6644
68,68855,2032-12-31,3020,3648,6668
68,68855,2033-12-31,3031,3643,6674
68,68855,2034-12-31,3054,3634,6688
68,68855,2035-12-31,3065,3635,6700
68,68861,1985-12-31,7232,8619,15851
68,68861,1986-12-31,7384,8723,16107
68,68861,1987-12-31,7555,8758,16313
68,68861,1988-12-31,7740,8707,16447
68,68861,1989-12-31,7925,8639,16564
68,68861,1990-12-31,8100,8646,16746
68,68861,1991-12-31,8285,8682,16967
68,68861,1992-12-31,8472,8690,17162
68,68861,1993-12-31,8667,9243,17910
68,68861,1994-12-31,8856,9328,18184
68,68861,1995-12-31,9053,9414,18467
68,68861,1996-12-31,9236,9506,18742
68,68861,1997-12-31,9437,9598,19035
68,68861,1998-12-31,9641,9677,19318
68,68861,1999-12-31,9858,9752,19610
68,68861,2000-12-31,10063,9827,19890
68,68861,2001-12-31,10258,9890,20148
68,68861,2002-12-31,10417,9954,20371
68,68861,2003-12-31,10591,10036,20627
68,68861,2004-12-31,10765,10113,20878
68,68861,2005-12-31,10932,10172,21104
68,68861,2006-12-31,11113,10200,21313
68,68861,2007-12-31,11283,10267,21550
68,68861,2008-12-31,11444,10320,21764
68,68861,2009-12-31,11615,10362,21977
68,68861,2010-12-31,11794,10417,22211
68,68861,2011-12-31,11970,10509,22479
68,68861,2012-12-31,12128,10562,22690
68,68861,2013-12-31,12287,10611,22898
68,68861,2014-12-31,12358,10707,23065
68,68861,2015-12-31,12508,10744,23252
68,68861,2016-12-31,12658,10896,23554
68,68861,2017-12-31,12861,10985,23846
68,68861,2018-12-31,13159,11197,24356
68,68861,2019-12-31,13557,11286,24843
68,68861,2020-12-31,13897,11322,25219
68,68861,2021-12-31,14212,11286,25498
68,68861,2022-12-31,14476,11217,25693
68,68861,2023-12-31,14734,11142,25876
68,68861,2024-12-31,14958,11080,26038
68,68861,2025-12-31,15154,11031,26185
68,68861,2026-12-31,15339,10995,26334
68,68861,2027-12-31,15485,10974,26459
68,68861,2028-12-31,15624,10993,26617
68,68861,2029-12-31,15765,11023,26788
68,68861,2030-12-31,15880,11115,26995
68,68861,2031-12-31,15987,11262,27249
68,68861,2032-12-31,16091,11500,27591
68,68861,2033-12-31,16187,11879,28066
68,68861,2034-12-31,16278,12490,28768
68,68861,2035-12-31,16357,13499,29856
68,68867,1985-12-31,609,1211,1820
68,68867,1986-12-31,578,1216,1794
68,68867,1987-12-31,588,1215,1803
68,68867,1988-12-31,620,1235,1855
68,68867,1989-12-31,654,1277,1931
68,68867,1990-12-31,626,1261,1887
68,68867,1991-12-31,639,1280,1919
68,68867,1992-12-31,650,1286,1936
68,68867,1993-12-31,644,1246,1890
68,68867,1994-12-31,633,1263,1896
68,68867,1995-12-31,673,1290,1963
68,68867,1996-12-31,667,1297,1964
68,68867,1997-12-31,637,1276,1913
68,68867,1998-12-31,611,1279,1890
68,68867,1999-12-31,667,1265,1932
68,68867,2000-12-31,609,1267,1876
68,68867,2001-12-31,620,1292,1912
68,68867,2002-12-31,634,1309,1943
68,68867,2003-12-31,663,1319,1982
68,68867,2004-12-31,665,1316,1981
68,68867,2005-12-31,698,1322,2020
68,68867,2006-12-31,693,1276,1969
68,68867,2007-12-31,675,1292,1967
68,68867,2008-12-31,688,1315,2003
68,68867,2009-12-31,697,1331,2028
68,68867,2010-12-31,657,1345,2002
68,68867,2011-12-31,667,1344,2011
68,68867,2012-12-31,658,1349,2007
68,68867,2013-12-31,672,1354,2026
68,68867,2014-12-31,682,1359,2041
68,68867,2015-12-31,687,1358,2045
68,68867,2016-12-31,701,1362,2063
68,68867,2017-12-31,709,1373,2082
68,68867,2018-12-31,729,1385,2114
68,68867,2019-12-31,722,1420,2142
68,68867,2020-12-31,722,1446,2168
68,68867,2021-12-31,750,1442,2192
68,68867,2022-12-31,776,1433,2209
68,68867,2023-12-31,801,1423,2224
68,68867,2024-12-31,803,1412,2215
68,68867,2025-12-31,808,1404,2212
68,68867,2026-12-31,821,1403,2224
68,68867,2027-12-31,829,1395,2224
68,68867,2028-12-31,838,1386,2224
68,68867,2029-12-31,844,1385,2229
68,68867,2030-12-31,850,1388,2238
68,68867,2031-12-31,853,1385,2238
68,68867,2032-12-31,857,1389,2246
68,68867,2033-12-31,863,1388,2251
68,68867,2034-12-31,863,1385,2248
68,68867,2035-12-31,873,1384,2257
68,68872,1985-12-31,2056,4607,6663
68,68872,1986-12-31,2118,4572,6690
68,68872,1987-12-31,2185,4486,6671
68,68872,1988-12-31,2257,4402,6659
68,68872,1989-12-31,2337,4357,6694
68,68872,1990-12-31,2408,4272,6680
68,68872,1991-12-31,2479,4188,6667
68,68872,1992-12-31,2550,4095,6645
68,68872,1993-12-31,2614,4265,6879
68,68872,1994-12-31,2731,4225,6956
68,68872,1995-12-31,2833,4209,7042
68,68872,1996-12-31,2921,4172,7093
68,68872,1997-12-31,3020,4123,7143
68,68872,1998-12-31,3096,4097,7193
68,68872,1999-12-31,3176,4050,7226
68,68872,2000-12-31,3251,4003,7254
68,68872,2001-12-31,3308,3937,7245
68,68872,2002-12-31,3377,3885,7262
68,68872,2003-12-31,3455,3844,7299
68,68872,2004-12-31,3530,3815,7345
68,68872,2005-12-31,3610,3769,7379
68,68872,2006-12-31,3695,3737,7432
68,68872,2007-12-31,3746,3702,7448
68,68872,2008-12-31,3838,3670,7508
68,68872,2009-12-31,3930,3627,7557
68,68872,2010-12-31,3987,3580,7567
68,68872,2011-12-31,3997,3549,7546
68,68872,2012-12-31,4072,3518,7590
68,68872,2013-12-31,4155,3477,7632
68,68872,2014-12-31,4228,3450,7678
68,68872,2015-12-31,4298,3426,7724
68,68872,2016-12-31,4371,3398,7769
68,68872,2017-12-31,4455,3298,7753
68,68872,2018-12-31,4564,3309,7873
68,68872,2019-12-31,4702,3225,7927
68,68872,2020-12-31,4820,3162,7982
68,68872,2021-12-31,4918,3152,8070
68,68872,2022-12-31,4999,3133,8132
68,68872,2023-12-31,5078,3112,8190
68,68872,2024-12-31,5148,3093,8241
68,68872,2025-12-31,5203,3075,8278
68,68872,2026-12-31,5259,3069,8328
68,68872,2027-12-31,5307,3057,8364
68,68872,2028-12-31,5362,3049,8411
68,68872,2029-12-31,5404,3041,8445
68,68872,2030-12-31,5443,3042,8485
68,68872,2031-12-31,5479,3043,8522
68,68872,2032-12-31,5517,3042,8559
68,68872,2033-12-31,5545,3038,8583
68,68872,2034-12-31,5567,3040,8607
68,68872,2035-12-31,5611,3038,8649
68,68895,1985-12-31,5813,4223,10036
68,68895,1986-12-31,5806,4192,9998
68,68895,1987-12-31,5824,4096,9920
68,68895,1988-12-31,5840,4059,9899
68,68895,1989-12-31,5855,4024,9879
68,68895,1990-12-31,5880,3940,9820
68,68895,1991-12-31,5890,3871,9761
68,68895,1992-12-31,5900,3796,9696
68,68895,1993-12-31,5916,3957,9873
68,68895,1994-12-31,5941,3921,9862
68,68895,1995-12-31,5971,3901,9872
68,68895,1996-12-31,5974,3873,9847
68,68895,1997-12-31,6043,3834,9877
68,68895,1998-12-31,6086,3815,9901
68,68895,1999-12-31,6117,3777,9894
68,68895,2000-12-31,6146,3740,9886
68,68895,2001-12-31,6159,3688,9847
68,68895,2002-12-31,6165,3648,9813
68,68895,2003-12-31,6163,3625,9788
68,68895,2004-12-31,6181,3584,9765
68,68895,2005-12-31,6189,3554,9743
68,68895,2006-12-31,6196,3542,9738
68,68895,2007-12-31,6205,3513,9718
68,68895,2008-12-31,6192,3494,9686
68,68895,2009-12-31,6207,3463,9670
68,68895,2010-12-31,6222,3404,9626
68,68895,2011-12-31,6230,3355,9585
68,68895,2012-12-31,6224,3333,9557
68,68895,2013-12-31,6241,3306,9547
68,68895,2014-12-31,6223,3279,9502
68,68895,2015-12-31,6210,3246,9456
68,68895,2016-12-31,6192,3218,9410
68,68895,2017-12-31,6272,3180,9452
68,68895,2018-12-31,6274,3192,9466
68,68895,2019-12-31,6296,3211,9507
68,68895,2020-12-31,6339,3227,9566
68,68895,2021-12-31,6457,3215,9672
68,68895,2022-12-31,6552,3194,9746
68,68895,2023-12-31,6642,3173,9815
68,68895,2024-12-31,6721,3149,9870
68,68895,2025-12-31,6787,3135,9922
68,68895,2026-12-31,6862,3129,9991
68,68895,2027-12-31,6926,3109,10035
68,68895,2028-12-31,6983,3099,10082
68,68895,2029-12-31,7038,3101,10139
68,68895,2030-12-31,7098,3107,10205
68,68895,2031-12-31,7138,3091,10229
68,68895,2032-12-31,7195,3091,10286
68,68895,2033-12-31,7229,3102,10331
68,68895,2034-12-31,7269,3091,10360
68,68895,2035-12-31,7305,3088,10393
70,70001,1985-12-31,136807,17156,153963
70,70001,1986-12-31,144056,16853,160909
70,70001,1987-12-31,150522,16637,167159
70,70001,1988-12-31,156415,16562,172977
70,70001,1989-12-31,161783,16571,178354
70,70001,1990-12-31,166661,16643,183304
70,70001,1991-12-31,171185,16766,187951
70,70001,1992-12-31,175470,16941,192411
70,70001,1993-12-31,179384,17163,196547
70,70001,1994-12-31,183116,17384,200500
70,70001,1995-12-31,186759,17629,204388
70,70001,1996-12-31,190078,17884,207962
70,70001,1997-12-31,193350,18155,211505
70,70001,1998-12-31,194542,18467,213009
70,70001,1999-12-31,197247,18923,216170
70,70001,2000-12-31,200376,19315,219691
70,70001,2001-12-31,203501,19724,223225
70,70001,2002-12-31,204650,20388,225038
70,70001,2003-12-31,208326,20709,229035
70,70001,2004-12-31,211055,21195,232250
70,70001,2005-12-31,213561,21661,235222
70,70001,2006-12-31,216163,22148,238311
70,70001,2007-12-31,218748,22632,241380
70,70001,2008-12-31,221320,23116,244436
70,70001,2009-12-31,223833,23599,247432
70,70001,2010-12-31,226320,24093,250413
70,70001,2011-12-31,228809,24585,253394
70,70001,2012-12-31,231265,25061,256326
70,70001,2013-12-31,233727,25550,259277
70,70001,2014-12-31,236150,26049,262199
70,70001,2015-12-31,238668,26544,265212
70,70001,2016-12-31,241537,27085,268622
70,70001,2017-12-31,244836,27698,272534
70,70001,2018-12-31,249323,28450,277773
70,70001,2019-12-31,254957,31678,286635
70,70001,2020-12-31,259435,34516,293951
70,70001,2021-12-31,262775,35287,298062
70,70001,2022-12-31,265190,35936,301126
70,70001,2023-12-31,267468,36558,304026
70,70001,2024-12-31,269180,37141,306321
70,70001,2025-12-31,270692,37719,308411
70,70001,2026-12-31,272120,38276,310396
70,70001,2027-12-31,273550,38824,312374
70,70001,2028-12-31,274996,39340,314336
70,70001,2029-12-31,276458,39846,316304
70,70001,2030-12-31,277968,40317,318285
70,70001,2031-12-31,279458,40776,320234
70,70001,2032-12-31,280862,41237,322099
70,70001,2033-12-31,282162,41682,323844
70,70001,2034-12-31,283379,42124,325503
70,70001,2035-12-31,284513,42576,327089
70,70110,1985-12-31,5305,1465,6770
70,70110,1986-12-31,5542,1415,6957
70,70110,1987-12-31,5763,1426,7189
70,70110,1988-12-31,5900,1396,7296
70,70110,1989-12-31,6092,1404,7496
70,70110,1990-12-31,6234,1390,7624
70,70110,1991-12-31,6363,1388,7751
70,70110,1992-12-31,6473,1400,7873
70,70110,1993-12-31,6568,1398,7966
70,70110,1994-12-31,6683,1416,8099
70,70110,1995-12-31,6772,1431,8203
70,70110,1996-12-31,6845,1456,8301
70,70110,1997-12-31,6984,1467,8451
70,70110,1998-12-31,6958,1511,8469
70,70110,1999-12-31,7035,1493,8528
70,70110,2000-12-31,7111,1523,8634
70,70110,2001-12-31,7191,1557,8748
70,70110,2002-12-31,7192,1585,8777
70,70110,2003-12-31,7302,1602,8904
70,70110,2004-12-31,7349,1651,9000
70,70110,2005-12-31,7444,1686,9130
70,70110,2006-12-31,7486,1711,9197
70,70110,2007-12-31,7544,1714,9258
70,70110,2008-12-31,7612,1744,9356
70,70110,2009-12-31,7675,1776,9451
70,70110,2010-12-31,7724,1803,9527
70,70110,2011-12-31,7783,1832,9615
70,70110,2012-12-31,7857,1881,9738
70,70110,2013-12-31,7962,1895,9857
70,70110,2014-12-31,7959,1935,9894
70,70110,2015-12-31,7986,1982,9968
70,70110,2016-12-31,8068,2028,10096
70,70110,2017-12-31,8171,2080,10251
70,70110,2018-12-31,8317,2124,10441
70,70110,2019-12-31,8504,2223,10727
70,70110,2020-12-31,8653,2311,10964
70,70110,2021-12-31,8754,2363,11117
70,70110,2022-12-31,8826,2406,11232
70,70110,2023-12-31,8892,2448,11340
70,70110,2024-12-31,8950,2487,11437
70,70110,2025-12-31,8991,2521,11512
70,70110,2026-12-31,9039,2564,11603
70,70110,2027-12-31,9093,2599,11692
70,70110,2028-12-31,9145,2627,11772
70,70110,2029-12-31,9186,2666,11852
70,70110,2030-12-31,9233,2705,11938
70,70110,2031-12-31,9291,2736,12027
70,70110,2032-12-31,9322,2760,12082
70,70110,2033-12-31,9381,2783,12164
70,70110,2034-12-31,9414,2816,12230
70,70110,2035-12-31,9454,2847,12301
70,70124,1985-12-31,2404,6834,9238
70,70124,1986-12-31,2481,6723,9204
70,70124,1987-12-31,2582,6631,9213
70,70124,1988-12-31,2679,6613,9292
70,70124,1989-12-31,2744,6631,9375
70,70124,1990-12-31,2826,6647,9473
70,70124,1991-12-31,2880,6710,9590
70,70124,1992-12-31,2933,6776,9709
70,70124,1993-12-31,2980,6855,9835
70,70124,1994-12-31,3032,6930,9962
70,70124,1995-12-31,3077,7038,10115
70,70124,1996-12-31,3117,7149,10266
70,70124,1997-12-31,3171,7267,10438
70,70124,1998-12-31,3159,7389,10548
70,70124,1999-12-31,3189,7559,10748
70,70124,2000-12-31,3214,7725,10939
70,70124,2001-12-31,3271,7886,11157
70,70124,2002-12-31,3257,8155,11412
70,70124,2003-12-31,3306,8297,11603
70,70124,2004-12-31,3318,8473,11791
70,70124,2005-12-31,3369,8670,12039
70,70124,2006-12-31,3404,8877,12281
70,70124,2007-12-31,3444,9073,12517
70,70124,2008-12-31,3468,9266,12734
70,70124,2009-12-31,3492,9438,12930
70,70124,2010-12-31,3523,9655,13178
70,70124,2011-12-31,3543,9833,13376
70,70124,2012-12-31,3540,10042,13582
70,70124,2013-12-31,3545,10221,13766
70,70124,2014-12-31,3592,10424,14016
70,70124,2015-12-31,3639,10631,14270
70,70124,2016-12-31,3691,10856,14547
70,70124,2017-12-31,3749,11106,14855
70,70124,2018-12-31,3821,11410,15231
70,70124,2019-12-31,3902,11766,15668
70,70124,2020-12-31,3966,12062,16028
70,70124,2021-12-31,3923,12329,16252
70,70124,2022-12-31,3864,12555,16419
70,70124,2023-12-31,3804,12773,16577
70,70124,2024-12-31,3790,12985,16775
70,70124,2025-12-31,3803,13194,16997
70,70124,2026-12-31,3815,13382,17197
70,70124,2027-12-31,3823,13575,17398
70,70124,2028-12-31,3847,13763,17610
70,70124,2029-12-31,3867,13929,17796
70,70124,2030-12-31,3880,14100,17980
70,70124,2031-12-31,3915,14255,18170
70,70124,2032-12-31,3938,14421,18359
70,70124,2033-12-31,3953,14586,18539
70,70124,2034-12-31,3969,14735,18704
70,70124,2035-12-31,3991,14873,18864
70,70204,1985-12-31,3784,6175,9959
70,70204,1986-12-31,3895,5916,9811
70,70204,1987-12-31,3912,5710,9622
70,70204,1988-12-31,3980,5502,9482
70,70204,1989-12-31,4044,5340,9384
70,70204,1990-12-31,4084,5234,9318
70,70204,1991-12-31,4094,5151,9245
70,70204,1992-12-31,4103,5081,9184
70,70204,1993-12-31,4100,5011,9111
70,70204,1994-12-31,4115,4940,9055
70,70204,1995-12-31,4094,4887,8981
70,70204,1996-12-31,4090,4837,8927
70,70204,1997-12-31,4072,4799,8871
70,70204,1998-12-31,4029,4784,8813
70,70204,1999-12-31,4018,4771,8789
70,70204,2000-12-31,4022,4759,8781
70,70204,2001-12-31,3990,4763,8753
70,70204,2002-12-31,3946,4808,8754
70,70204,2003-12-31,3959,4776,8735
70,70204,2004-12-31,3921,4768,8689
70,70204,2005-12-31,3917,4789,8706
70,70204,2006-12-31,3907,4776,8683
70,70204,2007-12-31,3911,4772,8683
70,70204,2008-12-31,3904,4784,8688
70,70204,2009-12-31,3869,4786,8655
70,70204,2010-12-31,3875,4749,8624
70,70204,2011-12-31,3861,4774,8635
70,70204,2012-12-31,3845,4786,8631
70,70204,2013-12-31,3770,4751,8521
70,70204,2014-12-31,3799,4762,8561
70,70204,2015-12-31,3802,4753,8555
70,70204,2016-12-31,3821,4749,8570
70,70204,2017-12-31,3793,4773,8566
70,70204,2018-12-31,3832,4791,8623
70,70204,2019-12-31,3810,4860,8670
70,70204,2020-12-31,3792,4940,8732
70,70204,2021-12-31,3802,5050,8852
70,70204,2022-12-31,3801,5142,8943
70,70204,2023-12-31,3799,5231,9030
70,70204,2024-12-31,3811,5316,9127
70,70204,2025-12-31,3820,5395,9215
70,70204,2026-12-31,3827,5468,9295
70,70204,2027-12-31,3851,5544,9395
70,70204,2028-12-31,3869,5621,9490
70,70204,2029-12-31,3888,5689,9577
70,70204,2030-12-31,3911,5767,9678
70,70204,2031-12-31,3920,5823,9743
70,70204,2032-12-31,3943,5889,9832
70,70204,2033-12-31,3958,5964,9922
70,70204,2034-12-31,3980,6024,10004
70,70204,2035-12-31,3997,6071,10068
70,70215,1985-12-31,33614,18649,52263
70,70215,1986-12-31,35080,18370,53450
70,70215,1987-12-31,36325,18166,54491
70,70215,1988-12-31,37446,18118,55564
70,70215,1989-12-31,38425,18167,56592
70,70215,1990-12-31,39260,18296,57556
70,70215,1991-12-31,40037,18471,58508
70,70215,1992-12-31,40738,18704,59442
70,70215,1993-12-31,41371,18952,60323
70,70215,1994-12-31,41937,19253,61190
70,70215,1995-12-31,42513,19556,62069
70,70215,1996-12-31,42992,19881,62873
70,70215,1997-12-31,43493,20195,63688
70,70215,1998-12-31,43502,13996,57498
70,70215,1999-12-31,43851,14096,57947
70,70215,2000-12-31,44321,14149,58470
70,70215,2001-12-31,44785,14195,58980
70,70215,2002-12-31,44820,14442,59262
70,70215,2003-12-31,45401,14438,59839
70,70215,2004-12-31,45796,14552,60348
70,70215,2005-12-31,46129,14621,60750
70,70215,2006-12-31,46492,14719,61211
70,70215,2007-12-31,46844,14819,61663
70,70215,2008-12-31,47212,14903,62115
70,70215,2009-12-31,47552,15012,62564
70,70215,2010-12-31,47909,15107,63016
70,70215,2011-12-31,48255,15194,63449
70,70215,2012-12-31,48612,15267,63879
70,70215,2013-12-31,49002,15364,64366
70,70215,2014-12-31,49310,15446,64756
70,70215,2015-12-31,49670,15535,65205
70,70215,2016-12-31,50025,15641,65666
70,70215,2017-12-31,50572,15781,66353
70,70215,2018-12-31,51372,15999,67371
70,70215,2019-12-31,52540,16728,69268
70,70215,2020-12-31,53468,17385,70853
70,70215,2021-12-31,54069,17774,71843
70,70215,2022-12-31,54482,18100,72582
70,70215,2023-12-31,54868,18414,73282
70,70215,2024-12-31,55197,18720,73917
70,70215,2025-12-31,55532,19002,74534
70,70215,2026-12-31,55885,19292,75177
70,70215,2027-12-31,56168,19556,75724
70,70215,2028-12-31,56513,19817,76330
70,70215,2029-12-31,56797,20066,76863
70,70215,2030-12-31,57107,20302,77409
70,70215,2031-12-31,57431,20535,77966
70,70215,2032-12-31,57702,20772,78474
70,70215,2033-12-31,57970,20987,78957
70,70215,2034-12-31,58216,21208,79424
70,70215,2035-12-31,58436,21440,79876
70,70221,1985-12-31,0,0,0
70,70221,1986-12-31,0,0,0
70,70221,1987-12-31,0,0,0
70,70221,1988-12-31,0,0,0
70,70221,1989-12-31,0,0,0
70,70221,1990-12-31,0,0,0
70,70221,1991-12-31,0,0,0
70,70221,1992-12-31,0,0,0
70,70221,1993-12-31,0,0,0
70,70221,1994-12-31,0,0,0
70,70221,1995-12-31,0,0,0
70,70221,1996-12-31,0,0,0
70,70221,1997-12-31,0,0,0
70,70221,1998-12-31,0,0,0
70,70221,1999-12-31,0,0,0
70,70221,2000-12-31,0,0,0
70,70221,2001-12-31,0,0,0
70,70221,2002-12-31,4299,10489,14788
70,70221,2003-12-31,4743,10255,14998
70,70221,2004-12-31,5182,10088,15270
70,70221,2005-12-31,5616,9887,15503
70,70221,2006-12-31,6013,9726,15739
70,70221,2007-12-31,6423,9534,15957
70,70221,2008-12-31,6816,9347,16163
70,70221,2009-12-31,7267,9178,16445
70,70221,2010-12-31,7663,8974,16637
70,70221,2011-12-31,8029,8776,16805
70,70221,2012-12-31,8418,8565,16983
70,70221,2013-12-31,8836,8378,17214
70,70221,2014-12-31,9202,8153,17355
70,70221,2015-12-31,9589,7937,17526
70,70221,2016-12-31,9990,7728,17718
70,70221,2017-12-31,10403,7534,17937
70,70221,2018-12-31,10856,7394,18250
70,70221,2019-12-31,11224,7668,18892
70,70221,2020-12-31,11625,7891,19516
70,70221,2021-12-31,11719,8070,19789
70,70221,2022-12-31,11771,8221,19992
70,70221,2023-12-31,11819,8366,20185
70,70221,2024-12-31,11877,8503,20380
70,70221,2025-12-31,11940,8639,20579
70,70221,2026-12-31,11996,8777,20773
70,70221,2027-12-31,12062,8910,20972
70,70221,2028-12-31,12129,9026,21155
70,70221,2029-12-31,12205,9160,21365
70,70221,2030-12-31,12292,9270,21562
70,70221,2031-12-31,12353,9381,21734
70,70221,2032-12-31,12439,9488,21927
70,70221,2033-12-31,12506,9591,22097
70,70221,2034-12-31,12558,9697,22255
70,70221,2035-12-31,12632,9801,22433
70,70230,1985-12-31,2089,2027,4116
70,70230,1986-12-31,2179,1934,4113
70,70230,1987-12-31,2247,1906,4153
70,70230,1988-12-31,2296,1851,4147
70,70230,1989-12-31,2334,1803,4137
70,70230,1990-12-31,2369,1741,4110
70,70230,1991-12-31,2409,1710,4119
70,70230,1992-12-31,2439,1696,4135
70,70230,1993-12-31,2471,1683,4154
70,70230,1994-12-31,2522,1656,4178
70,70230,1995-12-31,2522,1618,4140
70,70230,1996-12-31,2570,1611,4181
70,70230,1997-12-31,2574,1585,4159
70,70230,1998-12-31,2587,1603,4190
70,70230,1999-12-31,2574,1595,4169
70,70230,2000-12-31,2584,1616,4200
70,70230,2001-12-31,2593,1600,4193
70,70230,2002-12-31,2606,1595,4201
70,70230,2003-12-31,2627,1579,4206
70,70230,2004-12-31,2635,1581,4216
70,70230,2005-12-31,2665,1600,4265
70,70230,2006-12-31,2681,1604,4285
70,70230,2007-12-31,2687,1613,4300
70,70230,2008-12-31,2684,1583,4267
70,70230,2009-12-31,2681,1566,4247
70,70230,2010-12-31,2705,1578,4283
70,70230,2011-12-31,2693,1589,4282
70,70230,2012-12-31,2686,1604,4290
70,70230,2013-12-31,2698,1616,4314
70,70230,2014-12-31,2719,1642,4361
70,70230,2015-12-31,2744,1645,4389
70,70230,2016-12-31,2767,1634,4401
70,70230,2017-12-31,2801,1576,4377
70,70230,2018-12-31,2853,1613,4466
70,70230,2019-12-31,2890,1647,4537
70,70230,2020-12-31,2919,1685,4604
70,70230,2021-12-31,2945,1722,4667
70,70230,2022-12-31,2961,1754,4715
70,70230,2023-12-31,2977,1784,4761
70,70230,2024-12-31,2996,1809,4805
70,70230,2025-12-31,3006,1835,4841
70,70230,2026-12-31,3013,1867,4880
70,70230,2027-12-31,3037,1896,4933
70,70230,2028-12-31,3046,1920,4966
70,70230,2029-12-31,3073,1944,5017
70,70230,2030-12-31,3081,1967,5048
70,70230,2031-12-31,3092,1985,5077
70,70230,2032-12-31,3116,2005,5121
70,70230,2033-12-31,3127,2023,5150
70,70230,2034-12-31,3151,2051,5202
70,70230,2035-12-31,3151,2073,5224
70,70233,1985-12-31,0,0,0
70,70233,1986-12-31,0,0,0
70,70233,1987-12-31,0,0,0
70,70233,1988-12-31,0,0,0
70,70233,1989-12-31,0,0,0
70,70233,1990-12-31,0,0,0
70,70233,1991-12-31,0,0,0
70,70233,1992-12-31,0,0,0
70,70233,1993-12-31,0,0,0
70,70233,1994-12-31,0,0,0
70,70233,1995-12-31,0,0,0
70,70233,1996-12-31,0,0,0
70,70233,1997-12-31,0,0,0
70,70233,1998-12-31,4656,6144,10800
70,70233,1999-12-31,4658,6132,10790
70,70233,2000-12-31,4615,6083,10698
70,70233,2001-12-31,4609,6029,10638
70,70233,2002-12-31,4539,6071,10610
70,70233,2003-12-31,4542,6007,10549
70,70233,2004-12-31,4523,5997,10520
70,70233,2005-12-31,4491,5972,10463
70,70233,2006-12-31,4466,5938,10404
70,70233,2007-12-31,4444,5902,10346
70,70233,2008-12-31,4450,5871,10321
70,70233,2009-12-31,4424,5849,10273
70,70233,2010-12-31,4410,5825,10235
70,70233,2011-12-31,4394,5775,10169
70,70233,2012-12-31,4371,5736,10107
70,70233,2013-12-31,4321,5728,10049
70,70233,2014-12-31,4310,5681,9991
70,70233,2015-12-31,4320,5646,9966
70,70233,2016-12-31,4325,5624,9949
70,70233,2017-12-31,4335,5621,9956
70,70233,2018-12-31,4340,5604,9944
70,70233,2019-12-31,4436,5779,10215
70,70233,2020-12-31,4512,5927,10439
70,70233,2021-12-31,4527,6058,10585
70,70233,2022-12-31,4525,6169,10694
70,70233,2023-12-31,4520,6277,10797
70,70233,2024-12-31,4530,6384,10914
70,70233,2025-12-31,4554,6487,11041
70,70233,2026-12-31,4568,6581,11149
70,70233,2027-12-31,4600,6659,11259
70,70233,2028-12-31,4623,6751,11374
70,70233,2029-12-31,4648,6840,11488
70,70233,2030-12-31,4663,6919,11582
70,70233,2031-12-31,4700,7002,11702
70,70233,2032-12-31,4713,7078,11791
70,70233,2033-12-31,4735,7158,11893
70,70233,2034-12-31,4756,7232,11988
70,70233,2035-12-31,4777,7302,12079
70,70235,1985-12-31,7099,5650,12749
70,70235,1986-12-31,7445,5570,13015
70,70235,1987-12-31,7787,5528,13315
70,70235,1988-12-31,8010,5512,13522
70,70235,1989-12-31,8250,5533,13783
70,70235,1990-12-31,8485,5590,14075
70,70235,1991-12-31,8697,5658,14355
70,70235,1992-12-31,8873,5685,14558
70,70235,1993-12-31,9049,5780,14829
70,70235,1994-12-31,9216,5871,15087
70,70235,1995-12-31,9333,5981,15314
70,70235,1996-12-31,9524,6073,15597
70,70235,1997-12-31,9647,6168,15815
70,70235,1998-12-31,9690,6290,15980
70,70235,1999-12-31,9798,6464,16262
70,70235,2000-12-31,9926,6623,16549
70,70235,2001-12-31,10063,6757,16820
70,70235,2002-12-31,10103,7000,17103
70,70235,2003-12-31,10255,7127,17382
70,70235,2004-12-31,10374,7304,17678
70,70235,2005-12-31,10472,7481,17953
70,70235,2006-12-31,10602,7649,18251
70,70235,2007-12-31,10702,7831,18533
70,70235,2008-12-31,10813,8019,18832
70,70235,2009-12-31,10909,8184,19093
70,70235,2010-12-31,11013,8375,19388
70,70235,2011-12-31,11127,8545,19672
70,70235,2012-12-31,11215,8710,19925
70,70235,2013-12-31,11326,8918,20244
70,70235,2014-12-31,11464,9110,20574
70,70235,2015-12-31,11519,9277,20796
70,70235,2016-12-31,11645,9505,21150
70,70235,2017-12-31,11738,9701,21439
70,70235,2018-12-31,11997,9985,21982
70,70235,2019-12-31,12268,10405,22673
70,70235,2020-12-31,12483,10755,23238
70,70235,2021-12-31,12567,10996,23563
70,70235,2022-12-31,12608,11197,23805
70,70235,2023-12-31,12643,11392,24035
70,70235,2024-12-31,12696,11563,24259
70,70235,2025-12-31,12759,11758,24517
70,70235,2026-12-31,12818,11918,24736
70,70235,2027-12-31,12879,12080,24959
70,70235,2028-12-31,12939,12257,25196
70,70235,2029-12-31,13013,12404,25417
70,70235,2030-12-31,13085,12550,25635
70,70235,2031-12-31,13162,12687,25849
70,70235,2032-12-31,13228,12838,26066
70,70235,2033-12-31,13291,12980,26271
70,70235,2034-12-31,13348,13121,26469
70,70235,2035-12-31,13386,13242,26628
70,70265,1985-12-31,3476,7984,11460
70,70265,1986-12-31,3711,7759,11470
70,70265,1987-12-31,3886,7590,11476
70,70265,1988-12-31,4086,7499,11585
70,70265,1989-12-31,4252,7430,11682
70,70265,1990-12-31,4390,7386,11776
70,70265,1991-12-31,4527,7380,11907
70,70265,1992-12-31,4652,7397,12049
70,70265,1993-12-31,4780,7431,12211
70,70265,1994-12-31,4915,7470,12385
70,70265,1995-12-31,5024,7512,12536
70,70265,1996-12-31,5154,7566,12720
70,70265,1997-12-31,5257,7600,12857
70,70265,1998-12-31,5296,7676,12972
70,70265,1999-12-31,5376,7818,13194
70,70265,2000-12-31,5495,7931,13426
70,70265,2001-12-31,5595,8035,13630
70,70265,2002-12-31,5649,8256,13905
70,70265,2003-12-31,5755,8337,14092
70,70265,2004-12-31,5860,8481,14341
70,70265,2005-12-31,5944,8621,14565
70,70265,2006-12-31,6032,8762,14794
70,70265,2007-12-31,6108,8908,15016
70,70265,2008-12-31,6199,9055,15254
70,70265,2009-12-31,6277,9184,15461
70,70265,2010-12-31,6366,9328,15694
70,70265,2011-12-31,6453,9473,15926
70,70265,2012-12-31,6533,9602,16135
70,70265,2013-12-31,6606,9699,16305
70,70265,2014-12-31,6703,9858,16561
70,70265,2015-12-31,6795,10027,16822
70,70265,2016-12-31,6882,10168,17050
70,70265,2017-12-31,6988,10338,17326
70,70265,2018-12-31,7122,10591,17713
70,70265,2019-12-31,7293,10905,18198
70,70265,2020-12-31,7425,11176,18601
70,70265,2021-12-31,7437,11424,18861
70,70265,2022-12-31,7422,11633,19055
70,70265,2023-12-31,7404,11835,19239
70,70265,2024-12-31,7429,12034,19463
70,70265,2025-12-31,7455,12209,19664
70,70265,2026-12-31,7488,12404,19892
70,70265,2027-12-31,7527,12573,20100
70,70265,2028-12-31,7570,12737,20307
70,70265,2029-12-31,7618,12904,20522
70,70265,2030-12-31,7663,13062,20725
70,70265,2031-12-31,7692,13207,20899
70,70265,2032-12-31,7736,13348,21084
70,70265,2033-12-31,7771,13497,21268
70,70265,2034-12-31,7806,13637,21443
70,70265,2035-12-31,7847,13779,21626
70,70400,1985-12-31,3115,4688,7803
70,70400,1986-12-31,3285,4561,7846
70,70400,1987-12-31,3460,4512,7972
70,70400,1988-12-31,3582,4426,8008
70,70400,1989-12-31,3701,4384,8085
70,70400,1990-12-31,3822,4365,8187
70,70400,1991-12-31,3937,4369,8306
70,70400,1992-12-31,4057,4386,8443
70,70400,1993-12-31,4158,4399,8557
70,70400,1994-12-31,4246,4433,8679
70,70400,1995-12-31,4294,4464,8758
70,70400,1996-12-31,4434,4497,8931
70,70400,1997-12-31,4516,4541,9057
70,70400,1998-12-31,4534,4583,9117
70,70400,1999-12-31,4599,4659,9258
70,70400,2000-12-31,4690,4732,9422
70,70400,2001-12-31,4769,4800,9569
70,70400,2002-12-31,4801,4934,9735
70,70400,2003-12-31,4899,4985,9884
70,70400,2004-12-31,4947,5071,10018
70,70400,2005-12-31,5023,5161,10184
70,70400,2006-12-31,5104,5245,10349
70,70400,2007-12-31,5156,5333,10489
70,70400,2008-12-31,5202,5429,10631
70,70400,2009-12-31,5262,5535,10797
70,70400,2010-12-31,5368,5612,10980
70,70400,2011-12-31,5423,5701,11124
70,70400,2012-12-31,5497,5792,11289
70,70400,2013-12-31,5511,5868,11379
70,70400,2014-12-31,5594,5973,11567
70,70400,2015-12-31,5690,6055,11745
70,70400,2016-12-31,5756,6142,11898
70,70400,2017-12-31,5828,6222,12050
70,70400,2018-12-31,5934,6415,12349
70,70400,2019-12-31,6078,6623,12701
70,70400,2020-12-31,6189,6805,12994
70,70400,2021-12-31,6220,6956,13176
70,70400,2022-12-31,6228,7083,13311
70,70400,2023-12-31,6233,7206,13439
70,70400,2024-12-31,6258,7330,13588
70,70400,2025-12-31,6282,7436,13718
70,70400,2026-12-31,6322,7542,13864
70,70400,2027-12-31,6347,7647,13994
70,70400,2028-12-31,6372,7749,14121
70,70400,2029-12-31,6409,7849,14258
70,70400,2030-12-31,6441,7935,14376
70,70400,2031-12-31,6483,8029,14512
70,70400,2032-12-31,6512,8106,14618
70,70400,2033-12-31,6545,8208,14753
70,70400,2034-12-31,6578,8287,14865
70,70400,2035-12-31,6596,8378,14974
70,70418,1985-12-31,5821,11227,17048
70,70418,1986-12-31,6159,10799,16958
70,70418,1987-12-31,6470,10499,16969
70,70418,1988-12-31,6719,10260,16979
70,70418,1989-12-31,6969,10088,17057
70,70418,1990-12-31,7205,9962,17167
70,70418,1991-12-31,7406,9866,17272
70,70418,1992-12-31,7604,9799,17403
70,70418,1993-12-31,7800,9766,17566
70,70418,1994-12-31,7965,9739,17704
70,70418,1995-12-31,8137,9714,17851
70,70418,1996-12-31,8303,9699,18002
70,70418,1997-12-31,8448,9704,18152
70,70418,1998-12-31,8512,9727,18239
70,70418,1999-12-31,8650,9824,18474
70,70418,2000-12-31,8789,9872,18661
70,70418,2001-12-31,8922,9941,18863
70,70418,2002-12-31,9012,10136,19148
70,70418,2003-12-31,9176,10171,19347
70,70418,2004-12-31,9257,10277,19534
70,70418,2005-12-31,9427,10354,19781
70,70418,2006-12-31,9533,10452,19985
70,70418,2007-12-31,9711,10562,20273
70,70418,2008-12-31,9809,10655,20464
70,70418,2009-12-31,9909,10737,20646
70,70418,2010-12-31,10046,10839,20885
70,70418,2011-12-31,10153,10932,21085
70,70418,2012-12-31,10270,11031,21301
70,70418,2013-12-31,10411,11115,21526
70,70418,2014-12-31,10566,11205,21771
70,70418,2015-12-31,10607,11304,21911
70,70418,2016-12-31,10757,11421,22178
70,70418,2017-12-31,10907,11562,22469
70,70418,2018-12-31,11137,11743,22880
70,70418,2019-12-31,11344,12076,23420
70,70418,2020-12-31,11501,12383,23884
70,70418,2021-12-31,11555,12658,24213
70,70418,2022-12-31,11573,12889,24462
70,70418,2023-12-31,11585,13113,24698
70,70418,2024-12-31,11597,13341,24938
70,70418,2025-12-31,11633,13541,25174
70,70418,2026-12-31,11662,13748,25410
70,70418,2027-12-31,11715,13936,25651
70,70418,2028-12-31,11771,14124,25895
70,70418,2029-12-31,11828,14308,26136
70,70418,2030-12-31,11887,14478,26365
70,70418,2031-12-31,11939,14642,26581
70,70418,2032-12-31,12006,14803,26809
70,70418,2033-12-31,12060,14970,27030
70,70418,2034-12-31,12111,15124,27235
70,70418,2035-12-31,12148,15277,27425
70,70429,1985-12-31,3748,21491,25239
70,70429,1986-12-31,4030,20838,24868
70,70429,1987-12-31,4357,20309,24666
70,70429,1988-12-31,4616,19954,24570
70,70429,1989-12-31,4892,19715,24607
70,70429,1990-12-31,5146,19574,24720
70,70429,1991-12-31,5384,19503,24887
70,70429,1992-12-31,5620,19481,25101
70,70429,1993-12-31,5843,19503,25346
70,70429,1994-12-31,6069,19561,25630
70,70429,1995-12-31,6258,19639,25897
70,70429,1996-12-31,6462,19712,26174
70,70429,1997-12-31,6659,19812,26471
70,70429,1998-12-31,6766,19956,26722
70,70429,1999-12-31,6975,20272,27247
70,70429,2000-12-31,7171,20497,27668
70,70429,2001-12-31,7355,20740,28095
70,70429,2002-12-31,7460,21266,28726
70,70429,2003-12-31,7674,21421,29095
70,70429,2004-12-31,7853,21743,29596
70,70429,2005-12-31,8011,22031,30042
70,70429,2006-12-31,8177,22350,30527
70,70429,2007-12-31,8352,22659,31011
70,70429,2008-12-31,8509,22974,31483
70,70429,2009-12-31,8657,23288,31945
70,70429,2010-12-31,8821,23596,32417
70,70429,2011-12-31,8982,23909,32891
70,70429,2012-12-31,9151,24215,33366
70,70429,2013-12-31,9310,24519,33829
70,70429,2014-12-31,9468,24827,34295
70,70429,2015-12-31,9609,25142,34751
70,70429,2016-12-31,9811,25488,35299
70,70429,2017-12-31,10016,25916,35932
70,70429,2018-12-31,10205,26445,36650
70,70429,2019-12-31,10558,27006,37564
70,70429,2020-12-31,10859,27447,38306
70,70429,2021-12-31,10778,28056,38834
70,70429,2022-12-31,10663,28570,39233
70,70429,2023-12-31,10545,29066,39611
70,70429,2024-12-31,10568,29561,40129
70,70429,2025-12-31,10615,30017,40632
70,70429,2026-12-31,10664,30462,41126
70,70429,2027-12-31,10718,30891,41609
70,70429,2028-12-31,10776,31298,42074
70,70429,2029-12-31,10832,31702,42534
70,70429,2030-12-31,10897,32074,42971
70,70429,2031-12-31,10953,32442,43395
70,70429,2032-12-31,11006,32797,43803
70,70429,2033-12-31,11056,33160,44216
70,70429,2034-12-31,11105,33516,44621
70,70429,2035-12-31,11145,33848,44993
70,70473,1985-12-31,3557,6443,10000
70,70473,1986-12-31,3830,6185,10015
70,70473,1987-12-31,4082,5978,10060
70,70473,1988-12-31,4319,5839,10158
70,70473,1989-12-31,4560,5702,10262
70,70473,1990-12-31,4774,5630,10404
70,70473,1991-12-31,4965,5548,10513
70,70473,1992-12-31,5197,5488,10685
70,70473,1993-12-31,5391,5453,10844
70,70473,1994-12-31,5588,5421,11009
70,70473,1995-12-31,5732,5391,11123
70,70473,1996-12-31,5898,5350,11248
70,70473,1997-12-31,6058,5335,11393
70,70473,1998-12-31,6156,5346,11502
70,70473,1999-12-31,6315,5363,11678
70,70473,2000-12-31,6482,5390,11872
70,70473,2001-12-31,6637,5408,12045
70,70473,2002-12-31,6728,5482,12210
70,70473,2003-12-31,6911,5498,12409
70,70473,2004-12-31,7048,5522,12570
70,70473,2005-12-31,7193,5565,12758
70,70473,2006-12-31,7322,5602,12924
70,70473,2007-12-31,7459,5634,13093
70,70473,2008-12-31,7613,5657,13270
70,70473,2009-12-31,7739,5691,13430
70,70473,2010-12-31,7867,5745,13612
70,70473,2011-12-31,8012,5773,13785
70,70473,2012-12-31,8078,5786,13864
70,70473,2013-12-31,8250,5839,14089
70,70473,2014-12-31,8388,5823,14211
70,70473,2015-12-31,8486,5852,14338
70,70473,2016-12-31,8658,5908,14566
70,70473,2017-12-31,8829,5932,14761
70,70473,2018-12-31,9031,6030,15061
70,70473,2019-12-31,9294,6201,15495
70,70473,2020-12-31,9491,6367,15858
70,70473,2021-12-31,9572,6508,16080
70,70473,2022-12-31,9618,6627,16245
70,70473,2023-12-31,9660,6742,16402
70,70473,2024-12-31,9703,6856,16559
70,70473,2025-12-31,9751,6955,16706
70,70473,2026-12-31,9805,7072,16877
70,70473,2027-12-31,9858,7159,17017
70,70473,2028-12-31,9908,7257,17165
70,70473,2029-12-31,9955,7350,17305
70,70473,2030-12-31,10003,7436,17439
70,70473,2031-12-31,10061,7520,17581
70,70473,2032-12-31,10121,7611,17732
70,70473,2033-12-31,10152,7693,17845
70,70473,2034-12-31,10205,7767,17972
70,70473,2035-12-31,10239,7850,18089
70,70508,1985-12-31,9215,13993,23208
70,70508,1986-12-31,9531,13391,22922
70,70508,1987-12-31,9797,12913,22710
70,70508,1988-12-31,10002,12514,22516
70,70508,1989-12-31,10181,12192,22373
70,70508,1990-12-31,10303,11948,22251
70,70508,1991-12-31,10429,11758,22187
70,70508,1992-12-31,10525,11609,22134
70,70508,1993-12-31,10608,11458,22066
70,70508,1994-12-31,10676,11357,22033
70,70508,1995-12-31,10743,11249,21992
70,70508,1996-12-31,10788,11137,21925
70,70508,1997-12-31,10834,11071,21905
70,70508,1998-12-31,10759,11024,21783
70,70508,1999-12-31,10779,11046,21825
70,70508,2000-12-31,10823,11026,21849
70,70508,2001-12-31,10870,11029,21899
70,70508,2002-12-31,10805,11161,21966
70,70508,2003-12-31,10880,11111,21991
70,70508,2004-12-31,10908,11144,22052
70,70508,2005-12-31,10929,11139,22068
70,70508,2006-12-31,10946,11170,22116
70,70508,2007-12-31,10977,11198,22175
70,70508,2008-12-31,10996,11208,22204
70,70508,2009-12-31,11041,11231,22272
70,70508,2010-12-31,11062,11252,22314
70,70508,2011-12-31,11096,11274,22370
70,70508,2012-12-31,11095,11259,22354
70,70508,2013-12-31,11076,11278,22354
70,70508,2014-12-31,11177,11291,22468
70,70508,2015-12-31,11165,11277,22442
70,70508,2016-12-31,11246,11308,22554
70,70508,2017-12-31,11316,11361,22677
70,70508,2018-12-31,11409,11462,22871
70,70508,2019-12-31,11553,11595,23148
70,70508,2020-12-31,11671,11765,23436
70,70508,2021-12-31,11733,12026,23759
70,70508,2022-12-31,11757,12246,24003
70,70508,2023-12-31,11776,12459,24235
70,70508,2024-12-31,11812,12662,24474
70,70508,2025-12-31,11845,12849,24694
70,70508,2026-12-31,11881,13049,24930
70,70508,2027-12-31,11932,13236,25168
70,70508,2028-12-31,11985,13407,25392
70,70508,2029-12-31,12041,13577,25618
70,70508,2030-12-31,12101,13730,25831
70,70508,2031-12-31,12158,13904,26062
70,70508,2032-12-31,12208,14046,26254
70,70508,2033-12-31,12265,14199,26464
70,70508,2034-12-31,12312,14359,26671
70,70508,2035-12-31,12356,14499,26855
70,70523,1985-12-31,2602,2533,5135
70,70523,1986-12-31,2750,2618,5368
70,70523,1987-12-31,2890,2763,5653
70,70523,1988-12-31,3008,2886,5894
70,70523,1989-12-31,3031,3021,6052
70,70523,1990-12-31,3148,3145,6293
70,70523,1991-12-31,3266,3313,6579
70,70523,1992-12-31,3352,3455,6807
70,70523,1993-12-31,3422,3607,7029
70,70523,1994-12-31,3525,3789,7314
70,70523,1995-12-31,3636,3952,7588
70,70523,1996-12-31,3664,4119,7783
70,70523,1997-12-31,3731,4285,8016
70,70523,1998-12-31,3764,4459,8223
70,70523,1999-12-31,3832,4682,8514
70,70523,2000-12-31,3881,4887,8768
70,70523,2001-12-31,3940,5086,9026
70,70523,2002-12-31,3988,5357,9345
70,70523,2003-12-31,4062,5552,9614
70,70523,2004-12-31,4130,5747,9877
70,70523,2005-12-31,4170,5996,10166
70,70523,2006-12-31,4213,6214,10427
70,70523,2007-12-31,4252,6451,10703
70,70523,2008-12-31,4309,6676,10985
70,70523,2009-12-31,4371,6925,11296
70,70523,2010-12-31,4408,7159,11567
70,70523,2011-12-31,4491,7389,11880
70,70523,2012-12-31,4527,7626,12153
70,70523,2013-12-31,4589,7866,12455
70,70523,2014-12-31,4603,8114,12717
70,70523,2015-12-31,4726,8358,13084
70,70523,2016-12-31,4769,8640,13409
70,70523,2017-12-31,4824,8934,13758
70,70523,2018-12-31,4905,9209,14114
70,70523,2019-12-31,5026,9609,14635
70,70523,2020-12-31,5125,9931,15056
70,70523,2021-12-31,5114,10153,15267
70,70523,2022-12-31,5084,10339,15423
70,70523,2023-12-31,5053,10519,15572
70,70523,2024-12-31,5066,10669,15735
70,70523,2025-12-31,5082,10870,15952
70,70523,2026-12-31,5110,11017,16127
70,70523,2027-12-31,5132,11191,16323
70,70523,2028-12-31,5158,11324,16482
70,70523,2029-12-31,5193,11460,16653
70,70523,2030-12-31,5219,11590,16809
70,70523,2031-12-31,5240,11720,16960
70,70523,2032-12-31,5272,11862,17134
70,70523,2033-12-31,5295,11982,17277
70,70523,2034-12-31,5319,12108,17427
70,70523,2035-12-31,5350,12246,17596
70,70670,1985-12-31,11226,11152,22378
70,70670,1986-12-31,11928,11074,23002
70,70670,1987-12-31,12585,11087,23672
70,70670,1988-12-31,13195,11161,24356
70,70670,1989-12-31,13685,11281,24966
70,70670,1990-12-31,14200,11456,25656
70,70670,1991-12-31,14692,11658,26350
70,70670,1992-12-31,15136,11889,27025
70,70670,1993-12-31,15564,12145,27709
70,70670,1994-12-31,15969,12406,28375
70,70670,1995-12-31,16359,12686,29045
70,70670,1996-12-31,16754,12969,29723
70,70670,1997-12-31,17106,13254,30360
70,70670,1998-12-31,17277,13576,30853
70,70670,1999-12-31,17609,14006,31615
70,70670,2000-12-31,17915,14385,32300
70,70670,2001-12-31,18273,14785,33058
70,70670,2002-12-31,18465,15358,33823
70,70670,2003-12-31,18851,15691,34542
70,70670,2004-12-31,19173,16142,35315
70,70670,2005-12-31,19455,16595,36050
70,70670,2006-12-31,19735,17041,36776
70,70670,2007-12-31,20038,17502,37540
70,70670,2008-12-31,20346,17961,38307
70,70670,2009-12-31,20625,18439,39064
70,70670,2010-12-31,20909,18889,39798
70,70670,2011-12-31,21201,19360,40561
70,70670,2012-12-31,21481,19822,41303
70,70670,2013-12-31,21752,20301,42053
70,70670,2014-12-31,22029,20788,42817
70,70670,2015-12-31,22310,21246,43556
70,70670,2016-12-31,22598,21762,44360
70,70670,2017-12-31,22950,22312,45262
70,70670,2018-12-31,23452,23003,46455
70,70670,2019-12-31,24051,23695,47746
70,70670,2020-12-31,24511,24308,48819
70,70670,2021-12-31,24654,24847,49501
70,70670,2022-12-31,24708,25302,50010
70,70670,2023-12-31,24752,25741,50493
70,70670,2024-12-31,24853,26164,51017
70,70670,2025-12-31,24976,26569,51545
70,70670,2026-12-31,25096,26965,52061
70,70670,2027-12-31,25239,27347,52586
70,70670,2028-12-31,25358,27717,53075
70,70670,2029-12-31,25493,28057,53550
70,70670,2030-12-31,25636,28398,54034
70,70670,2031-12-31,25783,28722,54505
70,70670,2032-12-31,25908,29045,54953
70,70670,2033-12-31,26021,29364,55385
70,70670,2034-12-31,26123,29676,55799
70,70670,2035-12-31,26225,29987,56212
70,70678,1985-12-31,3503,17016,20519
70,70678,1986-12-31,3666,16731,20397
70,70678,1987-12-31,3824,16580,20404
70,70678,1988-12-31,3953,16517,20470
70,70678,1989-12-31,4095,16556,20651
70,70678,1990-12-31,4198,16648,20846
70,70678,1991-12-31,4314,16785,21099
70,70678,1992-12-31,4402,17006,21408
70,70678,1993-12-31,4499,17238,21737
70,70678,1994-12-31,4577,17485,22062
70,70678,1995-12-31,4647,17745,22392
70,70678,1996-12-31,4707,18036,22743
70,70678,1997-12-31,4774,18325,23099
70,70678,1998-12-31,4809,20340,25149
70,70678,1999-12-31,4850,20466,25316
70,70678,2000-12-31,4917,20514,25431
70,70678,2001-12-31,4977,20573,25550
70,70678,2002-12-31,5015,20892,25907
70,70678,2003-12-31,5088,20860,25948
70,70678,2004-12-31,5141,21001,26142
70,70678,2005-12-31,5199,21079,26278
70,70678,2006-12-31,5267,21194,26461
70,70678,2007-12-31,5310,21318,26628
70,70678,2008-12-31,5349,21422,26771
70,70678,2009-12-31,5421,21527,26948
70,70678,2010-12-31,5463,21639,27102
70,70678,2011-12-31,5535,21737,27272
70,70678,2012-12-31,5596,21838,27434
70,70678,2013-12-31,5606,21931,27537
70,70678,2014-12-31,5654,22024,27678
70,70678,2015-12-31,5747,22123,27870
70,70678,2016-12-31,5814,22247,28061
70,70678,2017-12-31,5866,22419,28285
70,70678,2018-12-31,5966,22707,28673
70,70678,2019-12-31,6092,23190,29282
70,70678,2020-12-31,6191,23583,29774
70,70678,2021-12-31,6078,24106,30184
70,70678,2022-12-31,5948,24547,30495
70,70678,2023-12-31,5815,24974,30789
70,70678,2024-12-31,5774,25404,31178
70,70678,2025-12-31,5785,25805,31590
70,70678,2026-12-31,5815,26174,31989
70,70678,2027-12-31,5849,26549,32398
70,70678,2028-12-31,5879,26903,32782
70,70678,2029-12-31,5894,27233,33127
70,70678,2030-12-31,5939,27566,33505
70,70678,2031-12-31,5968,27879,33847
70,70678,2032-12-31,5988,28199,34187
70,70678,2033-12-31,6027,28498,34525
70,70678,2034-12-31,6051,28796,34847
70,70678,2035-12-31,6077,29100,35177
70,70702,1985-12-31,4606,4914,9520
70,70702,1986-12-31,4794,4784,9578
70,70702,1987-12-31,4975,4720,9695
70,70702,1988-12-31,5128,4628,9756
70,70702,1989-12-31,5254,4587,9841
70,70702,1990-12-31,5358,4572,9930
70,70702,1991-12-31,5463,4570,10033
70,70702,1992-12-31,5560,4580,10140
70,70702,1993-12-31,5633,4603,10236
70,70702,1994-12-31,5710,4626,10336
70,70702,1995-12-31,5793,4663,10456
70,70702,1996-12-31,5848,4696,10544
70,70702,1997-12-31,5903,4730,10633
70,70702,1998-12-31,5892,4758,10650
70,70702,1999-12-31,5951,4857,10808
70,70702,2000-12-31,6015,4919,10934
70,70702,2001-12-31,6065,4980,11045
70,70702,2002-12-31,6061,5142,11203
70,70702,2003-12-31,6147,5183,11330
70,70702,2004-12-31,6204,5267,11471
70,70702,2005-12-31,6235,5372,11607
70,70702,2006-12-31,6290,5450,11740
70,70702,2007-12-31,6342,5549,11891
70,70702,2008-12-31,6371,5660,12031
70,70702,2009-12-31,6438,5726,12164
70,70702,2010-12-31,6453,5835,12288
70,70702,2011-12-31,6480,5902,12382
70,70702,2012-12-31,6597,6045,12642
70,70702,2013-12-31,6647,6100,12747
70,70702,2014-12-31,6591,6152,12743
70,70702,2015-12-31,6648,6225,12873
70,70702,2016-12-31,6703,6336,13039
70,70702,2017-12-31,6784,6410,13194
70,70702,2018-12-31,6907,6628,13535
70,70702,2019-12-31,7024,6868,13892
70,70702,2020-12-31,7119,7072,14191
70,70702,2021-12-31,7156,7231,14387
70,70702,2022-12-31,7169,7365,14534
70,70702,2023-12-31,7182,7493,14675
70,70702,2024-12-31,7201,7607,14808
70,70702,2025-12-31,7204,7733,14937
70,70702,2026-12-31,7225,7842,15067
70,70702,2027-12-31,7247,7954,15201
70,70702,2028-12-31,7255,8061,15316
70,70702,2029-12-31,7281,8160,15441
70,70702,2030-12-31,7304,8256,15560
70,70702,2031-12-31,7332,8347,15679
70,70702,2032-12-31,7355,8437,15792
70,70702,2033-12-31,7366,8536,15902
70,70702,2034-12-31,7388,8627,16015
70,70702,2035-12-31,7405,8723,16128
70,70708,1985-12-31,20437,14915,35352
70,70708,1986-12-31,21361,14676,36037
70,70708,1987-12-31,22160,14535,36695
70,70708,1988-12-31,22879,14465,37344
70,70708,1989-12-31,23513,14486,37999
70,70708,1990-12-31,24067,14570,38637
70,70708,1991-12-31,24587,14703,39290
70,70708,1992-12-31,25055,14877,39932
70,70708,1993-12-31,25473,15063,40536
70,70708,1994-12-31,25853,15278,41131
70,70708,1995-12-31,26214,15507,41721
70,70708,1996-12-31,26551,15753,42304
70,70708,1997-12-31,26879,15999,42878
70,70708,1998-12-31,26906,16287,43193
70,70708,1999-12-31,27148,16709,43857
70,70708,2000-12-31,27473,17071,44544
70,70708,2001-12-31,27774,17439,45213
70,70708,2002-12-31,27827,18038,45865
70,70708,2003-12-31,28219,18342,46561
70,70708,2004-12-31,28482,18779,47261
70,70708,2005-12-31,28709,19215,47924
70,70708,2006-12-31,28956,19658,48614
70,70708,2007-12-31,29218,20090,49308
70,70708,2008-12-31,29462,20537,49999
70,70708,2009-12-31,29702,20976,50678
70,70708,2010-12-31,29943,21427,51370
70,70708,2011-12-31,30186,21871,52057
70,70708,2012-12-31,30417,22322,52739
70,70708,2013-12-31,30673,22763,53436
70,70708,2014-12-31,30904,23218,54122
70,70708,2015-12-31,31147,23679,54826
70,70708,2016-12-31,31358,24148,55506
70,70708,2017-12-31,31734,24737,56471
70,70708,2018-12-31,32275,25397,57672
70,70708,2019-12-31,32884,26370,59254
70,70708,2020-12-31,33366,27200,60566
70,70708,2021-12-31,33603,27809,61412
70,70708,2022-12-31,33726,28318,62044
70,70708,2023-12-31,33832,28810,62642
70,70708,2024-12-31,33943,29282,63225
70,70708,2025-12-31,34068,29746,63814
70,70708,2026-12-31,34188,30200,64388
70,70708,2027-12-31,34317,30622,64939
70,70708,2028-12-31,34455,31033,65488
70,70708,2029-12-31,34628,31418,66046
70,70708,2030-12-31,34781,31791,66572
70,70708,2031-12-31,34934,32169,67103
70,70708,2032-12-31,35074,32523,67597
70,70708,2033-12-31,35214,32878,68092
70,70708,2034-12-31,35337,33218,68555
70,70708,2035-12-31,35458,33573,69031
70,70713,1985-12-31,11730,35188,46918
70,70713,1986-12-31,12276,33700,45976
70,70713,1987-12-31,12756,32488,45244
70,70713,1988-12-31,13192,31589,44781
70,70713,1989-12-31,13576,30846,44422
70,70713,1990-12-31,13919,30255,44174
70,70713,1991-12-31,14231,29823,44054
70,70713,1992-12-31,14520,29472,43992
70,70713,1993-12-31,14777,29197,43974
70,70713,1994-12-31,15010,28942,43952
70,70713,1995-12-31,15232,28735,43967
70,70713,1996-12-31,15437,28553,43990
70,70713,1997-12-31,15626,28389,44015
70,70713,1998-12-31,15654,28317,43971
70,70713,1999-12-31,15811,28446,44257
70,70713,2000-12-31,16011,28464,44475
70,70713,2001-12-31,16208,28504,44712
70,70713,2002-12-31,16228,28917,45145
70,70713,2003-12-31,16480,28830,45310
70,70713,2004-12-31,16652,28953,45605
70,70713,2005-12-31,16795,29061,45856
70,70713,2006-12-31,16959,29171,46130
70,70713,2007-12-31,17110,29283,46393
70,70713,2008-12-31,17270,29379,46649
70,70713,2009-12-31,17420,29481,46901
70,70713,2010-12-31,17565,29578,47143
70,70713,2011-12-31,17705,29662,47367
70,70713,2012-12-31,17855,29738,47593
70,70713,2013-12-31,18010,29826,47836
70,70713,2014-12-31,18168,29906,48074
70,70713,2015-12-31,18304,29990,48294
70,70713,2016-12-31,18499,30111,48610
70,70713,2017-12-31,18648,30303,48951
70,70713,2018-12-31,19008,30625,49633
70,70713,2019-12-31,19408,31015,50423
70,70713,2020-12-31,19722,31387,51109
70,70713,2021-12-31,19730,32083,51813
70,70713,2022-12-31,19675,32671,52346
70,70713,2023-12-31,19613,33238,52851
70,70713,2024-12-31,19635,33777,53412
70,70713,2025-12-31,19712,34316,54028
70,70713,2026-12-31,19817,34810,54627
70,70713,2027-12-31,19902,35300,55202
70,70713,2028-12-31,20016,35783,55799
70,70713,2029-12-31,20103,36226,56329
70,70713,2030-12-31,20210,36646,56856
70,70713,2031-12-31,20333,37057,57390
70,70713,2032-12-31,20441,37485,57926
70,70713,2033-12-31,20530,37876,58406
70,70713,2034-12-31,20613,38291,58904
70,70713,2035-12-31,20693,38668,59361
70,70717,1985-12-31,10404,6262,16666
70,70717,1986-12-31,10736,6034,16770
70,70717,1987-12-31,11004,5836,16840
70,70717,1988-12-31,11235,5723,16958
70,70717,1989-12-31,11381,5595,16976
70,70717,1990-12-31,11516,5527,17043
70,70717,1991-12-31,11625,5480,17105
70,70717,1992-12-31,11708,5440,17148
70,70717,1993-12-31,11783,5403,17186
70,70717,1994-12-31,11835,5395,17230
70,70717,1995-12-31,11874,5377,17251
70,70717,1996-12-31,11915,5360,17275
70,70717,1997-12-31,11957,5361,17318
70,70717,1998-12-31,11869,5370,17239
70,70717,1999-12-31,11861,5417,17278
70,70717,2000-12-31,11888,5450,17338
70,70717,2001-12-31,11901,5470,17371
70,70717,2002-12-31,11819,5584,17403
70,70717,2003-12-31,11885,5591,17476
70,70717,2004-12-31,11901,5641,17542
70,70717,2005-12-31,11903,5689,17592
70,70717,2006-12-31,11900,5737,17637
70,70717,2007-12-31,11906,5793,17699
70,70717,2008-12-31,11923,5828,17751
70,70717,2009-12-31,11925,5892,17817
70,70717,2010-12-31,11929,5930,17859
70,70717,2011-12-31,11959,5971,17930
70,70717,2012-12-31,11957,6008,17965
70,70717,2013-12-31,11976,6081,18057
70,70717,2014-12-31,12027,6112,18139
70,70717,2015-12-31,11969,6160,18129
70,70717,2016-12-31,12049,6223,18272
70,70717,2017-12-31,12089,6293,18382
70,70717,2018-12-31,12204,6386,18590
70,70717,2019-12-31,12323,6597,18920
70,70717,2020-12-31,12417,6793,19210
70,70717,2021-12-31,12531,6944,19475
70,70717,2022-12-31,12604,7071,19675
70,70717,2023-12-31,12671,7194,19865
70,70717,2024-12-31,12730,7313,20043
70,70717,2025-12-31,12782,7409,20191
70,70717,2026-12-31,12837,7525,20362
70,70717,2027-12-31,12915,7629,20544
70,70717,2028-12-31,12980,7735,20715
70,70717,2029-12-31,13042,7826,20868
70,70717,2030-12-31,13119,7916,21035
70,70717,2031-12-31,13189,8012,21201
70,70717,2032-12-31,13248,8091,21339
70,70717,2033-12-31,13327,8174,21501
70,70717,2034-12-31,13378,8261,21639
70,70717,2035-12-31,13442,8357,21799
70,70742,1985-12-31,17782,8539,26321
70,70742,1986-12-31,18418,8679,27097
70,70742,1987-12-31,18937,8862,27799
70,70742,1988-12-31,19367,9129,28496
70,70742,1989-12-31,19725,9400,29125
70,70742,1990-12-31,20017,9706,29723
70,70742,1991-12-31,20258,10026,30284
70,70742,1992-12-31,20482,10376,30858
70,70742,1993-12-31,20665,10732,31397
70,70742,1994-12-31,20812,11103,31915
70,70742,1995-12-31,20954,11488,32442
70,70742,1996-12-31,21067,11886,32953
70,70742,1997-12-31,21175,12274,33449
70,70742,1998-12-31,21057,10854,31911
70,70742,1999-12-31,21107,10744,31851
70,70742,2000-12-31,21221,10577,31798
70,70742,2001-12-31,21320,10425,31745
70,70742,2002-12-31,21218,10419,31637
70,70742,2003-12-31,21389,10217,31606
70,70742,2004-12-31,21462,10098,31560
70,70742,2005-12-31,21514,9944,31458
70,70742,2006-12-31,21581,9814,31395
70,70742,2007-12-31,21638,9668,31306
70,70742,2008-12-31,21705,9554,31259
70,70742,2009-12-31,21792,9396,31188
70,70742,2010-12-31,21852,9258,31110
70,70742,2011-12-31,21907,9107,31014
70,70742,2012-12-31,21978,8956,30934
70,70742,2013-12-31,21986,8803,30789
70,70742,2014-12-31,22093,8632,30725
70,70742,2015-12-31,22134,8490,30624
70,70742,2016-12-31,22272,8330,30602
70,70742,2017-12-31,22340,8175,30515
70,70742,2018-12-31,22672,8101,30773
70,70742,2019-12-31,22923,8442,31365
70,70742,2020-12-31,23146,8757,31903
70,70742,2021-12-31,23390,8953,32343
70,70742,2022-12-31,23558,9117,32675
70,70742,2023-12-31,23715,9275,32990
70,70742,2024-12-31,23824,9432,33256
70,70742,2025-12-31,23931,9585,33516
70,70742,2026-12-31,24059,9733,33792
70,70742,2027-12-31,24168,9872,34040
70,70742,2028-12-31,24311,9999,34310
70,70742,2029-12-31,24439,10124,34563
70,70742,2030-12-31,24570,10244,34814
70,70742,2031-12-31,24676,10364,35040
70,70742,2032-12-31,24792,10483,35275
70,70742,2033-12-31,24927,10594,35521
70,70742,2034-12-31,25043,10703,35746
70,70742,2035-12-31,25143,10809,35952
70,70771,1985-12-31,3806,18227,22033
70,70771,1986-12-31,4029,17673,21702
70,70771,1987-12-31,4209,17216,21425
70,70771,1988-12-31,4387,16914,21301
70,70771,1989-12-31,4533,16710,21243
70,70771,1990-12-31,4692,16592,21284
70,70771,1991-12-31,4814,16519,21333
70,70771,1992-12-31,4943,16515,21458
70,70771,1993-12-31,5068,16519,21587
70,70771,1994-12-31,5181,16574,21755
70,70771,1995-12-31,5288,16640,21928
70,70771,1996-12-31,5394,16706,22100
70,70771,1997-12-31,5485,16767,22252
70,70771,1998-12-31,5525,16903,22428
70,70771,1999-12-31,5612,17156,22768
70,70771,2000-12-31,5709,17357,23066
70,70771,2001-12-31,5800,17554,23354
70,70771,2002-12-31,5842,17992,23834
70,70771,2003-12-31,5961,18130,24091
70,70771,2004-12-31,6062,18394,24456
70,70771,2005-12-31,6115,18642,24757
70,70771,2006-12-31,6170,18914,25084
70,70771,2007-12-31,6284,19171,25455
70,70771,2008-12-31,6324,19437,25761
70,70771,2009-12-31,6428,19696,26124
70,70771,2010-12-31,6533,19951,26484
70,70771,2011-12-31,6585,20220,26805
70,70771,2012-12-31,6679,20474,27153
70,70771,2013-12-31,6760,20729,27489
70,70771,2014-12-31,6761,20976,27737
70,70771,2015-12-31,6863,21256,28119
70,70771,2016-12-31,6951,21554,28505
70,70771,2017-12-31,7059,21896,28955
70,70771,2018-12-31,7205,22347,29552
70,70771,2019-12-31,7261,22992,30253
70,70771,2020-12-31,7293,23521,30814
70,70771,2021-12-31,7196,24043,31239
70,70771,2022-12-31,7077,24483,31560
70,70771,2023-12-31,6956,24908,31864
70,70771,2024-12-31,6866,25316,32182
70,70771,2025-12-31,6803,25712,32515
70,70771,2026-12-31,6770,26086,32856
70,70771,2027-12-31,6769,26453,33222
70,70771,2028-12-31,6764,26801,33565
70,70771,2029-12-31,6794,27133,33927
70,70771,2030-12-31,6820,27456,34276
70,70771,2031-12-31,6859,27766,34625
70,70771,2032-12-31,6899,28072,34971
70,70771,2033-12-31,6903,28377,35280
70,70771,2034-12-31,6925,28673,35598
70,70771,2035-12-31,6958,28959,35917
70,70820,1985-12-31,14489,11387,25876
70,70820,1986-12-31,15258,11774,27032
70,70820,1987-12-31,15958,12174,28132
70,70820,1988-12-31,16593,12627,29220
70,70820,1989-12-31,17168,13135,30303
70,70820,1990-12-31,17689,13676,31365
70,70820,1991-12-31,18164,14243,32407
70,70820,1992-12-31,18611,14848,33459
70,70820,1993-12-31,19034,15476,34510
70,70820,1994-12-31,19425,16111,35536
70,70820,1995-12-31,19799,16759,36558
70,70820,1996-12-31,20152,17411,37563
70,70820,1997-12-31,20487,18075,38562
70,70820,1998-12-31,20623,18774,39397
70,70820,1999-12-31,20906,19638,40544
70,70820,2000-12-31,21232,20419,41651
70,70820,2001-12-31,21567,21210,42777
70,70820,2002-12-31,21680,8089,29769
70,70820,2003-12-31,22062,7953,30015
70,70820,2004-12-31,22359,7859,30218
70,70820,2005-12-31,22619,7764,30383
70,70820,2006-12-31,22899,7681,30580
70,70820,2007-12-31,23167,7584,30751
70,70820,2008-12-31,23443,7507,30950
70,70820,2009-12-31,23710,7415,31125
70,70820,2010-12-31,23975,7316,31291
70,70820,2011-12-31,24242,7210,31452
70,70820,2012-12-31,24490,7110,31600
70,70820,2013-12-31,24774,6994,31768
70,70820,2014-12-31,25033,6887,31920
70,70820,2015-12-31,25328,6791,32119
70,70820,2016-12-31,25500,6665,32165
70,70820,2017-12-31,25896,6586,32482
70,70820,2018-12-31,26401,6521,32922
70,70820,2019-12-31,26982,6571,33553
70,70820,2020-12-31,27435,6682,34117
70,70820,2021-12-31,27757,6830,34587
70,70820,2022-12-31,27988,6955,34943
70,70820,2023-12-31,28204,7076,35280
70,70820,2024-12-31,28374,7200,35574
70,70820,2025-12-31,28522,7311,35833
70,70820,2026-12-31,28670,7413,36083
70,70820,2027-12-31,28814,7526,36340
70,70820,2028-12-31,28952,7623,36575
70,70820,2029-12-31,29107,7717,36824
70,70820,2030-12-31,29275,7818,37093
70,70820,2031-12-31,29424,7914,37338
70,70820,2032-12-31,29577,7988,37565
70,70820,2033-12-31,29725,8070,37795
70,70820,2034-12-31,29844,8149,37993
70,70820,2035-12-31,29957,8245,38202
70,70823,1985-12-31,3832,12095,15927
70,70823,1986-12-31,4036,11716,15752
70,70823,1987-12-31,4211,11432,15643
70,70823,1988-12-31,4358,11215,15573
70,70823,1989-12-31,4499,11093,15592
70,70823,1990-12-31,4612,11011,15623
70,70823,1991-12-31,4723,10962,15685
70,70823,1992-12-31,4818,10960,15778
70,70823,1993-12-31,4935,10965,15900
70,70823,1994-12-31,5024,10989,16013
70,70823,1995-12-31,5105,11031,16136
70,70823,1996-12-31,5180,11077,16257
70,70823,1997-12-31,5242,11135,16377
70,70823,1998-12-31,5267,11198,16465
70,70823,1999-12-31,5327,11365,16692
70,70823,2000-12-31,5410,11494,16904
70,70823,2001-12-31,5460,11630,17090
70,70823,2002-12-31,5467,11923,17390
70,70823,2003-12-31,5589,12009,17598
70,70823,2004-12-31,5624,12180,17804
70,70823,2005-12-31,5678,12357,18035
70,70823,2006-12-31,5772,12527,18299
70,70823,2007-12-31,5780,12700,18480
70,70823,2008-12-31,5857,12876,18733
70,70823,2009-12-31,5931,13060,18991
70,70823,2010-12-31,5999,13197,19196
70,70823,2011-12-31,6046,13392,19438
70,70823,2012-12-31,6114,13550,19664
70,70823,2013-12-31,6171,13729,19900
70,70823,2014-12-31,6168,13904,20072
70,70823,2015-12-31,6245,14066,20311
70,70823,2016-12-31,6324,14280,20604
70,70823,2017-12-31,6412,14488,20900
70,70823,2018-12-31,6545,14794,21339
70,70823,2019-12-31,6673,15177,21850
70,70823,2020-12-31,6771,15518,22289
70,70823,2021-12-31,6734,15862,22596
70,70823,2022-12-31,6675,16153,22828
70,70823,2023-12-31,6616,16433,23049
70,70823,2024-12-31,6610,16709,23319
70,70823,2025-12-31,6632,16976,23608
70,70823,2026-12-31,6661,17235,23896
70,70823,2027-12-31,6693,17471,24164
70,70823,2028-12-31,6726,17700,24426
70,70823,2029-12-31,6770,17929,24699
70,70823,2030-12-31,6805,18146,24951
70,70823,2031-12-31,6840,18349,25189
70,70823,2032-12-31,6878,18560,25438
70,70823,2033-12-31,6909,18765,25674
70,70823,2034-12-31,6951,18971,25922
70,70823,2035-12-31,6973,19154,26127
73,73001,1985-12-31,296422,27052,323474
73,73001,1986-12-31,305454,27237,332691
73,73001,1987-12-31,314362,27417,341779
73,73001,1988-12-31,323150,27593,350743
73,73001,1989-12-31,331742,27772,359514
73,73001,1990-12-31,340251,27974,368225
73,73001,1991-12-31,348605,28167,376772
73,73001,1992-12-31,356816,28365,385181
73,73001,1993-12-31,364519,28553,393072
73,73001,1994-12-31,372457,28779,401236
73,73001,1995-12-31,380141,29017,409158
73,73001,1996-12-31,387663,29240,416903
73,73001,1997-12-31,393232,29580,422812
73,73001,1998-12-31,400291,29867,430158
73,73001,1999-12-31,407082,30163,437245
73,73001,2000-12-31,413798,30468,444266
73,73001,2001-12-31,420142,30781,450923
73,73001,2002-12-31,426113,30998,457111
73,73001,2003-12-31,431825,31314,463139
73,73001,2004-12-31,436989,31643,468632
73,73001,2005-12-31,441279,31941,473220
73,73001,2006-12-31,446001,32254,478255
73,73001,2007-12-31,450335,32560,482895
73,73001,2008-12-31,454625,32886,487511
73,73001,2009-12-31,458774,33239,492013
73,73001,2010-12-31,462824,33604,496428
73,73001,2011-12-31,466791,33963,500754
73,73001,2012-12-31,470504,34339,504843
73,73001,2013-12-31,474124,34746,508870
73,73001,2014-12-31,477595,35154,512749
73,73001,2015-12-31,481134,35625,516759
73,73001,2016-12-31,484809,36047,520856
73,73001,2017-12-31,488538,36538,525076
73,73001,2018-12-31,492554,37081,529635
73,73001,2019-12-31,497603,38484,536087
73,73001,2020-12-31,501991,39110,541101
73,73001,2021-12-31,503745,38979,542724
73,73001,2022-12-31,505107,38842,543949
73,73001,2023-12-31,506505,38705,545210
73,73001,2024-12-31,508667,38587,547254
73,73001,2025-12-31,510923,38509,549432
73,73001,2026-12-31,513088,38449,551537
73,73001,2027-12-31,515100,38413,553513
73,73001,2028-12-31,516938,38402,555340
73,73001,2029-12-31,518524,38408,556932
73,73001,2030-12-31,519952,38447,558399
73,73001,2031-12-31,521210,38485,559695
73,73001,2032-12-31,522309,38507,560816
73,73001,2033-12-31,523257,38543,561800
73,73001,2034-12-31,524103,38567,562670
73,73001,2035-12-31,524781,38591,563372
73,73024,1985-12-31,2043,4402,6445
73,73024,1986-12-31,2050,4280,6330
73,73024,1987-12-31,2037,4207,6244
73,73024,1988-12-31,2058,4130,6188
73,73024,1989-12-31,2104,4052,6156
73,73024,1990-12-31,2101,3939,6040
73,73024,1991-12-31,2110,3875,5985
73,73024,1992-12-31,2118,3833,5951
73,73024,1993-12-31,2128,3761,5889
73,73024,1994-12-31,2143,3694,5837
73,73024,1995-12-31,2138,3613,5751
73,73024,1996-12-31,2141,3514,5655
73,73024,1997-12-31,2146,3515,5661
73,73024,1998-12-31,2144,3448,5592
73,73024,1999-12-31,2150,3390,5540
73,73024,2000-12-31,2131,3345,5476
73,73024,2001-12-31,2141,3308,5449
73,73024,2002-12-31,2129,3274,5403
73,73024,2003-12-31,2106,3231,5337
73,73024,2004-12-31,2096,3194,5290
73,73024,2005-12-31,2125,3138,5263
73,73024,2006-12-31,2091,3086,5177
73,73024,2007-12-31,2074,3047,5121
73,73024,2008-12-31,2060,2996,5056
73,73024,2009-12-31,2074,2987,5061
73,73024,2010-12-31,2081,2892,4973
73,73024,2011-12-31,2031,2823,4854
73,73024,2012-12-31,1998,2778,4776
73,73024,2013-12-31,1975,2737,4712
73,73024,2014-12-31,1954,2690,4644
73,73024,2015-12-31,1952,2630,4582
73,73024,2016-12-31,1959,2599,4558
73,73024,2017-12-31,1975,2560,4535
73,73024,2018-12-31,1991,2553,4544
73,73024,2019-12-31,1999,2494,4493
73,73024,2020-12-31,2004,2454,4458
73,73024,2021-12-31,2025,2445,4470
73,73024,2022-12-31,2044,2437,4481
73,73024,2023-12-31,2063,2428,4491
73,73024,2024-12-31,2069,2420,4489
73,73024,2025-12-31,2080,2413,4493
73,73024,2026-12-31,2096,2401,4497
73,73024,2027-12-31,2097,2403,4500
73,73024,2028-12-31,2101,2405,4506
73,73024,2029-12-31,2118,2405,4523
73,73024,2030-12-31,2128,2410,4538
73,73024,2031-12-31,2133,2406,4539
73,73024,2032-12-31,2131,2411,4542
73,73024,2033-12-31,2136,2407,4543
73,73024,2034-12-31,2136,2410,4546
73,73024,2035-12-31,2140,2412,4552
73,73026,1985-12-31,2159,7467,9626
73,73026,1986-12-31,2227,7379,9606
73,73026,1987-12-31,2285,7251,9536
73,73026,1988-12-31,2357,7151,9508
73,73026,1989-12-31,2415,7053,9468
73,73026,1990-12-31,2456,6956,9412
73,73026,1991-12-31,2498,6862,9360
73,73026,1992-12-31,2541,6758,9299
73,73026,1993-12-31,2574,6665,9239
73,73026,1994-12-31,2625,6602,9227
73,73026,1995-12-31,2651,6531,9182
73,73026,1996-12-31,2697,6458,9155
73,73026,1997-12-31,2723,6418,9141
73,73026,1998-12-31,2771,6330,9101
73,73026,1999-12-31,2812,6274,9086
73,73026,2000-12-31,2847,6188,9035
73,73026,2001-12-31,2872,6175,9047
73,73026,2002-12-31,2896,6147,9043
73,73026,2003-12-31,2925,6128,9053
73,73026,2004-12-31,2980,6054,9034
73,73026,2005-12-31,2972,5976,8948
73,73026,2006-12-31,3007,5911,8918
73,73026,2007-12-31,3041,5889,8930
73,73026,2008-12-31,3058,5819,8877
73,73026,2009-12-31,3055,5732,8787
73,73026,2010-12-31,3083,5658,8741
73,73026,2011-12-31,3123,5646,8769
73,73026,2012-12-31,3146,5613,8759
73,73026,2013-12-31,3155,5589,8744
73,73026,2014-12-31,3170,5549,8719
73,73026,2015-12-31,3198,5526,8724
73,73026,2016-12-31,3208,5506,8714
73,73026,2017-12-31,3222,5478,8700
73,73026,2018-12-31,3236,5461,8697
73,73026,2019-12-31,3270,5440,8710
73,73026,2020-12-31,3299,5416,8715
73,73026,2021-12-31,3342,5397,8739
73,73026,2022-12-31,3381,5378,8759
73,73026,2023-12-31,3420,5359,8779
73,73026,2024-12-31,3442,5345,8787
73,73026,2025-12-31,3461,5327,8788
73,73026,2026-12-31,3474,5322,8796
73,73026,2027-12-31,3490,5320,8810
73,73026,2028-12-31,3499,5314,8813
73,73026,2029-12-31,3504,5310,8814
73,73026,2030-12-31,3516,5304,8820
73,73026,2031-12-31,3521,5317,8838
73,73026,2032-12-31,3523,5338,8861
73,73026,2033-12-31,3544,5321,8865
73,73026,2034-12-31,3544,5331,8875
73,73026,2035-12-31,3541,5338,8879
73,73030,1985-12-31,5726,2952,8678
73,73030,1986-12-31,5776,2874,8650
73,73030,1987-12-31,5806,2818,8624
73,73030,1988-12-31,5845,2738,8583
73,73030,1989-12-31,5852,2683,8535
73,73030,1990-12-31,5873,2608,8481
73,73030,1991-12-31,5899,2554,8453
73,73030,1992-12-31,5911,2511,8422
73,73030,1993-12-31,5904,2442,8346
73,73030,1994-12-31,5917,2373,8290
73,73030,1995-12-31,5905,2299,8204
73,73030,1996-12-31,5929,2265,8194
73,73030,1997-12-31,5896,2241,8137
73,73030,1998-12-31,5880,2192,8072
73,73030,1999-12-31,5869,2124,7993
73,73030,2000-12-31,5873,2101,7974
73,73030,2001-12-31,5859,2066,7925
73,73030,2002-12-31,5844,2040,7884
73,73030,2003-12-31,5816,1972,7788
73,73030,2004-12-31,5788,1913,7701
73,73030,2005-12-31,5754,1914,7668
73,73030,2006-12-31,5735,1871,7606
73,73030,2007-12-31,5620,1802,7422
73,73030,2008-12-31,5662,1789,7451
73,73030,2009-12-31,5610,1754,7364
73,73030,2010-12-31,5562,1712,7274
73,73030,2011-12-31,5484,1671,7155
73,73030,2012-12-31,5441,1641,7082
73,73030,2013-12-31,5378,1613,6991
73,73030,2014-12-31,5372,1573,6945
73,73030,2015-12-31,5366,1524,6890
73,73030,2016-12-31,5298,1429,6727
73,73030,2017-12-31,5249,1406,6655
73,73030,2018-12-31,5261,1396,6657
73,73030,2019-12-31,5217,1379,6596
73,73030,2020-12-31,5197,1364,6561
73,73030,2021-12-31,5220,1359,6579
73,73030,2022-12-31,5240,1354,6594
73,73030,2023-12-31,5260,1350,6610
73,73030,2024-12-31,5286,1344,6630
73,73030,2025-12-31,5311,1341,6652
73,73030,2026-12-31,5334,1340,6674
73,73030,2027-12-31,5363,1343,6706
73,73030,2028-12-31,5369,1336,6705
73,73030,2029-12-31,5394,1336,6730
73,73030,2030-12-31,5400,1332,6732
73,73030,2031-12-31,5415,1333,6748
73,73030,2032-12-31,5420,1338,6758
73,73030,2033-12-31,5436,1345,6781
73,73030,2034-12-31,5442,1342,6784
73,73030,2035-12-31,5448,1341,6789
73,73043,1985-12-31,2400,9026,11426
73,73043,1986-12-31,2359,8963,11322
73,73043,1987-12-31,2363,8893,11256
73,73043,1988-12-31,2332,8837,11169
73,73043,1989-12-31,2321,8792,11113
73,73043,1990-12-31,2299,8751,11050
73,73043,1991-12-31,2294,8709,11003
73,73043,1992-12-31,2273,8664,10937
73,73043,1993-12-31,2243,8622,10865
73,73043,1994-12-31,2218,8597,10815
73,73043,1995-12-31,2197,8548,10745
73,73043,1996-12-31,2185,8524,10709
73,73043,1997-12-31,2119,8523,10642
73,73043,1998-12-31,2091,8532,10623
73,73043,1999-12-31,2115,8521,10636
73,73043,2000-12-31,2061,8505,10566
73,73043,2001-12-31,2035,8497,10532
73,73043,2002-12-31,2015,8505,10520
73,73043,2003-12-31,1979,8518,10497
73,73043,2004-12-31,1939,8507,10446
73,73043,2005-12-31,1928,8488,10416
73,73043,2006-12-31,1857,8463,10320
73,73043,2007-12-31,1855,8472,10327
73,73043,2008-12-31,1823,8476,10299
73,73043,2009-12-31,1742,8483,10225
73,73043,2010-12-31,1675,8489,10164
73,73043,2011-12-31,1646,8510,10156
73,73043,2012-12-31,1610,8515,10125
73,73043,2013-12-31,1572,8543,10115
73,73043,2014-12-31,1535,8566,10101
73,73043,2015-12-31,1495,8566,10061
73,73043,2016-12-31,1477,8611,10088
73,73043,2017-12-31,1467,8684,10151
73,73043,2018-12-31,1469,8748,10217
73,73043,2019-12-31,1445,8665,10110
73,73043,2020-12-31,1432,8574,10006
73,73043,2021-12-31,1491,8543,10034
73,73043,2022-12-31,1543,8514,10057
73,73043,2023-12-31,1596,8484,10080
73,73043,2024-12-31,1599,8456,10055
73,73043,2025-12-31,1611,8432,10043
73,73043,2026-12-31,1618,8415,10033
73,73043,2027-12-31,1623,8410,10033
73,73043,2028-12-31,1632,8414,10046
73,73043,2029-12-31,1639,8419,10058
73,73043,2030-12-31,1645,8416,10061
73,73043,2031-12-31,1645,8419,10064
73,73043,2032-12-31,1649,8434,10083
73,73043,2033-12-31,1652,8461,10113
73,73043,2034-12-31,1654,8452,10106
73,73043,2035-12-31,1656,8455,10111
73,73055,1985-12-31,10164,5560,15724
73,73055,1986-12-31,10138,5444,15582
73,73055,1987-12-31,10161,5379,15540
73,73055,1988-12-31,10156,5331,15487
73,73055,1989-12-31,10162,5254,15416
73,73055,1990-12-31,10163,5203,15366
73,73055,1991-12-31,10162,5147,15309
73,73055,1992-12-31,10141,5112,15253
73,73055,1993-12-31,10123,5040,15163
73,73055,1994-12-31,10078,4995,15073
73,73055,1995-12-31,10055,4963,15018
73,73055,1996-12-31,10020,4929,14949
73,73055,1997-12-31,9925,4870,14795
73,73055,1998-12-31,9884,4829,14713
73,73055,1999-12-31,9838,4808,14646
73,73055,2000-12-31,9778,4799,14577
73,73055,2001-12-31,9718,4782,14500
73,73055,2002-12-31,9647,4769,14416
73,73055,2003-12-31,9580,4753,14333
73,73055,2004-12-31,9496,4733,14229
73,73055,2005-12-31,9392,4725,14117
73,73055,2006-12-31,9298,4680,13978
73,73055,2007-12-31,9213,4647,13860
73,73055,2008-12-31,9124,4619,13743
73,73055,2009-12-31,9006,4610,13616
73,73055,2010-12-31,8920,4600,13520
73,73055,2011-12-31,8810,4596,13406
73,73055,2012-12-31,8740,4575,13315
73,73055,2013-12-31,8646,4538,13184
73,73055,2014-12-31,8528,4517,13045
73,73055,2015-12-31,8433,4519,12952
73,73055,2016-12-31,8423,4517,12940
73,73055,2017-12-31,8186,4521,12707
73,73055,2018-12-31,8184,4512,12696
73,73055,2019-12-31,7845,4490,12335
73,73055,2020-12-31,7573,4465,12038
73,73055,2021-12-31,7623,4449,12072
73,73055,2022-12-31,7665,4434,12099
73,73055,2023-12-31,7709,4418,12127
73,73055,2024-12-31,7751,4405,12156
73,73055,2025-12-31,7792,4405,12197
73,73055,2026-12-31,7829,4384,12213
73,73055,2027-12-31,7861,4378,12239
73,73055,2028-12-31,7898,4371,12269
73,73055,2029-12-31,7920,4389,12309
73,73055,2030-12-31,7937,4379,12316
73,73055,2031-12-31,7962,4394,12356
73,73055,2032-12-31,7960,4396,12356
73,73055,2033-12-31,7988,4394,12382
73,73055,2034-12-31,7998,4394,12392
73,73055,2035-12-31,8007,4400,12407
73,73067,1985-12-31,3649,20458,24107
73,73067,1986-12-31,3707,20151,23858
73,73067,1987-12-31,3791,19848,23639
73,73067,1988-12-31,3828,19562,23390
73,73067,1989-12-31,3910,19269,23179
73,73067,1990-12-31,3983,19009,22992
73,73067,1991-12-31,4031,18751,22782
73,73067,1992-12-31,4088,18488,22576
73,73067,1993-12-31,4146,18223,22369
73,73067,1994-12-31,4207,17987,22194
73,73067,1995-12-31,4253,17747,22000
73,73067,1996-12-31,4296,17523,21819
73,73067,1997-12-31,4330,17378,21708
73,73067,1998-12-31,4370,17204,21574
73,73067,1999-12-31,4425,17037,21462
73,73067,2000-12-31,4463,16884,21347
73,73067,2001-12-31,4530,16704,21234
73,73067,2002-12-31,4546,16524,21070
73,73067,2003-12-31,4583,16366,20949
73,73067,2004-12-31,4588,16168,20756
73,73067,2005-12-31,4609,15985,20594
73,73067,2006-12-31,4639,15847,20486
73,73067,2007-12-31,4657,15696,20353
73,73067,2008-12-31,4675,15555,20230
73,73067,2009-12-31,4698,15425,20123
73,73067,2010-12-31,4684,15306,19990
73,73067,2011-12-31,4711,15170,19881
73,73067,2012-12-31,4726,15058,19784
73,73067,2013-12-31,4765,14945,19710
73,73067,2014-12-31,4804,14826,19630
73,73067,2015-12-31,4850,14721,19571
73,73067,2016-12-31,4819,14644,19463
73,73067,2017-12-31,4794,14558,19352
73,73067,2018-12-31,4820,14510,19330
73,73067,2019-12-31,4829,14366,19195
73,73067,2020-12-31,4835,14282,19117
73,73067,2021-12-31,4940,14231,19171
73,73067,2022-12-31,5032,14182,19214
73,73067,2023-12-31,5126,14132,19258
73,73067,2024-12-31,5157,14093,19250
73,73067,2025-12-31,5183,14055,19238
73,73067,2026-12-31,5205,14037,19242
73,73067,2027-12-31,5224,14016,19240
73,73067,2028-12-31,5242,14016,19258
73,73067,2029-12-31,5264,14018,19282
73,73067,2030-12-31,5278,14041,19319
73,73067,2031-12-31,5282,14047,19329
73,73067,2032-12-31,5298,14058,19356
73,73067,2033-12-31,5304,14056,19360
73,73067,2034-12-31,5315,14078,19393
73,73067,2035-12-31,5321,14080,19401
73,73124,1985-12-31,8042,12105,20147
73,73124,1986-12-31,8160,11957,20117
73,73124,1987-12-31,8274,11774,20048
73,73124,1988-12-31,8367,11619,19986
73,73124,1989-12-31,8486,11465,19951
73,73124,1990-12-31,8584,11324,19908
73,73124,1991-12-31,8677,11173,19850
73,73124,1992-12-31,8754,11033,19787
73,73124,1993-12-31,8856,10898,19754
73,73124,1994-12-31,8933,10758,19691
73,73124,1995-12-31,8994,10632,19626
73,73124,1996-12-31,9065,10531,19596
73,73124,1997-12-31,9093,10446,19539
73,73124,1998-12-31,9151,10373,19524
73,73124,1999-12-31,9213,10304,19517
73,73124,2000-12-31,9270,10190,19460
73,73124,2001-12-31,9318,10102,19420
73,73124,2002-12-31,9357,10038,19395
73,73124,2003-12-31,9400,9948,19348
73,73124,2004-12-31,9416,9861,19277
73,73124,2005-12-31,9410,9728,19138
73,73124,2006-12-31,9433,9639,19072
73,73124,2007-12-31,9443,9580,19023
73,73124,2008-12-31,9456,9490,18946
73,73124,2009-12-31,9463,9431,18894
73,73124,2010-12-31,9455,9378,18833
73,73124,2011-12-31,9457,9302,18759
73,73124,2012-12-31,9442,9295,18737
73,73124,2013-12-31,9456,9198,18654
73,73124,2014-12-31,9474,9115,18589
73,73124,2015-12-31,9486,9035,18521
73,73124,2016-12-31,9496,9002,18498
73,73124,2017-12-31,9498,9019,18517
73,73124,2018-12-31,9461,9010,18471
73,73124,2019-12-31,9464,8979,18443
73,73124,2020-12-31,9478,8964,18442
73,73124,2021-12-31,9565,8929,18494
73,73124,2022-12-31,9639,8896,18535
73,73124,2023-12-31,9714,8864,18578
73,73124,2024-12-31,9771,8839,18610
73,73124,2025-12-31,9824,8810,18634
73,73124,2026-12-31,9862,8802,18664
73,73124,2027-12-31,9900,8788,18688
73,73124,2028-12-31,9923,8792,18715
73,73124,2029-12-31,9970,8794,18764
73,73124,2030-12-31,9992,8794,18786
73,73124,2031-12-31,10012,8803,18815
73,73124,2032-12-31,10032,8818,18850
73,73124,2033-12-31,10060,8825,18885
73,73124,2034-12-31,10069,8828,18897
73,73124,2035-12-31,10076,8835,18911
73,73148,1985-12-31,3493,2341,5834
73,73148,1986-12-31,3648,2326,5974
73,73148,1987-12-31,3826,2325,6151
73,73148,1988-12-31,3975,2324,6299
73,73148,1989-12-31,4131,2281,6412
73,73148,1990-12-31,4312,2252,6564
73,73148,1991-12-31,4452,2276,6728
73,73148,1992-12-31,4630,2291,6921
73,73148,1993-12-31,4776,2269,7045
73,73148,1994-12-31,4958,2246,7204
73,73148,1995-12-31,5087,2238,7325
73,73148,1996-12-31,5229,2255,7484
73,73148,1997-12-31,5360,2266,7626
73,73148,1998-12-31,5495,2277,7772
73,73148,1999-12-31,5636,2292,7928
73,73148,2000-12-31,5768,2297,8065
73,73148,2001-12-31,5907,2304,8211
73,73148,2002-12-31,6034,2319,8353
73,73148,2003-12-31,6162,2330,8492
73,73148,2004-12-31,6297,2337,8634
73,73148,2005-12-31,6410,2366,8776
73,73148,2006-12-31,6517,2317,8834
73,73148,2007-12-31,6603,2362,8965
73,73148,2008-12-31,6707,2399,9106
73,73148,2009-12-31,6803,2425,9228
73,73148,2010-12-31,6912,2452,9364
73,73148,2011-12-31,6988,2461,9449
73,73148,2012-12-31,7091,2466,9557
73,73148,2013-12-31,7208,2474,9682
73,73148,2014-12-31,7259,2480,9739
73,73148,2015-12-31,7376,2482,9858
73,73148,2016-12-31,7486,2480,9966
73,73148,2017-12-31,7497,2484,9981
73,73148,2018-12-31,7627,2490,10117
73,73148,2019-12-31,7762,2544,10306
73,73148,2020-12-31,7869,2579,10448
73,73148,2021-12-31,7909,2570,10479
73,73148,2022-12-31,7942,2561,10503
73,73148,2023-12-31,7975,2552,10527
73,73148,2024-12-31,8007,2539,10546
73,73148,2025-12-31,8049,2539,10588
73,73148,2026-12-31,8072,2535,10607
73,73148,2027-12-31,8115,2528,10643
73,73148,2028-12-31,8137,2532,10669
73,73148,2029-12-31,8149,2526,10675
73,73148,2030-12-31,8178,2534,10712
73,73148,2031-12-31,8204,2534,10738
73,73148,2032-12-31,8221,2532,10753
73,73148,2033-12-31,8232,2537,10769
73,73148,2034-12-31,8232,2539,10771
73,73148,2035-12-31,8267,2549,10816
73,73152,1985-12-31,1670,6530,8200
73,73152,1986-12-31,1638,6437,8075
73,73152,1987-12-31,1641,6329,7970
73,73152,1988-12-31,1656,6245,7901
73,73152,1989-12-31,1694,6142,7836
73,73152,1990-12-31,1709,6045,7754
73,73152,1991-12-31,1709,5957,7666
73,73152,1992-12-31,1700,5878,7578
73,73152,1993-12-31,1693,5797,7490
73,73152,1994-12-31,1737,5728,7465
73,73152,1995-12-31,1747,5649,7396
73,73152,1996-12-31,1762,5621,7383
73,73152,1997-12-31,1760,5577,7337
73,73152,1998-12-31,1772,5500,7272
73,73152,1999-12-31,1771,5424,7195
73,73152,2000-12-31,1785,5385,7170
73,73152,2001-12-31,1788,5347,7135
73,73152,2002-12-31,1787,5304,7091
73,73152,2003-12-31,1776,5264,7040
73,73152,2004-12-31,1790,5209,6999
73,73152,2005-12-31,1770,5153,6923
73,73152,2006-12-31,1762,5110,6872
73,73152,2007-12-31,1761,5054,6815
73,73152,2008-12-31,1778,5025,6803
73,73152,2009-12-31,1792,4968,6760
73,73152,2010-12-31,1748,4937,6685
73,73152,2011-12-31,1695,4908,6603
73,73152,2012-12-31,1661,4835,6496
73,73152,2013-12-31,1658,4785,6443
73,73152,2014-12-31,1674,4740,6414
73,73152,2015-12-31,1677,4724,6401
73,73152,2016-12-31,1684,4701,6385
73,73152,2017-12-31,1705,4681,6386
73,73152,2018-12-31,1720,4653,6373
73,73152,2019-12-31,1688,4638,6326
73,73152,2020-12-31,1658,4639,6297
73,73152,2021-12-31,1692,4623,6315
73,73152,2022-12-31,1722,4607,6329
73,73152,2023-12-31,1753,4591,6344
73,73152,2024-12-31,1765,4572,6337
73,73152,2025-12-31,1774,4567,6341
73,73152,2026-12-31,1782,4563,6345
73,73152,2027-12-31,1793,4553,6346
73,73152,2028-12-31,1801,4554,6355
73,73152,2029-12-31,1800,4561,6361
73,73152,2030-12-31,1802,4555,6357
73,73152,2031-12-31,1807,4557,6364
73,73152,2032-12-31,1808,4560,6368
73,73152,2033-12-31,1815,4562,6377
73,73152,2034-12-31,1818,4565,6383
73,73152,2035-12-31,1816,4561,6377
73,73168,1985-12-31,19947,28049,47996
73,73168,1986-12-31,20414,27689,48103
73,73168,1987-12-31,20856,27345,48201
73,73168,1988-12-31,21302,26988,48290
73,73168,1989-12-31,21727,26667,48394
73,73168,1990-12-31,22147,26358,48505
73,73168,1991-12-31,22551,26045,48596
73,73168,1992-12-31,22954,25751,48705
73,73168,1993-12-31,23323,25441,48764
73,73168,1994-12-31,23688,25187,48875
73,73168,1995-12-31,24057,24928,48985
73,73168,1996-12-31,24411,24658,49069
73,73168,1997-12-31,24631,24500,49131
73,73168,1998-12-31,24949,24316,49265
73,73168,1999-12-31,25276,24150,49426
73,73168,2000-12-31,25573,23979,49552
73,73168,2001-12-31,25837,23807,49644
73,73168,2002-12-31,26111,23605,49716
73,73168,2003-12-31,26356,23379,49735
73,73168,2004-12-31,26568,23223,49791
73,73168,2005-12-31,26716,23073,49789
73,73168,2006-12-31,26894,22926,49820
73,73168,2007-12-31,27109,22765,49874
73,73168,2008-12-31,27233,22625,49858
73,73168,2009-12-31,27392,22489,49881
73,73168,2010-12-31,27545,22368,49913
73,73168,2011-12-31,27690,22237,49927
73,73168,2012-12-31,27824,22117,49941
73,73168,2013-12-31,27946,22046,49992
73,73168,2014-12-31,28083,21963,50046
73,73168,2015-12-31,28202,21874,50076
73,73168,2016-12-31,28350,21807,50157
73,73168,2017-12-31,28470,21762,50232
73,73168,2018-12-31,28615,21752,50367
73,73168,2019-12-31,28802,21763,50565
73,73168,2020-12-31,28976,21765,50741
73,73168,2021-12-31,29197,21692,50889
73,73168,2022-12-31,29388,21617,51005
73,73168,2023-12-31,29585,21540,51125
73,73168,2024-12-31,29749,21474,51223
73,73168,2025-12-31,29884,21433,51317
73,73168,2026-12-31,30002,21402,51404
73,73168,2027-12-31,30115,21374,51489
73,73168,2028-12-31,30227,21361,51588
73,73168,2029-12-31,30311,21353,51664
73,73168,2030-12-31,30405,21383,51788
73,73168,2031-12-31,30474,21401,51875
73,73168,2032-12-31,30542,21425,51967
73,73168,2033-12-31,30593,21433,52026
73,73168,2034-12-31,30637,21446,52083
73,73168,2035-12-31,30677,21469,52146
73,73200,1985-12-31,1175,9239,10414
73,73200,1986-12-31,1182,9090,10272
73,73200,1987-12-31,1183,8947,10130
73,73200,1988-12-31,1214,8835,10049
73,73200,1989-12-31,1221,8716,9937
73,73200,1990-12-31,1260,8589,9849
73,73200,1991-12-31,1273,8486,9759
73,73200,1992-12-31,1285,8389,9674
73,73200,1993-12-31,1296,8261,9557
73,73200,1994-12-31,1335,8166,9501
73,73200,1995-12-31,1338,8053,9391
73,73200,1996-12-31,1341,7990,9331
73,73200,1997-12-31,1329,7923,9252
73,73200,1998-12-31,1379,7843,9222
73,73200,1999-12-31,1404,7782,9186
73,73200,2000-12-31,1395,7677,9072
73,73200,2001-12-31,1388,7663,9051
73,73200,2002-12-31,1420,7593,9013
73,73200,2003-12-31,1433,7542,8975
73,73200,2004-12-31,1439,7476,8915
73,73200,2005-12-31,1446,7353,8799
73,73200,2006-12-31,1435,7269,8704
73,73200,2007-12-31,1426,7208,8634
73,73200,2008-12-31,1425,7119,8544
73,73200,2009-12-31,1426,7090,8516
73,73200,2010-12-31,1424,7048,8472
73,73200,2011-12-31,1435,6965,8400
73,73200,2012-12-31,1459,6895,8354
73,73200,2013-12-31,1463,6830,8293
73,73200,2014-12-31,1465,6793,8258
73,73200,2015-12-31,1473,6799,8272
73,73200,2016-12-31,1469,6814,8283
73,73200,2017-12-31,1479,6797,8276
73,73200,2018-12-31,1482,6766,8248
73,73200,2019-12-31,1497,6789,8286
73,73200,2020-12-31,1511,6809,8320
73,73200,2021-12-31,1559,6786,8345
73,73200,2022-12-31,1601,6763,8364
73,73200,2023-12-31,1644,6739,8383
73,73200,2024-12-31,1654,6719,8373
73,73200,2025-12-31,1666,6699,8365
73,73200,2026-12-31,1670,6688,8358
73,73200,2027-12-31,1670,6683,8353
73,73200,2028-12-31,1674,6681,8355
73,73200,2029-12-31,1686,6678,8364
73,73200,2030-12-31,1687,6689,8376
73,73200,2031-12-31,1691,6691,8382
73,73200,2032-12-31,1699,6698,8397
73,73200,2033-12-31,1702,6706,8408
73,73200,2034-12-31,1697,6705,8402
73,73200,2035-12-31,1705,6720,8425
73,73217,1985-12-31,2681,26390,29071
73,73217,1986-12-31,2770,26001,28771
73,73217,1987-12-31,2823,25616,28439
73,73217,1988-12-31,2890,25238,28128
73,73217,1989-12-31,2939,24884,27823
73,73217,1990-12-31,2988,24553,27541
73,73217,1991-12-31,3044,24212,27256
73,73217,1992-12-31,3100,23886,26986
73,73217,1993-12-31,3153,23567,26720
73,73217,1994-12-31,3196,23280,26476
73,73217,1995-12-31,3250,22994,26244
73,73217,1996-12-31,3295,22727,26022
73,73217,1997-12-31,3316,22532,25848
73,73217,1998-12-31,3355,22313,25668
73,73217,1999-12-31,3391,22092,25483
73,73217,2000-12-31,3436,21879,25315
73,73217,2001-12-31,3472,21647,25119
73,73217,2002-12-31,3508,21422,24930
73,73217,2003-12-31,3540,21210,24750
73,73217,2004-12-31,3581,20997,24578
73,73217,2005-12-31,3590,20803,24393
73,73217,2006-12-31,3618,20622,24240
73,73217,2007-12-31,3628,20448,24076
73,73217,2008-12-31,3636,20275,23911
73,73217,2009-12-31,3662,20091,23753
73,73217,2010-12-31,3704,19937,23641
73,73217,2011-12-31,3702,19789,23491
73,73217,2012-12-31,3735,19628,23363
73,73217,2013-12-31,3772,19494,23266
73,73217,2014-12-31,3796,19400,23196
73,73217,2015-12-31,3777,19234,23011
73,73217,2016-12-31,3791,19091,22882
73,73217,2017-12-31,3824,18969,22793
73,73217,2018-12-31,3836,18977,22813
73,73217,2019-12-31,3861,18749,22610
73,73217,2020-12-31,3884,18606,22490
73,73217,2021-12-31,4013,18540,22553
73,73217,2022-12-31,4128,18476,22604
73,73217,2023-12-31,4246,18410,22656
73,73217,2024-12-31,4275,18355,22630
73,73217,2025-12-31,4288,18318,22606
73,73217,2026-12-31,4317,18278,22595
73,73217,2027-12-31,4320,18261,22581
73,73217,2028-12-31,4337,18247,22584
73,73217,2029-12-31,4359,18249,22608
73,73217,2030-12-31,4373,18256,22629
73,73217,2031-12-31,4371,18291,22662
73,73217,2032-12-31,4391,18311,22702
73,73217,2033-12-31,4387,18325,22712
73,73217,2034-12-31,4395,18332,22727
73,73217,2035-12-31,4416,18335,22751
73,73226,1985-12-31,2773,14430,17203
73,73226,1986-12-31,2791,14102,16893
73,73226,1987-12-31,2788,13746,16534
73,73226,1988-12-31,2787,13418,16205
73,73226,1989-12-31,2799,13092,15891
73,73226,1990-12-31,2807,12773,15580
73,73226,1991-12-31,2802,12483,15285
73,73226,1992-12-31,2808,12174,14982
73,73226,1993-12-31,2793,11867,14660
73,73226,1994-12-31,2795,11597,14392
73,73226,1995-12-31,2798,11323,14121
73,73226,1996-12-31,2792,11048,13840
73,73226,1997-12-31,2780,10825,13605
73,73226,1998-12-31,2777,10607,13384
73,73226,1999-12-31,2777,10390,13167
73,73226,2000-12-31,2755,10120,12875
73,73226,2001-12-31,2734,9887,12621
73,73226,2002-12-31,2722,9677,12399
73,73226,2003-12-31,2705,9433,12138
73,73226,2004-12-31,2684,9205,11889
73,73226,2005-12-31,2654,8937,11591
73,73226,2006-12-31,2638,8705,11343
73,73226,2007-12-31,2636,8496,11132
73,73226,2008-12-31,2605,8275,10880
73,73226,2009-12-31,2594,8077,10671
73,73226,2010-12-31,2592,7856,10448
73,73226,2011-12-31,2596,7650,10246
73,73226,2012-12-31,2591,7451,10042
73,73226,2013-12-31,2483,7267,9750
73,73226,2014-12-31,2396,7077,9473
73,73226,2015-12-31,2370,6905,9275
73,73226,2016-12-31,2375,6735,9110
73,73226,2017-12-31,2379,6551,8930
73,73226,2018-12-31,2397,6348,8745
73,73226,2019-12-31,2377,6141,8518
73,73226,2020-12-31,2366,6006,8372
73,73226,2021-12-31,2410,5985,8395
73,73226,2022-12-31,2450,5964,8414
73,73226,2023-12-31,2491,5943,8434
73,73226,2024-12-31,2511,5929,8440
73,73226,2025-12-31,2507,5914,8421
73,73226,2026-12-31,2527,5903,8430
73,73226,2027-12-31,2540,5904,8444
73,73226,2028-12-31,2541,5896,8437
73,73226,2029-12-31,2557,5899,8456
73,73226,2030-12-31,2558,5900,8458
73,73226,2031-12-31,2567,5903,8470
73,73226,2032-12-31,2563,5907,8470
73,73226,2033-12-31,2574,5912,8486
73,73226,2034-12-31,2577,5924,8501
73,73226,2035-12-31,2585,5916,8501
73,73236,1985-12-31,4323,7350,11673
73,73236,1986-12-31,4352,7228,11580
73,73236,1987-12-31,4343,7102,11445
73,73236,1988-12-31,4369,6992,11361
73,73236,1989-12-31,4381,6891,11272
73,73236,1990-12-31,4364,6744,11108
73,73236,1991-12-31,4363,6638,11001
73,73236,1992-12-31,4361,6532,10893
73,73236,1993-12-31,4332,6436,10768
73,73236,1994-12-31,4323,6349,10672
73,73236,1995-12-31,4327,6255,10582
73,73236,1996-12-31,4276,6179,10455
73,73236,1997-12-31,4262,6109,10371
73,73236,1998-12-31,4235,6020,10255
73,73236,1999-12-31,4207,5939,10146
73,73236,2000-12-31,4194,5888,10082
73,73236,2001-12-31,4172,5832,10004
73,73236,2002-12-31,4157,5765,9922
73,73236,2003-12-31,4096,5701,9797
73,73236,2004-12-31,4061,5649,9710
73,73236,2005-12-31,4049,5577,9626
73,73236,2006-12-31,3986,5501,9487
73,73236,2007-12-31,3956,5440,9396
73,73236,2008-12-31,3903,5356,9259
73,73236,2009-12-31,3875,5287,9162
73,73236,2010-12-31,3835,5245,9080
73,73236,2011-12-31,3800,5194,8994
73,73236,2012-12-31,3742,5133,8875
73,73236,2013-12-31,3707,5080,8787
73,73236,2014-12-31,3690,5041,8731
73,73236,2015-12-31,3623,5032,8655
73,73236,2016-12-31,3508,4963,8471
73,73236,2017-12-31,3482,4911,8393
73,73236,2018-12-31,3503,4856,8359
73,73236,2019-12-31,3423,4827,8250
73,73236,2020-12-31,3374,4811,8185
73,73236,2021-12-31,3414,4794,8208
73,73236,2022-12-31,3449,4777,8226
73,73236,2023-12-31,3486,4760,8246
73,73236,2024-12-31,3510,4741,8251
73,73236,2025-12-31,3528,4728,8256
73,73236,2026-12-31,3540,4723,8263
73,73236,2027-12-31,3553,4720,8273
73,73236,2028-12-31,3571,4723,8294
73,73236,2029-12-31,3575,4721,8296
73,73236,2030-12-31,3585,4729,8314
73,73236,2031-12-31,3589,4733,8322
73,73236,2032-12-31,3598,4743,8341
73,73236,2033-12-31,3603,4735,8338
73,73236,2034-12-31,3611,4741,8352
73,73236,2035-12-31,3625,4736,8361
73,73268,1985-12-31,42387,21161,63548
73,73268,1986-12-31,43050,21009,64059
73,73268,1987-12-31,43657,20870,64527
73,73268,1988-12-31,44262,20722,64984
73,73268,1989-12-31,44817,20574,65391
73,73268,1990-12-31,45376,20454,65830
73,73268,1991-12-31,45897,20310,66207
73,73268,1992-12-31,46395,20182,66577
73,73268,1993-12-31,46830,20071,66901
73,73268,1994-12-31,47277,19958,67235
73,73268,1995-12-31,47708,19883,67591
73,73268,1996-12-31,48115,19758,67873
73,73268,1997-12-31,48273,19756,68029
73,73268,1998-12-31,48627,19716,68343
73,73268,1999-12-31,48951,19686,68637
73,73268,2000-12-31,49269,19659,68928
73,73268,2001-12-31,49535,19624,69159
73,73268,2002-12-31,49760,19543,69303
73,73268,2003-12-31,49965,19501,69466
73,73268,2004-12-31,50096,19469,69565
73,73268,2005-12-31,50136,19461,69597
73,73268,2006-12-31,50231,19467,69698
73,73268,2007-12-31,50295,19442,69737
73,73268,2008-12-31,50355,19418,69773
73,73268,2009-12-31,50407,19419,69826
73,73268,2010-12-31,50435,19423,69858
73,73268,2011-12-31,50495,19433,69928
73,73268,2012-12-31,50513,19472,69985
73,73268,2013-12-31,50525,19520,70045
73,73268,2014-12-31,50533,19542,70075
73,73268,2015-12-31,50537,19618,70155
73,73268,2016-12-31,50580,19631,70211
73,73268,2017-12-31,50657,19722,70379
73,73268,2018-12-31,50664,19830,70494
73,73268,2019-12-31,50942,19827,70769
73,73268,2020-12-31,51211,19804,71015
73,73268,2021-12-31,51484,19737,71221
73,73268,2022-12-31,51714,19669,71383
73,73268,2023-12-31,51949,19600,71549
73,73268,2024-12-31,52193,19546,71739
73,73268,2025-12-31,52423,19507,71930
73,73268,2026-12-31,52618,19466,72084
73,73268,2027-12-31,52819,19448,72267
73,73268,2028-12-31,52994,19439,72433
73,73268,2029-12-31,53154,19437,72591
73,73268,2030-12-31,53296,19461,72757
73,73268,2031-12-31,53436,19468,72904
73,73268,2032-12-31,53545,19497,73042
73,73268,2033-12-31,53633,19510,73143
73,73268,2034-12-31,53732,19521,73253
73,73268,2035-12-31,53786,19541,73327
73,73270,1985-12-31,1738,17762,19500
73,73270,1986-12-31,1741,18132,19873
73,73270,1987-12-31,1776,18483,20259
73,73270,1988-12-31,1770,18838,20608
73,73270,1989-12-31,1794,19202,20996
73,73270,1990-12-31,1805,19573,21378
73,73270,1991-12-31,1824,19929,21753
73,73270,1992-12-31,1820,20273,22093
73,73270,1993-12-31,1828,20624,22452
73,73270,1994-12-31,1833,20997,22830
73,73270,1995-12-31,1828,21370,23198
73,73270,1996-12-31,1845,21730,23575
73,73270,1997-12-31,1848,9819,11667
73,73270,1998-12-31,1850,9630,11480
73,73270,1999-12-31,1842,9423,11265
73,73270,2000-12-31,1847,9209,11056
73,73270,2001-12-31,1859,9007,10866
73,73270,2002-12-31,1869,8821,10690
73,73270,2003-12-31,1894,8631,10525
73,73270,2004-12-31,1838,8423,10261
73,73270,2005-12-31,1850,8192,10042
73,73270,2006-12-31,1845,7978,9823
73,73270,2007-12-31,1847,7779,9626
73,73270,2008-12-31,1834,7595,9429
73,73270,2009-12-31,1817,7409,9226
73,73270,2010-12-31,1775,7246,9021
73,73270,2011-12-31,1747,7060,8807
73,73270,2012-12-31,1733,6888,8621
73,73270,2013-12-31,1719,6734,8453
73,73270,2014-12-31,1724,6567,8291
73,73270,2015-12-31,1728,6415,8143
73,73270,2016-12-31,1740,6299,8039
73,73270,2017-12-31,1746,6093,7839
73,73270,2018-12-31,1764,5929,7693
73,73270,2019-12-31,1765,5729,7494
73,73270,2020-12-31,1767,5619,7386
73,73270,2021-12-31,1808,5599,7407
73,73270,2022-12-31,1843,5580,7423
73,73270,2023-12-31,1881,5560,7441
73,73270,2024-12-31,1894,5543,7437
73,73270,2025-12-31,1902,5536,7438
73,73270,2026-12-31,1906,5520,7426
73,73270,2027-12-31,1912,5519,7431
73,73270,2028-12-31,1919,5513,7432
73,73270,2029-12-31,1931,5516,7447
73,73270,2030-12-31,1935,5532,7467
73,73270,2031-12-31,1935,5528,7463
73,73270,2032-12-31,1942,5531,7473
73,73270,2033-12-31,1942,5533,7475
73,73270,2034-12-31,1953,5537,7490
73,73270,2035-12-31,1951,5540,7491
73,73275,1985-12-31,19204,4896,24100
73,73275,1986-12-31,19546,4821,24367
73,73275,1987-12-31,19880,4768,24648
73,73275,1988-12-31,20210,4704,24914
73,73275,1989-12-31,20506,4647,25153
73,73275,1990-12-31,20805,4585,25390
73,73275,1991-12-31,21093,4551,25644
73,73275,1992-12-31,21372,4494,25866
73,73275,1993-12-31,21617,4425,26042
73,73275,1994-12-31,21885,4402,26287
73,73275,1995-12-31,22140,4381,26521
73,73275,1996-12-31,22379,4267,26646
73,73275,1997-12-31,22506,4249,26755
73,73275,1998-12-31,22715,4227,26942
73,73275,1999-12-31,22914,4177,27091
73,73275,2000-12-31,23117,4243,27360
73,73275,2001-12-31,23287,4181,27468
73,73275,2002-12-31,23430,4169,27599
73,73275,2003-12-31,23576,4146,27722
73,73275,2004-12-31,23686,4116,27802
73,73275,2005-12-31,23754,4092,27846
73,73275,2006-12-31,23849,4087,27936
73,73275,2007-12-31,23912,4052,27964
73,73275,2008-12-31,23979,4042,28021
73,73275,2009-12-31,24056,3994,28050
73,73275,2010-12-31,24133,3964,28097
73,73275,2011-12-31,24171,4016,28187
73,73275,2012-12-31,24247,3987,28234
73,73275,2013-12-31,24288,3955,28243
73,73275,2014-12-31,24339,3921,28260
73,73275,2015-12-31,24387,3892,28279
73,73275,2016-12-31,24433,3861,28294
73,73275,2017-12-31,24523,3853,28376
73,73275,2018-12-31,24551,3838,28389
73,73275,2019-12-31,24669,3841,28510
73,73275,2020-12-31,24772,3843,28615
73,73275,2021-12-31,24870,3830,28700
73,73275,2022-12-31,24949,3817,28766
73,73275,2023-12-31,25029,3803,28832
73,73275,2024-12-31,25142,3784,28926
73,73275,2025-12-31,25244,3782,29026
73,73275,2026-12-31,25352,3783,29135
73,73275,2027-12-31,25441,3772,29213
73,73275,2028-12-31,25539,3763,29302
73,73275,2029-12-31,25613,3769,29382
73,73275,2030-12-31,25677,3768,29445
73,73275,2031-12-31,25756,3776,29532
73,73275,2032-12-31,25806,3780,29586
73,73275,2033-12-31,25852,3783,29635
73,73275,2034-12-31,25884,3783,29667
73,73275,2035-12-31,25920,3785,29705
73,73283,1985-12-31,11842,20272,32114
73,73283,1986-12-31,12073,19993,32066
73,73283,1987-12-31,12300,19734,32034
73,73283,1988-12-31,12529,19481,32010
73,73283,1989-12-31,12717,19221,31938
73,73283,1990-12-31,12930,18996,31926
73,73283,1991-12-31,13129,18764,31893
73,73283,1992-12-31,13329,18522,31851
73,73283,1993-12-31,13504,18311,31815
73,73283,1994-12-31,13676,18117,31793
73,73283,1995-12-31,13848,17906,31754
73,73283,1996-12-31,14032,17698,31730
73,73283,1997-12-31,14123,17597,31720
73,73283,1998-12-31,14275,17464,31739
73,73283,1999-12-31,14391,17309,31700
73,73283,2000-12-31,14533,17193,31726
73,73283,2001-12-31,14684,17051,31735
73,73283,2002-12-31,14824,16891,31715
73,73283,2003-12-31,14860,16723,31583
73,73283,2004-12-31,14975,16579,31554
73,73283,2005-12-31,15016,16441,31457
73,73283,2006-12-31,15108,16342,31450
73,73283,2007-12-31,15207,16222,31429
73,73283,2008-12-31,15231,16116,31347
73,73283,2009-12-31,15285,16020,31305
73,73283,2010-12-31,15337,15893,31230
73,73283,2011-12-31,15393,15845,31238
73,73283,2012-12-31,15438,15697,31135
73,73283,2013-12-31,15490,15620,31110
73,73283,2014-12-31,15534,15584,31118
73,73283,2015-12-31,15563,15515,31078
73,73283,2016-12-31,15600,15405,31005
73,73283,2017-12-31,15732,15303,31035
73,73283,2018-12-31,15713,15356,31069
73,73283,2019-12-31,15789,15335,31124
73,73283,2020-12-31,15858,15333,31191
73,73283,2021-12-31,15997,15281,31278
73,73283,2022-12-31,16120,15229,31349
73,73283,2023-12-31,16247,15175,31422
73,73283,2024-12-31,16344,15129,31473
73,73283,2025-12-31,16422,15096,31518
73,73283,2026-12-31,16494,15067,31561
73,73283,2027-12-31,16556,15053,31609
73,73283,2028-12-31,16616,15052,31668
73,73283,2029-12-31,16670,15051,31721
73,73283,2030-12-31,16710,15064,31774
73,73283,2031-12-31,16750,15083,31833
73,73283,2032-12-31,16796,15087,31883
73,73283,2033-12-31,16821,15100,31921
73,73283,2034-12-31,16849,15109,31958
73,73283,2035-12-31,16878,15118,31996
73,73319,1985-12-31,14776,22942,37718
73,73319,1986-12-31,14963,22601,37564
73,73319,1987-12-31,15157,22281,37438
73,73319,1988-12-31,15326,21937,37263
73,73319,1989-12-31,15484,21612,37096
73,73319,1990-12-31,15641,21306,36947
73,73319,1991-12-31,15784,20999,36783
73,73319,1992-12-31,15923,20716,36639
73,73319,1993-12-31,16036,20435,36471
73,73319,1994-12-31,16168,20174,36342
73,73319,1995-12-31,16283,19961,36244
73,73319,1996-12-31,16392,19671,36063
73,73319,1997-12-31,16411,19524,35935
73,73319,1998-12-31,16501,19306,35807
73,73319,1999-12-31,16592,19128,35720
73,73319,2000-12-31,16650,18943,35593
73,73319,2001-12-31,16711,18696,35407
73,73319,2002-12-31,16769,18507,35276
73,73319,2003-12-31,16799,18307,35106
73,73319,2004-12-31,16808,18142,34950
73,73319,2005-12-31,16841,17939,34780
73,73319,2006-12-31,16869,17792,34661
73,73319,2007-12-31,16829,17644,34473
73,73319,2008-12-31,16795,17489,34284
73,73319,2009-12-31,16790,17334,34124
73,73319,2010-12-31,16759,17133,33892
73,73319,2011-12-31,16785,17035,33820
73,73319,2012-12-31,16770,16884,33654
73,73319,2013-12-31,16777,16762,33539
73,73319,2014-12-31,16756,16641,33397
73,73319,2015-12-31,16719,16528,33247
73,73319,2016-12-31,16681,16422,33103
73,73319,2017-12-31,16706,16320,33026
73,73319,2018-12-31,16656,16284,32940
73,73319,2019-12-31,16642,16184,32826
73,73319,2020-12-31,16654,16118,32772
73,73319,2021-12-31,16803,16061,32864
73,73319,2022-12-31,16933,16005,32938
73,73319,2023-12-31,17066,15948,33014
73,73319,2024-12-31,17172,15920,33092
73,73319,2025-12-31,17250,15862,33112
73,73319,2026-12-31,17321,15846,33167
73,73319,2027-12-31,17385,15822,33207
73,73319,2028-12-31,17446,15807,33253
73,73319,2029-12-31,17504,15806,33310
73,73319,2030-12-31,17556,15821,33377
73,73319,2031-12-31,17578,15834,33412
73,73319,2032-12-31,17617,15850,33467
73,73319,2033-12-31,17656,15861,33517
73,73319,2034-12-31,17686,15878,33564
73,73319,2035-12-31,17697,15884,33581
73,73347,1985-12-31,2470,9390,11860
73,73347,1986-12-31,2471,9208,11679
73,73347,1987-12-31,2482,9034,11516
73,73347,1988-12-31,2482,8837,11319
73,73347,1989-12-31,2490,8673,11163
73,73347,1990-12-31,2487,8499,10986
73,73347,1991-12-31,2498,8339,10837
73,73347,1992-12-31,2503,8166,10669
73,73347,1993-12-31,2508,7993,10501
73,73347,1994-12-31,2507,7837,10344
73,73347,1995-12-31,2504,7702,10206
73,73347,1996-12-31,2492,7564,10056
73,73347,1997-12-31,2490,7464,9954
73,73347,1998-12-31,2491,7353,9844
73,73347,1999-12-31,2524,7208,9732
73,73347,2000-12-31,2474,7074,9548
73,73347,2001-12-31,2464,6955,9419
73,73347,2002-12-31,2425,6843,9268
73,73347,2003-12-31,2395,6749,9144
73,73347,2004-12-31,2427,6620,9047
73,73347,2005-12-31,2396,6487,8883
73,73347,2006-12-31,2381,6375,8756
73,73347,2007-12-31,2368,6251,8619
73,73347,2008-12-31,2354,6135,8489
73,73347,2009-12-31,2329,6032,8361
73,73347,2010-12-31,2313,5901,8214
73,73347,2011-12-31,2294,5800,8094
73,73347,2012-12-31,2261,5712,7973
73,73347,2013-12-31,2190,5620,7810
73,73347,2014-12-31,2150,5532,7682
73,73347,2015-12-31,2158,5458,7616
73,73347,2016-12-31,2157,5405,7562
73,73347,2017-12-31,2160,5259,7419
73,73347,2018-12-31,2179,5184,7363
73,73347,2019-12-31,2173,5093,7266
73,73347,2020-12-31,2174,5039,7213
73,73347,2021-12-31,2212,5021,7233
73,73347,2022-12-31,2246,5004,7250
73,73347,2023-12-31,2280,4986,7266
73,73347,2024-12-31,2288,4969,7257
73,73347,2025-12-31,2299,4951,7250
73,73347,2026-12-31,2305,4955,7260
73,73347,2027-12-31,2324,4958,7282
73,73347,2028-12-31,2323,4946,7269
73,73347,2029-12-31,2332,4951,7283
73,73347,2030-12-31,2336,4946,7282
73,73347,2031-12-31,2344,4964,7308
73,73347,2032-12-31,2353,4958,7311
73,73347,2033-12-31,2367,4966,7333
73,73347,2034-12-31,2360,4967,7327
73,73347,2035-12-31,2362,4960,7322
73,73349,1985-12-31,26993,1192,28185
73,73349,1986-12-31,27122,1213,28335
73,73349,1987-12-31,27243,1150,28393
73,73349,1988-12-31,27324,1175,28499
73,73349,1989-12-31,27403,1171,28574
73,73349,1990-12-31,27444,1156,28600
73,73349,1991-12-31,27485,1120,28605
73,73349,1992-12-31,27505,1099,28604
73,73349,1993-12-31,27481,1073,28554
73,73349,1994-12-31,27493,1099,28592
73,73349,1995-12-31,27470,1105,28575
73,73349,1996-12-31,27433,1085,28518
73,73349,1997-12-31,27273,1089,28362
73,73349,1998-12-31,27201,1079,28280
73,73349,1999-12-31,27133,1092,28225
73,73349,2000-12-31,27048,1073,28121
73,73349,2001-12-31,26937,1066,28003
73,73349,2002-12-31,26817,1059,27876
73,73349,2003-12-31,26676,1075,27751
73,73349,2004-12-31,26501,1067,27568
73,73349,2005-12-31,26293,1063,27356
73,73349,2006-12-31,26074,1078,27152
73,73349,2007-12-31,25918,1072,26990
73,73349,2008-12-31,25686,1046,26732
73,73349,2009-12-31,25470,1010,26480
73,73349,2010-12-31,25274,1018,26292
73,73349,2011-12-31,25057,1024,26081
73,73349,2012-12-31,24844,1026,25870
73,73349,2013-12-31,24625,1024,25649
73,73349,2014-12-31,24425,1031,25456
73,73349,2015-12-31,24253,1028,25281
73,73349,2016-12-31,24031,1029,25060
73,73349,2017-12-31,23896,1029,24925
73,73349,2018-12-31,23658,1035,24693
73,73349,2019-12-31,23384,1201,24585
73,73349,2020-12-31,23253,1289,24542
73,73349,2021-12-31,23326,1285,24611
73,73349,2022-12-31,23386,1280,24666
73,73349,2023-12-31,23447,1276,24723
73,73349,2024-12-31,23541,1259,24800
73,73349,2025-12-31,23645,1260,24905
73,73349,2026-12-31,23749,1259,25008
73,73349,2027-12-31,23838,1257,25095
73,73349,2028-12-31,23923,1252,25175
73,73349,2029-12-31,24000,1259,25259
73,73349,2030-12-31,24050,1258,25308
73,73349,2031-12-31,24117,1267,25384
73,73349,2032-12-31,24171,1266,25437
73,73349,2033-12-31,24210,1270,25480
73,73349,2034-12-31,24253,1278,25531
73,73349,2035-12-31,24291,1273,25564
73,73352,1985-12-31,3807,8208,12015
73,73352,1986-12-31,3824,8166,11990
73,73352,1987-12-31,3863,8149,12012
73,73352,1988-12-31,3875,8107,11982
73,73352,1989-12-31,3862,8067,11929
73,73352,1990-12-31,3899,8032,11931
73,73352,1991-12-31,3888,8010,11898
73,73352,1992-12-31,3903,7978,11881
73,73352,1993-12-31,3925,7955,11880
73,73352,1994-12-31,3960,7911,11871
73,73352,1995-12-31,3968,7889,11857
73,73352,1996-12-31,3964,7879,11843
73,73352,1997-12-31,3944,7925,11869
73,73352,1998-12-31,3921,7882,11803
73,73352,1999-12-31,3934,7885,11819
73,73352,2000-12-31,3949,7887,11836
73,73352,2001-12-31,3955,7907,11862
73,73352,2002-12-31,3933,7913,11846
73,73352,2003-12-31,3911,7943,11854
73,73352,2004-12-31,3872,7941,11813
73,73352,2005-12-31,3871,7926,11797
73,73352,2006-12-31,3854,7887,11741
73,73352,2007-12-31,3852,7896,11748
73,73352,2008-12-31,3811,7911,11722
73,73352,2009-12-31,3796,7905,11701
73,73352,2010-12-31,3773,7935,11708
73,73352,2011-12-31,3748,7996,11744
73,73352,2012-12-31,3729,8030,11759
73,73352,2013-12-31,3725,8071,11796
73,73352,2014-12-31,3691,8093,11784
73,73352,2015-12-31,3619,8126,11745
73,73352,2016-12-31,3561,8203,11764
73,73352,2017-12-31,3574,8278,11852
73,73352,2018-12-31,3595,8292,11887
73,73352,2019-12-31,3611,8280,11891
73,73352,2020-12-31,3625,8268,11893
73,73352,2021-12-31,3686,8240,11926
73,73352,2022-12-31,3741,8212,11953
73,73352,2023-12-31,3798,8183,11981
73,73352,2024-12-31,3826,8160,11986
73,73352,2025-12-31,3837,8153,11990
73,73352,2026-12-31,3853,8127,11980
73,73352,2027-12-31,3866,8114,11980
73,73352,2028-12-31,3882,8111,11993
73,73352,2029-12-31,3900,8115,12015
73,73352,2030-12-31,3908,8124,12032
73,73352,2031-12-31,3913,8126,12039
73,73352,2032-12-31,3927,8130,12057
73,73352,2033-12-31,3935,8149,12084
73,73352,2034-12-31,3929,8146,12075
73,73352,2035-12-31,3934,8151,12085
73,73408,1985-12-31,9108,5669,14777
73,73408,1986-12-31,9330,5621,14951
73,73408,1987-12-31,9547,5546,15093
73,73408,1988-12-31,9778,5506,15284
73,73408,1989-12-31,9992,5455,15447
73,73408,1990-12-31,10235,5403,15638
73,73408,1991-12-31,10432,5335,15767
73,73408,1992-12-31,10629,5281,15910
73,73408,1993-12-31,10824,5243,16067
73,73408,1994-12-31,11001,5213,16214
73,73408,1995-12-31,11200,5183,16383
73,73408,1996-12-31,11371,5158,16529
73,73408,1997-12-31,11515,5133,16648
73,73408,1998-12-31,11684,5089,16773
73,73408,1999-12-31,11855,5007,16862
73,73408,2000-12-31,12005,5034,17039
73,73408,2001-12-31,12151,5012,17163
73,73408,2002-12-31,12304,5009,17313
73,73408,2003-12-31,12425,5009,17434
73,73408,2004-12-31,12546,4995,17541
73,73408,2005-12-31,12644,4970,17614
73,73408,2006-12-31,12738,4946,17684
73,73408,2007-12-31,12823,4928,17751
73,73408,2008-12-31,12938,4926,17864
73,73408,2009-12-31,13010,4876,17886
73,73408,2010-12-31,13114,4872,17986
73,73408,2011-12-31,13186,4870,18056
73,73408,2012-12-31,13271,4883,18154
73,73408,2013-12-31,13348,4845,18193
73,73408,2014-12-31,13429,4825,18254
73,73408,2015-12-31,13517,4836,18353
73,73408,2016-12-31,13580,4827,18407
73,73408,2017-12-31,13672,4838,18510
73,73408,2018-12-31,13735,4839,18574
73,73408,2019-12-31,13824,4774,18598
73,73408,2020-12-31,13908,4709,18617
73,73408,2021-12-31,13977,4692,18669
73,73408,2022-12-31,14035,4676,18711
73,73408,2023-12-31,14096,4659,18755
73,73408,2024-12-31,14170,4652,18822
73,73408,2025-12-31,14228,4633,18861
73,73408,2026-12-31,14274,4629,18903
73,73408,2027-12-31,14332,4623,18955
73,73408,2028-12-31,14385,4628,19013
73,73408,2029-12-31,14435,4622,19057
73,73408,2030-12-31,14471,4631,19102
73,73408,2031-12-31,14505,4626,19131
73,73408,2032-12-31,14535,4641,19176
73,73408,2033-12-31,14554,4642,19196
73,73408,2034-12-31,14579,4643,19222
73,73408,2035-12-31,14597,4639,19236
73,73411,1985-12-31,24783,21229,46012
73,73411,1986-12-31,24967,20830,45797
73,73411,1987-12-31,25138,20465,45603
73,73411,1988-12-31,25282,20106,45388
73,73411,1989-12-31,25401,19751,45152
73,73411,1990-12-31,25524,19414,44938
73,73411,1991-12-31,25622,19083,44705
73,73411,1992-12-31,25710,18754,44464
73,73411,1993-12-31,25760,18431,44191
73,73411,1994-12-31,25819,18132,43951
73,73411,1995-12-31,25868,17841,43709
73,73411,1996-12-31,25895,17541,43436
73,73411,1997-12-31,25806,17340,43146
73,73411,1998-12-31,25800,17105,42905
73,73411,1999-12-31,25798,16878,42676
73,73411,2000-12-31,25777,16661,42438
73,73411,2001-12-31,25739,16415,42154
73,73411,2002-12-31,25686,16182,41868
73,73411,2003-12-31,25619,15944,41563
73,73411,2004-12-31,25524,15717,41241
73,73411,2005-12-31,25372,15453,40825
73,73411,2006-12-31,25245,15251,40496
73,73411,2007-12-31,25113,15046,40159
73,73411,2008-12-31,24976,14854,39830
73,73411,2009-12-31,24836,14622,39458
73,73411,2010-12-31,24694,14468,39162
73,73411,2011-12-31,24597,14285,38882
73,73411,2012-12-31,24382,14099,38481
73,73411,2013-12-31,24256,13913,38169
73,73411,2014-12-31,24167,13758,37925
73,73411,2015-12-31,24016,13588,37604
73,73411,2016-12-31,23901,13392,37293
73,73411,2017-12-31,23718,13305,37023
73,73411,2018-12-31,23605,13168,36773
73,73411,2019-12-31,23386,13046,36432
73,73411,2020-12-31,23290,12941,36231
73,73411,2021-12-31,23437,12895,36332
73,73411,2022-12-31,23564,12850,36414
73,73411,2023-12-31,23694,12805,36499
73,73411,2024-12-31,23820,12769,36589
73,73411,2025-12-31,23941,12733,36674
73,73411,2026-12-31,24037,12716,36753
73,73411,2027-12-31,24133,12704,36837
73,73411,2028-12-31,24220,12697,36917
73,73411,2029-12-31,24301,12703,37004
73,73411,2030-12-31,24354,12707,37061
73,73411,2031-12-31,24404,12718,37122
73,73411,2032-12-31,24459,12732,37191
73,73411,2033-12-31,24510,12746,37256
73,73411,2034-12-31,24558,12753,37311
73,73411,2035-12-31,24601,12769,37370
73,73443,1985-12-31,17746,9994,27740
73,73443,1986-12-31,18227,9942,28169
73,73443,1987-12-31,18712,9892,28604
73,73443,1988-12-31,19190,9814,29004
73,73443,1989-12-31,19641,9770,29411
73,73443,1990-12-31,20085,9720,29805
73,73443,1991-12-31,20542,9685,30227
73,73443,1992-12-31,20977,9619,30596
73,73443,1993-12-31,21388,9590,30978
73,73443,1994-12-31,21802,9543,31345
73,73443,1995-12-31,22193,9525,31718
73,73443,1996-12-31,22605,9496,32101
73,73443,1997-12-31,22880,9505,32385
73,73443,1998-12-31,23254,9521,32775
73,73443,1999-12-31,23653,9546,33199
73,73443,2000-12-31,23941,9501,33442
73,73443,2001-12-31,24294,9498,33792
73,73443,2002-12-31,24600,9523,34123
73,73443,2003-12-31,24887,9532,34419
73,73443,2004-12-31,25164,9525,34689
73,73443,2005-12-31,25371,9458,34829
73,73443,2006-12-31,25605,9480,35085
73,73443,2007-12-31,25817,9501,35318
73,73443,2008-12-31,26055,9511,35566
73,73443,2009-12-31,26243,9522,35765
73,73443,2010-12-31,26447,9531,35978
73,73443,2011-12-31,26638,9566,36204
73,73443,2012-12-31,26828,9605,36433
73,73443,2013-12-31,27007,9617,36624
73,73443,2014-12-31,27187,9639,36826
73,73443,2015-12-31,27367,9638,37005
73,73443,2016-12-31,27532,9725,37257
73,73443,2017-12-31,27702,9830,37532
73,73443,2018-12-31,27907,9863,37770
73,73443,2019-12-31,28091,9993,38084
73,73443,2020-12-31,28263,10070,38333
73,73443,2021-12-31,28412,10036,38448
73,73443,2022-12-31,28534,10001,38535
73,73443,2023-12-31,28658,9966,38624
73,73443,2024-12-31,28788,9939,38727
73,73443,2025-12-31,28914,9922,38836
73,73443,2026-12-31,29032,9906,38938
73,73443,2027-12-31,29146,9892,39038
73,73443,2028-12-31,29235,9885,39120
73,73443,2029-12-31,29329,9887,39216
73,73443,2030-12-31,29420,9897,39317
73,73443,2031-12-31,29483,9900,39383
73,73443,2032-12-31,29548,9905,39453
73,73443,2033-12-31,29604,9925,39529
73,73443,2034-12-31,29651,9924,39575
73,73443,2035-12-31,29682,9922,39604
73,73449,1985-12-31,14034,5278,19312
73,73449,1986-12-31,14677,5282,19959
73,73449,1987-12-31,15302,5322,20624
73,73449,1988-12-31,15932,5319,21251
73,73449,1989-12-31,16558,5353,21911
73,73449,1990-12-31,17189,5362,22551
73,73449,1991-12-31,17795,5404,23199
73,73449,1992-12-31,18401,5422,23823
73,73449,1993-12-31,18986,5432,24418
73,73449,1994-12-31,19567,5465,25032
73,73449,1995-12-31,20165,5492,25657
73,73449,1996-12-31,20718,5545,26263
73,73449,1997-12-31,21200,5612,26812
73,73449,1998-12-31,21754,5641,27395
73,73449,1999-12-31,22284,5659,27943
73,73449,2000-12-31,22819,5735,28554
73,73449,2001-12-31,23324,5794,29118
73,73449,2002-12-31,23805,5849,29654
73,73449,2003-12-31,24283,5913,30196
73,73449,2004-12-31,24723,5944,30667
73,73449,2005-12-31,25112,5990,31102
73,73449,2006-12-31,25524,6028,31552
73,73449,2007-12-31,25911,6061,31972
73,73449,2008-12-31,26293,6098,32391
73,73449,2009-12-31,26668,6147,32815
73,73449,2010-12-31,27042,6200,33242
73,73449,2011-12-31,27406,6258,33664
73,73449,2012-12-31,27741,6316,34057
73,73449,2013-12-31,28090,6372,34462
73,73449,2014-12-31,28409,6428,34837
73,73449,2015-12-31,28747,6567,35314
73,73449,2016-12-31,29087,6654,35741
73,73449,2017-12-31,29411,6782,36193
73,73449,2018-12-31,29749,6787,36536
73,73449,2019-12-31,30280,6911,37191
73,73449,2020-12-31,30709,6973,37682
73,73449,2021-12-31,30845,6950,37795
73,73449,2022-12-31,30955,6925,37880
73,73449,2023-12-31,31067,6901,37968
73,73449,2024-12-31,31204,6885,38089
73,73449,2025-12-31,31352,6872,38224
73,73449,2026-12-31,31472,6849,38321
73,73449,2027-12-31,31599,6851,38450
73,73449,2028-12-31,31721,6846,38567
73,73449,2029-12-31,31807,6833,38640
73,73449,2030-12-31,31889,6855,38744
73,73449,2031-12-31,31971,6849,38820
73,73449,2032-12-31,32036,6868,38904
73,73449,2033-12-31,32092,6862,38954
73,73449,2034-12-31,32143,6866,39009
73,73449,2035-12-31,32199,6881,39080
73,73461,1985-12-31,938,2448,3386
73,73461,1986-12-31,967,2388,3355
73,73461,1987-12-31,981,2386,3367
73,73461,1988-12-31,1012,2377,3389
73,73461,1989-12-31,1046,2365,3411
73,73461,1990-12-31,1066,2336,3402
73,73461,1991-12-31,1097,2326,3423
73,73461,1992-12-31,1136,2327,3463
73,73461,1993-12-31,1162,2317,3479
73,73461,1994-12-31,1186,2294,3480
73,73461,1995-12-31,1222,2281,3503
73,73461,1996-12-31,1236,2257,3493
73,73461,1997-12-31,1289,2267,3556
73,73461,1998-12-31,1328,2264,3592
73,73461,1999-12-31,1362,2270,3632
73,73461,2000-12-31,1375,2272,3647
73,73461,2001-12-31,1395,2277,3672
73,73461,2002-12-31,1455,2288,3743
73,73461,2003-12-31,1460,2300,3760
73,73461,2004-12-31,1495,2306,3801
73,73461,2005-12-31,1503,2301,3804
73,73461,2006-12-31,1515,2301,3816
73,73461,2007-12-31,1543,2309,3852
73,73461,2008-12-31,1561,2318,3879
73,73461,2009-12-31,1575,2324,3899
73,73461,2010-12-31,1579,2317,3896
73,73461,2011-12-31,1590,2328,3918
73,73461,2012-12-31,1621,2341,3962
73,73461,2013-12-31,1651,2335,3986
73,73461,2014-12-31,1675,2340,4015
73,73461,2015-12-31,1714,2330,4044
73,73461,2016-12-31,1730,2370,4100
73,73461,2017-12-31,1749,2378,4127
73,73461,2018-12-31,1758,2355,4113
73,73461,2019-12-31,1760,2369,4129
73,73461,2020-12-31,1761,2382,4143
73,73461,2021-12-31,1781,2374,4155
73,73461,2022-12-31,1798,2366,4164
73,73461,2023-12-31,1817,2357,4174
73,73461,2024-12-31,1821,2347,4168
73,73461,2025-12-31,1829,2336,4165
73,73461,2026-12-31,1829,2335,4164
73,73461,2027-12-31,1845,2333,4178
73,73461,2028-12-31,1846,2341,4187
73,73461,2029-12-31,1855,2337,4192
73,73461,2030-12-31,1864,2332,4196
73,73461,2031-12-31,1866,2339,4205
73,73461,2032-12-31,1871,2337,4208
73,73461,2033-12-31,1874,2335,4209
73,73461,2034-12-31,1883,2336,4219
73,73461,2035-12-31,1877,2338,4215
73,73483,1985-12-31,9956,11862,21818
73,73483,1986-12-31,9981,11625,21606
73,73483,1987-12-31,9951,11421,21372
73,73483,1988-12-31,9961,11195,21156
73,73483,1989-12-31,9980,10983,20963
73,73483,1990-12-31,9961,10788,20749
73,73483,1991-12-31,9938,10575,20513
73,73483,1992-12-31,9894,10389,20283
73,73483,1993-12-31,9931,10195,20126
73,73483,1994-12-31,9864,10040,19904
73,73483,1995-12-31,9833,9837,19670
73,73483,1996-12-31,9787,9671,19458
73,73483,1997-12-31,9691,9543,19234
73,73483,1998-12-31,9645,9421,19066
73,73483,1999-12-31,9577,9296,18873
73,73483,2000-12-31,9530,9118,18648
73,73483,2001-12-31,9456,8986,18442
73,73483,2002-12-31,9370,8868,18238
73,73483,2003-12-31,9298,8730,18028
73,73483,2004-12-31,9205,8578,17783
73,73483,2005-12-31,9101,8423,17524
73,73483,2006-12-31,9007,8240,17247
73,73483,2007-12-31,8911,8110,17021
73,73483,2008-12-31,8815,8007,16822
73,73483,2009-12-31,8703,7879,16582
73,73483,2010-12-31,8615,7768,16383
73,73483,2011-12-31,8512,7653,16165
73,73483,2012-12-31,8421,7561,15982
73,73483,2013-12-31,8318,7435,15753
73,73483,2014-12-31,8202,7328,15530
73,73483,2015-12-31,8137,7254,15391
73,73483,2016-12-31,8053,7194,15247
73,73483,2017-12-31,7926,7141,15067
73,73483,2018-12-31,7841,6994,14835
73,73483,2019-12-31,7889,6833,14722
73,73483,2020-12-31,7934,6738,14672
73,73483,2021-12-31,7999,6714,14713
73,73483,2022-12-31,8055,6691,14746
73,73483,2023-12-31,8113,6667,14780
73,73483,2024-12-31,8163,6648,14811
73,73483,2025-12-31,8199,6634,14833
73,73483,2026-12-31,8232,6624,14856
73,73483,2027-12-31,8268,6612,14880
73,73483,2028-12-31,8302,6619,14921
73,73483,2029-12-31,8330,6617,14947
73,73483,2030-12-31,8344,6624,14968
73,73483,2031-12-31,8358,6626,14984
73,73483,2032-12-31,8374,6639,15013
73,73483,2033-12-31,8394,6645,15039
73,73483,2034-12-31,8406,6638,15044
73,73483,2035-12-31,8420,6634,15054
73,73504,1985-12-31,5705,30700,36405
73,73504,1986-12-31,5828,30434,36262
73,73504,1987-12-31,5894,30171,36065
73,73504,1988-12-31,5972,29908,35880
73,73504,1989-12-31,6065,29661,35726
73,73504,1990-12-31,6120,29440,35560
73,73504,1991-12-31,6198,29223,35421
73,73504,1992-12-31,6269,29007,35276
73,73504,1993-12-31,6336,28803,35139
73,73504,1994-12-31,6403,28622,35025
73,73504,1995-12-31,6469,28454,34923
73,73504,1996-12-31,6524,28297,34821
73,73504,1997-12-31,6544,28256,34800
73,73504,1998-12-31,6590,28157,34747
73,73504,1999-12-31,6648,28080,34728
73,73504,2000-12-31,6691,27953,34644
73,73504,2001-12-31,6739,27907,34646
73,73504,2002-12-31,6778,27774,34552
73,73504,2003-12-31,6815,27674,34489
73,73504,2004-12-31,6824,27634,34458
73,73504,2005-12-31,6831,27577,34408
73,73504,2006-12-31,6845,27487,34332
73,73504,2007-12-31,6871,27444,34315
73,73504,2008-12-31,6876,27372,34248
73,73504,2009-12-31,6891,27367,34258
73,73504,2010-12-31,6907,27359,34266
73,73504,2011-12-31,6916,27329,34245
73,73504,2012-12-31,6907,27328,34235
73,73504,2013-12-31,6910,27355,34265
73,73504,2014-12-31,6915,27359,34274
73,73504,2015-12-31,6933,27436,34369
73,73504,2016-12-31,6972,27479,34451
73,73504,2017-12-31,6920,27509,34429
73,73504,2018-12-31,6946,27661,34607
73,73504,2019-12-31,6991,27462,34453
73,73504,2020-12-31,7033,27287,34320
73,73504,2021-12-31,7226,27190,34416
73,73504,2022-12-31,7398,27096,34494
73,73504,2023-12-31,7574,27000,34574
73,73504,2024-12-31,7620,26917,34537
73,73504,2025-12-31,7645,26860,34505
73,73504,2026-12-31,7691,26815,34506
73,73504,2027-12-31,7712,26802,34514
73,73504,2028-12-31,7743,26787,34530
73,73504,2029-12-31,7764,26789,34553
73,73504,2030-12-31,7785,26808,34593
73,73504,2031-12-31,7805,26839,34644
73,73504,2032-12-31,7820,26861,34681
73,73504,2033-12-31,7838,26894,34732
73,73504,2034-12-31,7847,26915,34762
73,73504,2035-12-31,7851,26920,34771
73,73520,1985-12-31,0,0,0
73,73520,1986-12-31,0,0,0
73,73520,1987-12-31,0,0,0
73,73520,1988-12-31,0,0,0
73,73520,1989-12-31,0,0,0
73,73520,1990-12-31,0,0,0
73,73520,1991-12-31,0,0,0
73,73520,1992-12-31,0,0,0
73,73520,1993-12-31,0,0,0
73,73520,1994-12-31,0,0,0
73,73520,1995-12-31,0,0,0
73,73520,1996-12-31,0,0,0
73,73520,1997-12-31,3440,10378,13818
73,73520,1998-12-31,3462,10197,13659
73,73520,1999-12-31,3422,10013,13435
73,73520,2000-12-31,3417,9802,13219
73,73520,2001-12-31,3403,9596,12999
73,73520,2002-12-31,3389,9436,12825
73,73520,2003-12-31,3377,9233,12610
73,73520,2004-12-31,3349,9057,12406
73,73520,2005-12-31,3322,8838,12160
73,73520,2006-12-31,3314,8623,11937
73,73520,2007-12-31,3277,8447,11724
73,73520,2008-12-31,3228,8278,11506
73,73520,2009-12-31,3233,8111,11344
73,73520,2010-12-31,3185,7947,11132
73,73520,2011-12-31,3156,7778,10934
73,73520,2012-12-31,3156,7619,10775
73,73520,2013-12-31,3127,7439,10566
73,73520,2014-12-31,3121,7297,10418
73,73520,2015-12-31,3047,7153,10200
73,73520,2016-12-31,2975,7042,10017
73,73520,2017-12-31,2974,6889,9863
73,73520,2018-12-31,3000,6730,9730
73,73520,2019-12-31,3030,6743,9773
73,73520,2020-12-31,3061,6753,9814
73,73520,2021-12-31,3113,6730,9843
73,73520,2022-12-31,3159,6707,9866
73,73520,2023-12-31,3206,6683,9889
73,73520,2024-12-31,3222,6660,9882
73,73520,2025-12-31,3237,6646,9883
73,73520,2026-12-31,3254,6645,9899
73,73520,2027-12-31,3259,6625,9884
73,73520,2028-12-31,3272,6627,9899
73,73520,2029-12-31,3292,6622,9914
73,73520,2030-12-31,3289,6631,9920
73,73520,2031-12-31,3297,6651,9948
73,73520,2032-12-31,3308,6644,9952
73,73520,2033-12-31,3312,6650,9962
73,73520,2034-12-31,3317,6654,9971
73,73520,2035-12-31,3331,6657,9988
73,73547,1985-12-31,1570,4417,5987
73,73547,1986-12-31,1599,4352,5951
73,73547,1987-12-31,1612,4328,5940
73,73547,1988-12-31,1682,4323,6005
73,73547,1989-12-31,1707,4319,6026
73,73547,1990-12-31,1731,4274,6005
73,73547,1991-12-31,1788,4258,6046
73,73547,1992-12-31,1811,4246,6057
73,73547,1993-12-31,1846,4220,6066
73,73547,1994-12-31,1849,4220,6069
73,73547,1995-12-31,1903,4206,6109
73,73547,1996-12-31,1925,4191,6116
73,73547,1997-12-31,1947,4187,6134
73,73547,1998-12-31,1980,4175,6155
73,73547,1999-12-31,2023,4191,6214
73,73547,2000-12-31,2051,4202,6253
73,73547,2001-12-31,2066,4217,6283
73,73547,2002-12-31,2094,4235,6329
73,73547,2003-12-31,2100,4229,6329
73,73547,2004-12-31,2109,4249,6358
73,73547,2005-12-31,2124,4280,6404
73,73547,2006-12-31,2137,4266,6403
73,73547,2007-12-31,2173,4266,6439
73,73547,2008-12-31,2167,4253,6420
73,73547,2009-12-31,2198,4290,6488
73,73547,2010-12-31,2213,4329,6542
73,73547,2011-12-31,2180,4352,6532
73,73547,2012-12-31,2201,4371,6572
73,73547,2013-12-31,2176,4395,6571
73,73547,2014-12-31,2181,4417,6598
73,73547,2015-12-31,2200,4421,6621
73,73547,2016-12-31,2229,4418,6647
73,73547,2017-12-31,2256,4425,6681
73,73547,2018-12-31,2280,4431,6711
73,73547,2019-12-31,2296,4441,6737
73,73547,2020-12-31,2311,4450,6761
73,73547,2021-12-31,2346,4435,6781
73,73547,2022-12-31,2376,4420,6796
73,73547,2023-12-31,2408,4404,6812
73,73547,2024-12-31,2420,4392,6812
73,73547,2025-12-31,2435,4372,6807
73,73547,2026-12-31,2447,4367,6814
73,73547,2027-12-31,2451,4364,6815
73,73547,2028-12-31,2458,4356,6814
73,73547,2029-12-31,2460,4353,6813
73,73547,2030-12-31,2470,4366,6836
73,73547,2031-12-31,2480,4370,6850
73,73547,2032-12-31,2483,4370,6853
73,73547,2033-12-31,2490,4373,6863
73,73547,2034-12-31,2504,4379,6883
73,73547,2035-12-31,2496,4384,6880
73,73555,1985-12-31,5695,20311,26006
73,73555,1986-12-31,5768,20153,25921
73,73555,1987-12-31,5838,19997,25835
73,73555,1988-12-31,5907,19853,25760
73,73555,1989-12-31,6014,19723,25737
73,73555,1990-12-31,6085,19617,25702
73,73555,1991-12-31,6152,19487,25639
73,73555,1992-12-31,6215,19368,25583
73,73555,1993-12-31,6280,19251,25531
73,73555,1994-12-31,6339,19151,25490
73,73555,1995-12-31,6391,19057,25448
73,73555,1996-12-31,6449,18975,25424
73,73555,1997-12-31,6461,18963,25424
73,73555,1998-12-31,6503,18939,25442
73,73555,1999-12-31,6535,18893,25428
73,73555,2000-12-31,6582,18885,25467
73,73555,2001-12-31,6612,18855,25467
73,73555,2002-12-31,6647,18812,25459
73,73555,2003-12-31,6671,18773,25444
73,73555,2004-12-31,6688,18714,25402
73,73555,2005-12-31,6676,18684,25360
73,73555,2006-12-31,6689,18675,25364
73,73555,2007-12-31,6703,18663,25366
73,73555,2008-12-31,6704,18656,25360
73,73555,2009-12-31,6714,18665,25379
73,73555,2010-12-31,6726,18662,25388
73,73555,2011-12-31,6723,18664,25387
73,73555,2012-12-31,6746,18682,25428
73,73555,2013-12-31,6725,18727,25452
73,73555,2014-12-31,6727,18773,25500
73,73555,2015-12-31,6727,18798,25525
73,73555,2016-12-31,6773,18850,25623
73,73555,2017-12-31,6739,18933,25672
73,73555,2018-12-31,6736,19028,25764
73,73555,2019-12-31,6780,19005,25785
73,73555,2020-12-31,6821,18978,25799
73,73555,2021-12-31,6957,18914,25871
73,73555,2022-12-31,7081,18849,25930
73,73555,2023-12-31,7208,18782,25990
73,73555,2024-12-31,7254,18732,25986
73,73555,2025-12-31,7286,18691,25977
73,73555,2026-12-31,7327,18662,25989
73,73555,2027-12-31,7351,18649,26000
73,73555,2028-12-31,7373,18633,26006
73,73555,2029-12-31,7397,18635,26032
73,73555,2030-12-31,7418,18640,26058
73,73555,2031-12-31,7439,18668,26107
73,73555,2032-12-31,7445,18684,26129
73,73555,2033-12-31,7464,18692,26156
73,73555,2034-12-31,7479,18711,26190
73,73555,2035-12-31,7480,18713,26193
73,73563,1985-12-31,3026,7608,10634
73,73563,1986-12-31,3065,7472,10537
73,73563,1987-12-31,3122,7327,10449
73,73563,1988-12-31,3168,7211,10379
73,73563,1989-12-31,3221,7088,10309
73,73563,1990-12-31,3260,6957,10217
73,73563,1991-12-31,3286,6845,10131
73,73563,1992-12-31,3338,6729,10067
73,73563,1993-12-31,3376,6590,9966
73,73563,1994-12-31,3423,6485,9908
73,73563,1995-12-31,3445,6388,9833
73,73563,1996-12-31,3482,6314,9796
73,73563,1997-12-31,3507,6242,9749
73,73563,1998-12-31,3535,6130,9665
73,73563,1999-12-31,3552,6003,9555
73,73563,2000-12-31,3555,5952,9507
73,73563,2001-12-31,3633,5903,9536
73,73563,2002-12-31,3638,5822,9460
73,73563,2003-12-31,3603,5743,9346
73,73563,2004-12-31,3624,5661,9285
73,73563,2005-12-31,3675,5569,9244
73,73563,2006-12-31,3631,5520,9151
73,73563,2007-12-31,3657,5437,9094
73,73563,2008-12-31,3681,5349,9030
73,73563,2009-12-31,3688,5264,8952
73,73563,2010-12-31,3711,5208,8919
73,73563,2011-12-31,3712,5148,8860
73,73563,2012-12-31,3742,5097,8839
73,73563,2013-12-31,3770,5037,8807
73,73563,2014-12-31,3780,4988,8768
73,73563,2015-12-31,3774,4952,8726
73,73563,2016-12-31,3704,4901,8605
73,73563,2017-12-31,3717,4775,8492
73,73563,2018-12-31,3745,4753,8498
73,73563,2019-12-31,3758,4685,8443
73,73563,2020-12-31,3769,4646,8415
73,73563,2021-12-31,3810,4629,8439
73,73563,2022-12-31,3845,4613,8458
73,73563,2023-12-31,3880,4597,8477
73,73563,2024-12-31,3908,4578,8486
73,73563,2025-12-31,3921,4571,8492
73,73563,2026-12-31,3934,4564,8498
73,73563,2027-12-31,3960,4562,8522
73,73563,2028-12-31,3961,4561,8522
73,73563,2029-12-31,3971,4561,8532
73,73563,2030-12-31,3990,4560,8550
73,73563,2031-12-31,3999,4570,8569
73,73563,2032-12-31,4021,4569,8590
73,73563,2033-12-31,4012,4585,8597
73,73563,2034-12-31,4017,4574,8591
73,73563,2035-12-31,4025,4584,8609
73,73585,1985-12-31,10096,15692,25788
73,73585,1986-12-31,10288,15423,25711
73,73585,1987-12-31,10477,15173,25650
73,73585,1988-12-31,10661,14922,25583
73,73585,1989-12-31,10823,14683,25506
73,73585,1990-12-31,10991,14449,25440
73,73585,1991-12-31,11165,14175,25340
73,73585,1992-12-31,11318,13980,25298
73,73585,1993-12-31,11453,13781,25234
73,73585,1994-12-31,11609,13560,25169
73,73585,1995-12-31,11744,13365,25109
73,73585,1996-12-31,11884,13143,25027
73,73585,1997-12-31,11948,13032,24980
73,73585,1998-12-31,12068,12888,24956
73,73585,1999-12-31,12177,12740,24917
73,73585,2000-12-31,12301,12601,24902
73,73585,2001-12-31,12405,12411,24816
73,73585,2002-12-31,12494,12282,24776
73,73585,2003-12-31,12576,12100,24676
73,73585,2004-12-31,12639,11926,24565
73,73585,2005-12-31,12676,11760,24436
73,73585,2006-12-31,12723,11646,24369
73,73585,2007-12-31,12785,11502,24287
73,73585,2008-12-31,12825,11374,24199
73,73585,2009-12-31,12870,11243,24113
73,73585,2010-12-31,12910,11164,24074
73,73585,2011-12-31,12940,11015,23955
73,73585,2012-12-31,12992,10900,23892
73,73585,2013-12-31,13020,10775,23795
73,73585,2014-12-31,13053,10663,23716
73,73585,2015-12-31,13108,10539,23647
73,73585,2016-12-31,13117,10484,23601
73,73585,2017-12-31,13162,10431,23593
73,73585,2018-12-31,13186,10350,23536
73,73585,2019-12-31,13282,10245,23527
73,73585,2020-12-31,13374,10164,23538
73,73585,2021-12-31,13476,10128,23604
73,73585,2022-12-31,13564,10093,23657
73,73585,2023-12-31,13655,10057,23712
73,73585,2024-12-31,13738,10031,23769
73,73585,2025-12-31,13796,10011,23807
73,73585,2026-12-31,13861,9985,23846
73,73585,2027-12-31,13912,9972,23884
73,73585,2028-12-31,13957,9970,23927
73,73585,2029-12-31,14009,9972,23981
73,73585,2030-12-31,14035,9989,24024
73,73585,2031-12-31,14074,9994,24068
73,73585,2032-12-31,14107,9997,24104
73,73585,2033-12-31,14133,10000,24133
73,73585,2034-12-31,14152,10006,24158
73,73585,2035-12-31,14160,10018,24178
73,73616,1985-12-31,3351,24816,28167
73,73616,1986-12-31,3400,24497,27897
73,73616,1987-12-31,3429,24189,27618
73,73616,1988-12-31,3465,23883,27348
73,73616,1989-12-31,3498,23573,27071
73,73616,1990-12-31,3531,23304,26835
73,73616,1991-12-31,3560,23028,26588
73,73616,1992-12-31,3598,22751,26349
73,73616,1993-12-31,3626,22489,26115
73,73616,1994-12-31,3640,22238,25878
73,73616,1995-12-31,3664,22016,25680
73,73616,1996-12-31,3680,21786,25466
73,73616,1997-12-31,3695,21653,25348
73,73616,1998-12-31,3712,21472,25184
73,73616,1999-12-31,3730,21314,25044
73,73616,2000-12-31,3752,21163,24915
73,73616,2001-12-31,3774,21008,24782
73,73616,2002-12-31,3778,20833,24611
73,73616,2003-12-31,3776,20630,24406
73,73616,2004-12-31,3778,20464,24242
73,73616,2005-12-31,3767,20293,24060
73,73616,2006-12-31,3777,20174,23951
73,73616,2007-12-31,3773,20033,23806
73,73616,2008-12-31,3773,19890,23663
73,73616,2009-12-31,3740,19782,23522
73,73616,2010-12-31,3760,19653,23413
73,73616,2011-12-31,3759,19551,23310
73,73616,2012-12-31,3734,19445,23179
73,73616,2013-12-31,3749,19370,23119
73,73616,2014-12-31,3768,19254,23022
73,73616,2015-12-31,3788,19166,22954
73,73616,2016-12-31,3741,19088,22829
73,73616,2017-12-31,3720,19026,22746
73,73616,2018-12-31,3724,19047,22771
73,73616,2019-12-31,3740,18920,22660
73,73616,2020-12-31,3757,18860,22617
73,73616,2021-12-31,3887,18793,22680
73,73616,2022-12-31,4004,18728,22732
73,73616,2023-12-31,4122,18662,22784
73,73616,2024-12-31,4157,18605,22762
73,73616,2025-12-31,4170,18555,22725
73,73616,2026-12-31,4193,18543,22736
73,73616,2027-12-31,4200,18505,22705
73,73616,2028-12-31,4219,18510,22729
73,73616,2029-12-31,4223,18515,22738
73,73616,2030-12-31,4246,18526,22772
73,73616,2031-12-31,4250,18543,22793
73,73616,2032-12-31,4264,18556,22820
73,73616,2033-12-31,4269,18579,22848
73,73616,2034-12-31,4275,18594,22869
73,73616,2035-12-31,4278,18608,22886
73,73622,1985-12-31,1835,5033,6868
73,73622,1986-12-31,1854,4955,6809
73,73622,1987-12-31,1888,4879,6767
73,73622,1988-12-31,1892,4817,6709
73,73622,1989-12-31,1906,4738,6644
73,73622,1990-12-31,1888,4673,6561
73,73622,1991-12-31,1929,4593,6522
73,73622,1992-12-31,1921,4543,6464
73,73622,1993-12-31,1932,4484,6416
73,73622,1994-12-31,1947,4419,6366
73,73622,1995-12-31,1955,4369,6324
73,73622,1996-12-31,1966,4324,6290
73,73622,1997-12-31,1965,4271,6236
73,73622,1998-12-31,1967,4216,6183
73,73622,1999-12-31,1981,4182,6163
73,73622,2000-12-31,1963,4153,6116
73,73622,2001-12-31,1973,4119,6092
73,73622,2002-12-31,1924,4093,6017
73,73622,2003-12-31,1965,4058,6023
73,73622,2004-12-31,1955,4023,5978
73,73622,2005-12-31,1938,3986,5924
73,73622,2006-12-31,1944,3941,5885
73,73622,2007-12-31,1951,3905,5856
73,73622,2008-12-31,1932,3876,5808
73,73622,2009-12-31,1920,3838,5758
73,73622,2010-12-31,1918,3813,5731
73,73622,2011-12-31,1893,3768,5661
73,73622,2012-12-31,1880,3765,5645
73,73622,2013-12-31,1863,3746,5609
73,73622,2014-12-31,1839,3707,5546
73,73622,2015-12-31,1844,3667,5511
73,73622,2016-12-31,1853,3632,5485
73,73622,2017-12-31,1863,3603,5466
73,73622,2018-12-31,1875,3584,5459
73,73622,2019-12-31,1876,3591,5467
73,73622,2020-12-31,1877,3602,5479
73,73622,2021-12-31,1904,3590,5494
73,73622,2022-12-31,1930,3577,5507
73,73622,2023-12-31,1955,3565,5520
73,73622,2024-12-31,1960,3564,5524
73,73622,2025-12-31,1979,3545,5524
73,73622,2026-12-31,1982,3539,5521
73,73622,2027-12-31,1991,3536,5527
73,73622,2028-12-31,2002,3537,5539
73,73622,2029-12-31,1997,3532,5529
73,73622,2030-12-31,2011,3535,5546
73,73622,2031-12-31,2012,3544,5556
73,73622,2032-12-31,2019,3538,5557
73,73622,2033-12-31,2019,3537,5556
73,73622,2034-12-31,2025,3554,5579
73,73622,2035-12-31,2030,3552,5582
73,73624,1985-12-31,7428,18199,25627
73,73624,1986-12-31,7587,17889,25476
73,73624,1987-12-31,7737,17579,25316
73,73624,1988-12-31,7878,17269,25147
73,73624,1989-12-31,8036,16977,25013
73,73624,1990-12-31,8156,16697,24853
73,73624,1991-12-31,8287,16417,24704
73,73624,1992-12-31,8414,16141,24555
73,73624,1993-12-31,8533,15890,24423
73,73624,1994-12-31,8664,15640,24304
73,73624,1995-12-31,8805,15363,24168
73,73624,1996-12-31,8888,15136,24024
73,73624,1997-12-31,8947,14970,23917
73,73624,1998-12-31,9078,14775,23853
73,73624,1999-12-31,9157,14607,23764
73,73624,2000-12-31,9253,14416,23669
73,73624,2001-12-31,9347,14219,23566
73,73624,2002-12-31,9427,14032,23459
73,73624,2003-12-31,9499,13863,23362
73,73624,2004-12-31,9552,13661,23213
73,73624,2005-12-31,9579,13421,23000
73,73624,2006-12-31,9651,13266,22917
73,73624,2007-12-31,9670,13103,22773
73,73624,2008-12-31,9719,12950,22669
73,73624,2009-12-31,9759,12784,22543
73,73624,2010-12-31,9797,12645,22442
73,73624,2011-12-31,9855,12482,22337
73,73624,2012-12-31,9893,12336,22229
73,73624,2013-12-31,9927,12182,22109
73,73624,2014-12-31,9937,12052,21989
73,73624,2015-12-31,9979,11918,21897
73,73624,2016-12-31,10048,11760,21808
73,73624,2017-12-31,10108,11692,21800
73,73624,2018-12-31,10080,11594,21674
73,73624,2019-12-31,10146,11410,21556
73,73624,2020-12-31,10207,11284,21491
73,73624,2021-12-31,10307,11244,21551
73,73624,2022-12-31,10395,11205,21600
73,73624,2023-12-31,10485,11165,21650
73,73624,2024-12-31,10545,11136,21681
73,73624,2025-12-31,10594,11118,21712
73,73624,2026-12-31,10634,11083,21717
73,73624,2027-12-31,10686,11079,21765
73,73624,2028-12-31,10720,11062,21782
73,73624,2029-12-31,10757,11081,21838
73,73624,2030-12-31,10787,11088,21875
73,73624,2031-12-31,10815,11078,21893
73,73624,2032-12-31,10835,11112,21947
73,73624,2033-12-31,10854,11117,21971
73,73624,2034-12-31,10868,11117,21985
73,73624,2035-12-31,10897,11118,22015
73,73671,1985-12-31,6571,7945,14516
73,73671,1986-12-31,6702,7820,14522
73,73671,1987-12-31,6810,7740,14550
73,73671,1988-12-31,6926,7622,14548
73,73671,1989-12-31,7046,7524,14570
73,73671,1990-12-31,7135,7425,14560
73,73671,1991-12-31,7244,7342,14586
73,73671,1992-12-31,7340,7241,14581
73,73671,1993-12-31,7427,7129,14556
73,73671,1994-12-31,7529,7050,14579
73,73671,1995-12-31,7609,6974,14583
73,73671,1996-12-31,7696,6915,14611
73,73671,1997-12-31,7752,6880,14632
73,73671,1998-12-31,7821,6810,14631
73,73671,1999-12-31,7896,6743,14639
73,73671,2000-12-31,7974,6666,14640
73,73671,2001-12-31,8034,6625,14659
73,73671,2002-12-31,8098,6589,14687
73,73671,2003-12-31,8130,6558,14688
73,73671,2004-12-31,8193,6502,14695
73,73671,2005-12-31,8201,6445,14646
73,73671,2006-12-31,8235,6380,14615
73,73671,2007-12-31,8287,6287,14574
73,73671,2008-12-31,8292,6241,14533
73,73671,2009-12-31,8321,6195,14516
73,73671,2010-12-31,8318,6156,14474
73,73671,2011-12-31,8382,6141,14523
73,73671,2012-12-31,8392,6085,14477
73,73671,2013-12-31,8421,6035,14456
73,73671,2014-12-31,8399,6004,14403
73,73671,2015-12-31,8417,5995,14412
73,73671,2016-12-31,8532,5981,14513
73,73671,2017-12-31,8501,5945,14446
73,73671,2018-12-31,8502,5933,14435
73,73671,2019-12-31,8519,5931,14450
73,73671,2020-12-31,8544,5929,14473
73,73671,2021-12-31,8605,5909,14514
73,73671,2022-12-31,8657,5889,14546
73,73671,2023-12-31,8712,5868,14580
73,73671,2024-12-31,8759,5847,14606
73,73671,2025-12-31,8813,5835,14648
73,73671,2026-12-31,8845,5828,14673
73,73671,2027-12-31,8883,5814,14697
73,73671,2028-12-31,8907,5813,14720
73,73671,2029-12-31,8931,5817,14748
73,73671,2030-12-31,8960,5812,14772
73,73671,2031-12-31,8990,5833,14823
73,73671,2032-12-31,9002,5827,14829
73,73671,2033-12-31,9020,5841,14861
73,73671,2034-12-31,9028,5842,14870
73,73671,2035-12-31,9054,5843,14897
73,73675,1985-12-31,4981,15232,20213
73,73675,1986-12-31,4997,14921,19918
73,73675,1987-12-31,5030,14626,19656
73,73675,1988-12-31,5043,14335,19378
73,73675,1989-12-31,5069,14052,19121
73,73675,1990-12-31,5073,13799,18872
73,73675,1991-12-31,5053,13524,18577
73,73675,1992-12-31,5065,13271,18336
73,73675,1993-12-31,5072,13010,18082
73,73675,1994-12-31,5050,12716,17766
73,73675,1995-12-31,5062,12486,17548
73,73675,1996-12-31,5050,12258,17308
73,73675,1997-12-31,5026,12118,17144
73,73675,1998-12-31,5021,11917,16938
73,73675,1999-12-31,4954,11746,16700
73,73675,2000-12-31,4941,11550,16491
73,73675,2001-12-31,4940,11333,16273
73,73675,2002-12-31,4920,11157,16077
73,73675,2003-12-31,4895,10967,15862
73,73675,2004-12-31,4866,10792,15658
73,73675,2005-12-31,4828,10563,15391
73,73675,2006-12-31,4795,10368,15163
73,73675,2007-12-31,4742,10210,14952
73,73675,2008-12-31,4707,10014,14721
73,73675,2009-12-31,4668,9841,14509
73,73675,2010-12-31,4620,9684,14304
73,73675,2011-12-31,4591,9516,14107
73,73675,2012-12-31,4564,9354,13918
73,73675,2013-12-31,4530,9220,13750
73,73675,2014-12-31,4504,9078,13582
73,73675,2015-12-31,4451,8927,13378
73,73675,2016-12-31,4367,8798,13165
73,73675,2017-12-31,4333,8683,13016
73,73675,2018-12-31,4351,8545,12896
73,73675,2019-12-31,4294,8397,12691
73,73675,2020-12-31,4265,8305,12570
73,73675,2021-12-31,4330,8275,12605
73,73675,2022-12-31,4387,8247,12634
73,73675,2023-12-31,4445,8218,12663
73,73675,2024-12-31,4474,8188,12662
73,73675,2025-12-31,4493,8176,12669
73,73675,2026-12-31,4514,8160,12674
73,73675,2027-12-31,4527,8154,12681
73,73675,2028-12-31,4541,8151,12692
73,73675,2029-12-31,4555,8142,12697
73,73675,2030-12-31,4575,8161,12736
73,73675,2031-12-31,4571,8162,12733
73,73675,2032-12-31,4586,8169,12755
73,73675,2033-12-31,4602,8176,12778
73,73675,2034-12-31,4608,8180,12788
73,73675,2035-12-31,4615,8180,12795
73,73678,1985-12-31,3096,13032,16128
73,73678,1986-12-31,3127,12843,15970
73,73678,1987-12-31,3214,12671,15885
73,73678,1988-12-31,3239,12494,15733
73,73678,1989-12-31,3286,12345,15631
73,73678,1990-12-31,3304,12171,15475
73,73678,1991-12-31,3361,12025,15386
73,73678,1992-12-31,3389,11877,15266
73,73678,1993-12-31,3432,11735,15167
73,73678,1994-12-31,3473,11607,15080
73,73678,1995-12-31,3504,11459,14963
73,73678,1996-12-31,3519,11338,14857
73,73678,1997-12-31,3519,11266,14785
73,73678,1998-12-31,3589,11192,14781
73,73678,1999-12-31,3584,11099,14683
73,73678,2000-12-31,3617,11001,14618
73,73678,2001-12-31,3631,10890,14521
73,73678,2002-12-31,3665,10830,14495
73,73678,2003-12-31,3677,10704,14381
73,73678,2004-12-31,3683,10597,14280
73,73678,2005-12-31,3697,10484,14181
73,73678,2006-12-31,3692,10392,14084
73,73678,2007-12-31,3686,10317,14003
73,73678,2008-12-31,3687,10254,13941
73,73678,2009-12-31,3718,10193,13911
73,73678,2010-12-31,3742,10130,13872
73,73678,2011-12-31,3759,10067,13826
73,73678,2012-12-31,3778,9999,13777
73,73678,2013-12-31,3815,9932,13747
73,73678,2014-12-31,3833,9877,13710
73,73678,2015-12-31,3775,9844,13619
73,73678,2016-12-31,3738,9838,13576
73,73678,2017-12-31,3746,9804,13550
73,73678,2018-12-31,3765,9788,13553
73,73678,2019-12-31,3766,9715,13481
73,73678,2020-12-31,3772,9679,13451
73,73678,2021-12-31,3844,9645,13489
73,73678,2022-12-31,3908,9611,13519
73,73678,2023-12-31,3973,9577,13550
73,73678,2024-12-31,3998,9554,13552
73,73678,2025-12-31,4005,9537,13542
73,73678,2026-12-31,4030,9515,13545
73,73678,2027-12-31,4041,9503,13544
73,73678,2028-12-31,4052,9497,13549
73,73678,2029-12-31,4066,9501,13567
73,73678,2030-12-31,4084,9509,13593
73,73678,2031-12-31,4097,9513,13610
73,73678,2032-12-31,4099,9518,13617
73,73678,2033-12-31,4111,9519,13630
73,73678,2034-12-31,4119,9533,13652
73,73678,2035-12-31,4120,9539,13659
73,73686,1985-12-31,2197,5603,7800
73,73686,1986-12-31,2224,5518,7742
73,73686,1987-12-31,2236,5401,7637
73,73686,1988-12-31,2264,5299,7563
73,73686,1989-12-31,2292,5201,7493
73,73686,1990-12-31,2327,5123,7450
73,73686,1991-12-31,2323,5051,7374
73,73686,1992-12-31,2327,4959,7286
73,73686,1993-12-31,2331,4884,7215
73,73686,1994-12-31,2340,4807,7147
73,73686,1995-12-31,2348,4736,7084
73,73686,1996-12-31,2369,4675,7044
73,73686,1997-12-31,2361,4587,6948
73,73686,1998-12-31,2346,4534,6880
73,73686,1999-12-31,2379,4507,6886
73,73686,2000-12-31,2367,4441,6808
73,73686,2001-12-31,2327,4397,6724
73,73686,2002-12-31,2300,4351,6651
73,73686,2003-12-31,2302,4317,6619
73,73686,2004-12-31,2301,4271,6572
73,73686,2005-12-31,2334,4204,6538
73,73686,2006-12-31,2320,4150,6470
73,73686,2007-12-31,2303,4088,6391
73,73686,2008-12-31,2275,4066,6341
73,73686,2009-12-31,2260,3982,6242
73,73686,2010-12-31,2245,3906,6151
73,73686,2011-12-31,2250,3871,6121
73,73686,2012-12-31,2224,3835,6059
73,73686,2013-12-31,2192,3800,5992
73,73686,2014-12-31,2173,3773,5946
73,73686,2015-12-31,2146,3711,5857
73,73686,2016-12-31,2156,3646,5802
73,73686,2017-12-31,2159,3623,5782
73,73686,2018-12-31,2171,3598,5769
73,73686,2019-12-31,2153,3557,5710
73,73686,2020-12-31,2144,3529,5673
73,73686,2021-12-31,2173,3516,5689
73,73686,2022-12-31,2198,3504,5702
73,73686,2023-12-31,2223,3492,5715
73,73686,2024-12-31,2232,3485,5717
73,73686,2025-12-31,2244,3476,5720
73,73686,2026-12-31,2254,3470,5724
73,73686,2027-12-31,2258,3467,5725
73,73686,2028-12-31,2270,3468,5738
73,73686,2029-12-31,2275,3468,5743
73,73686,2030-12-31,2291,3472,5763
73,73686,2031-12-31,2285,3479,5764
73,73686,2032-12-31,2287,3471,5758
73,73686,2033-12-31,2299,3467,5766
73,73686,2034-12-31,2306,3474,5780
73,73686,2035-12-31,2301,3479,5780
73,73770,1985-12-31,1423,3419,4842
73,73770,1986-12-31,1436,3375,4811
73,73770,1987-12-31,1446,3282,4728
73,73770,1988-12-31,1452,3242,4694
73,73770,1989-12-31,1453,3180,4633
73,73770,1990-12-31,1491,3158,4649
73,73770,1991-12-31,1506,3092,4598
73,73770,1992-12-31,1522,3032,4554
73,73770,1993-12-31,1531,2991,4522
73,73770,1994-12-31,1564,2935,4499
73,73770,1995-12-31,1583,2895,4478
73,73770,1996-12-31,1593,2856,4449
73,73770,1997-12-31,1578,2826,4404
73,73770,1998-12-31,1566,2800,4366
73,73770,1999-12-31,1575,2765,4340
73,73770,2000-12-31,1587,2751,4338
73,73770,2001-12-31,1599,2728,4327
73,73770,2002-12-31,1599,2707,4306
73,73770,2003-12-31,1607,2678,4285
73,73770,2004-12-31,1589,2645,4234
73,73770,2005-12-31,1591,2598,4189
73,73770,2006-12-31,1589,2634,4223
73,73770,2007-12-31,1597,2567,4164
73,73770,2008-12-31,1617,2519,4136
73,73770,2009-12-31,1580,2476,4056
73,73770,2010-12-31,1541,2438,3979
73,73770,2011-12-31,1520,2406,3926
73,73770,2012-12-31,1538,2386,3924
73,73770,2013-12-31,1549,2351,3900
73,73770,2014-12-31,1557,2333,3890
73,73770,2015-12-31,1550,2308,3858
73,73770,2016-12-31,1537,2297,3834
73,73770,2017-12-31,1533,2284,3817
73,73770,2018-12-31,1539,2274,3813
73,73770,2019-12-31,1548,2240,3788
73,73770,2020-12-31,1557,2215,3772
73,73770,2021-12-31,1576,2207,3783
73,73770,2022-12-31,1592,2199,3791
73,73770,2023-12-31,1608,2192,3800
73,73770,2024-12-31,1612,2188,3800
73,73770,2025-12-31,1629,2183,3812
73,73770,2026-12-31,1636,2179,3815
73,73770,2027-12-31,1633,2170,3803
73,73770,2028-12-31,1639,2174,3813
73,73770,2029-12-31,1641,2176,3817
73,73770,2030-12-31,1645,2177,3822
73,73770,2031-12-31,1657,2176,3833
73,73770,2032-12-31,1664,2185,3849
73,73770,2033-12-31,1667,2175,3842
73,73770,2034-12-31,1661,2181,3842
73,73770,2035-12-31,1666,2180,3846
73,73854,1985-12-31,1652,4455,6107
73,73854,1986-12-31,1682,4397,6079
73,73854,1987-12-31,1719,4332,6051
73,73854,1988-12-31,1753,4272,6025
73,73854,1989-12-31,1764,4226,5990
73,73854,1990-12-31,1791,4118,5909
73,73854,1991-12-31,1805,4062,5867
73,73854,1992-12-31,1840,4043,5883
73,73854,1993-12-31,1873,3986,5859
73,73854,1994-12-31,1899,3911,5810
73,73854,1995-12-31,1933,3882,5815
73,73854,1996-12-31,1943,3842,5785
73,73854,1997-12-31,1960,3781,5741
73,73854,1998-12-31,1954,3749,5703
73,73854,1999-12-31,1987,3730,5717
73,73854,2000-12-31,1988,3701,5689
73,73854,2001-12-31,2006,3679,5685
73,73854,2002-12-31,2035,3652,5687
73,73854,2003-12-31,2044,3629,5673
73,73854,2004-12-31,2060,3606,5666
73,73854,2005-12-31,2049,3568,5617
73,73854,2006-12-31,2045,3567,5612
73,73854,2007-12-31,2061,3526,5587
73,73854,2008-12-31,2060,3479,5539
73,73854,2009-12-31,2078,3504,5582
73,73854,2010-12-31,2095,3471,5566
73,73854,2011-12-31,2095,3417,5512
73,73854,2012-12-31,2061,3387,5448
73,73854,2013-12-31,2042,3348,5390
73,73854,2014-12-31,2073,3319,5392
73,73854,2015-12-31,2103,3287,5390
73,73854,2016-12-31,2102,3275,5377
73,73854,2017-12-31,2098,3256,5354
73,73854,2018-12-31,2104,3241,5345
73,73854,2019-12-31,2123,3230,5353
73,73854,2020-12-31,2140,3220,5360
73,73854,2021-12-31,2166,3209,5375
73,73854,2022-12-31,2190,3197,5387
73,73854,2023-12-31,2214,3186,5400
73,73854,2024-12-31,2226,3174,5400
73,73854,2025-12-31,2235,3161,5396
73,73854,2026-12-31,2245,3156,5401
73,73854,2027-12-31,2247,3158,5405
73,73854,2028-12-31,2259,3155,5414
73,73854,2029-12-31,2279,3164,5443
73,73854,2030-12-31,2275,3154,5429
73,73854,2031-12-31,2288,3166,5454
73,73854,2032-12-31,2287,3165,5452
73,73854,2033-12-31,2284,3174,5458
73,73854,2034-12-31,2294,3180,5474
73,73854,2035-12-31,2296,3173,5469
73,73861,1985-12-31,8820,6913,15733
73,73861,1986-12-31,8881,6766,15647
73,73861,1987-12-31,8943,6637,15580
73,73861,1988-12-31,8981,6520,15501
73,73861,1989-12-31,9051,6402,15453
73,73861,1990-12-31,9094,6288,15382
73,73861,1991-12-31,9139,6173,15312
73,73861,1992-12-31,9178,6072,15250
73,73861,1993-12-31,9238,5957,15195
73,73861,1994-12-31,9236,5865,15101
73,73861,1995-12-31,9261,5767,15028
73,73861,1996-12-31,9287,5658,14945
73,73861,1997-12-31,9250,5596,14846
73,73861,1998-12-31,9265,5523,14788
73,73861,1999-12-31,9260,5409,14669
73,73861,2000-12-31,9273,5338,14611
73,73861,2001-12-31,9264,5308,14572
73,73861,2002-12-31,9258,5205,14463
73,73861,2003-12-31,9225,5161,14386
73,73861,2004-12-31,9205,5093,14298
73,73861,2005-12-31,9180,5035,14215
73,73861,2006-12-31,9143,4935,14078
73,73861,2007-12-31,9105,4863,13968
73,73861,2008-12-31,9071,4809,13880
73,73861,2009-12-31,9014,4768,13782
73,73861,2010-12-31,8982,4674,13656
73,73861,2011-12-31,8927,4559,13486
73,73861,2012-12-31,8909,4513,13422
73,73861,2013-12-31,8854,4465,13319
73,73861,2014-12-31,8798,4454,13252
73,73861,2015-12-31,8753,4349,13102
73,73861,2016-12-31,8751,4269,13020
73,73861,2017-12-31,8712,4205,12917
73,73861,2018-12-31,8639,4178,12817
73,73861,2019-12-31,8676,4075,12751
73,73861,2020-12-31,8715,4008,12723
73,73861,2021-12-31,8765,3994,12759
73,73861,2022-12-31,8807,3980,12787
73,73861,2023-12-31,8851,3966,12817
73,73861,2024-12-31,8908,3960,12868
73,73861,2025-12-31,8943,3949,12892
73,73861,2026-12-31,8983,3944,12927
73,73861,2027-12-31,9011,3940,12951
73,73861,2028-12-31,9054,3937,12991
73,73861,2029-12-31,9075,3929,13004
73,73861,2030-12-31,9105,3930,13035
73,73861,2031-12-31,9124,3945,13069
73,73861,2032-12-31,9147,3941,13088
73,73861,2033-12-31,9160,3950,13110
73,73861,2034-12-31,9181,3952,13133
73,73861,2035-12-31,9189,3954,13143
73,73870,1985-12-31,3399,10796,14195
73,73870,1986-12-31,3437,10582,14019
73,73870,1987-12-31,3443,10364,13807
73,73870,1988-12-31,3482,10160,13642
73,73870,1989-12-31,3497,9953,13450
73,73870,1990-12-31,3515,9755,13270
73,73870,1991-12-31,3551,9571,13122
73,73870,1992-12-31,3553,9367,12920
73,73870,1993-12-31,3558,9189,12747
73,73870,1994-12-31,3597,9008,12605
73,73870,1995-12-31,3611,8846,12457
73,73870,1996-12-31,3584,8673,12257
73,73870,1997-12-31,3557,8544,12101
73,73870,1998-12-31,3547,8415,11962
73,73870,1999-12-31,3571,8272,11843
73,73870,2000-12-31,3591,8117,11708
73,73870,2001-12-31,3548,7968,11516
73,73870,2002-12-31,3548,7851,11399
73,73870,2003-12-31,3564,7715,11279
73,73870,2004-12-31,3545,7584,11129
73,73870,2005-12-31,3531,7422,10953
73,73870,2006-12-31,3502,7285,10787
73,73870,2007-12-31,3493,7163,10656
73,73870,2008-12-31,3459,7028,10487
73,73870,2009-12-31,3440,6868,10308
73,73870,2010-12-31,3432,6767,10199
73,73870,2011-12-31,3432,6649,10081
73,73870,2012-12-31,3438,6526,9964
73,73870,2013-12-31,3446,6427,9873
73,73870,2014-12-31,3425,6319,9744
73,73870,2015-12-31,3355,6206,9561
73,73870,2016-12-31,3332,6142,9474
73,73870,2017-12-31,3346,6049,9395
73,73870,2018-12-31,3364,5919,9283
73,73870,2019-12-31,3354,5862,9216
73,73870,2020-12-31,3353,5833,9186
73,73870,2021-12-31,3400,5812,9212
73,73870,2022-12-31,3441,5792,9233
73,73870,2023-12-31,3482,5772,9254
73,73870,2024-12-31,3512,5762,9274
73,73870,2025-12-31,3522,5746,9268
73,73870,2026-12-31,3536,5740,9276
73,73870,2027-12-31,3547,5742,9289
73,73870,2028-12-31,3558,5724,9282
73,73870,2029-12-31,3574,5732,9306
73,73870,2030-12-31,3578,5727,9305
73,73870,2031-12-31,3586,5735,9321
73,73870,2032-12-31,3597,5752,9349
73,73870,2033-12-31,3610,5747,9357
73,73870,2034-12-31,3611,5754,9365
73,73870,2035-12-31,3616,5751,9367
73,73873,1985-12-31,2900,6803,9703
73,73873,1986-12-31,2862,6649,9511
73,73873,1987-12-31,2864,6490,9354
73,73873,1988-12-31,2860,6341,9201
73,73873,1989-12-31,2844,6197,9041
73,73873,1990-12-31,2832,6066,8898
73,73873,1991-12-31,2800,5911,8711
73,73873,1992-12-31,2797,5788,8585
73,73873,1993-12-31,2775,5634,8409
73,73873,1994-12-31,2736,5526,8262
73,73873,1995-12-31,2716,5364,8080
73,73873,1996-12-31,2734,5248,7982
73,73873,1997-12-31,2685,5163,7848
73,73873,1998-12-31,2690,5020,7710
73,73873,1999-12-31,2638,4933,7571
73,73873,2000-12-31,2582,4837,7419
73,73873,2001-12-31,2535,4741,7276
73,73873,2002-12-31,2535,4651,7186
73,73873,2003-12-31,2469,4557,7026
73,73873,2004-12-31,2435,4461,6896
73,73873,2005-12-31,2409,4364,6773
73,73873,2006-12-31,2372,4263,6635
73,73873,2007-12-31,2352,4161,6513
73,73873,2008-12-31,2348,4061,6409
73,73873,2009-12-31,2314,3967,6281
73,73873,2010-12-31,2291,3884,6175
73,73873,2011-12-31,2259,3785,6044
73,73873,2012-12-31,2209,3713,5922
73,73873,2013-12-31,2130,3632,5762
73,73873,2014-12-31,2063,3518,5581
73,73873,2015-12-31,1988,3433,5421
73,73873,2016-12-31,1969,3346,5315
73,73873,2017-12-31,1965,3232,5197
73,73873,2018-12-31,1968,3160,5128
73,73873,2019-12-31,1925,3096,5021
73,73873,2020-12-31,1902,3058,4960
73,73873,2021-12-31,1927,3047,4974
73,73873,2022-12-31,1948,3037,4985
73,73873,2023-12-31,1971,3026,4997
73,73873,2024-12-31,1984,3019,5003
73,73873,2025-12-31,1994,3012,5006
73,73873,2026-12-31,1997,3008,5005
73,73873,2027-12-31,2012,3001,5013
73,73873,2028-12-31,2016,3004,5020
73,73873,2029-12-31,2022,3006,5028
73,73873,2030-12-31,2028,2997,5025
73,73873,2031-12-31,2030,3007,5037
73,73873,2032-12-31,2034,3008,5042
73,73873,2033-12-31,2037,3017,5054
73,73873,2034-12-31,2045,3007,5052
73,73873,2035-12-31,2042,3014,5056
76,76001,1985-12-31,1557434,34435,1591869
76,76001,1986-12-31,1598398,33868,1632266
76,76001,1987-12-31,1636025,33572,1669597
76,76001,1988-12-31,1670742,33546,1704288
76,76001,1989-12-31,1702276,33667,1735943
76,76001,1990-12-31,1730804,33891,1764695
76,76001,1991-12-31,1757507,34316,1791823
76,76001,1992-12-31,1783978,34826,1818804
76,76001,1993-12-31,1811741,35483,1847224
76,76001,1994-12-31,1837184,36209,1873393
76,76001,1995-12-31,1861703,36962,1898665
76,76001,1996-12-31,1885135,37776,1922911
76,76001,1997-12-31,1907375,38601,1945976
76,76001,1998-12-31,1928263,39434,1967697
76,76001,1999-12-31,1947747,40269,1988016
76,76001,2000-12-31,1965622,41106,2006728
76,76001,2001-12-31,1981755,41916,2023671
76,76001,2002-12-31,1996452,42724,2039176
76,76001,2003-12-31,2010489,43537,2054026
76,76001,2004-12-31,2024670,44376,2069046
76,76001,2005-12-31,2039652,45244,2084896
76,76001,2006-12-31,2054618,46087,2100705
76,76001,2007-12-31,2067628,46902,2114530
76,76001,2008-12-31,2077934,47627,2125561
76,76001,2009-12-31,2087602,48378,2135980
76,76001,2010-12-31,2097362,49173,2146535
76,76001,2011-12-31,2107023,49903,2156926
76,76001,2012-12-31,2115008,50617,2165625
76,76001,2013-12-31,2120964,51240,2172204
76,76001,2014-12-31,2126942,51900,2178842
76,76001,2015-12-31,2133982,52594,2186576
76,76001,2016-12-31,2142593,53322,2195915
76,76001,2017-12-31,2151547,54068,2205615
76,76001,2018-12-31,2172527,55115,2227642
76,76001,2019-12-31,2190363,51128,2241491
76,76001,2020-12-31,2205680,46936,2252616
76,76001,2021-12-31,2217961,46787,2264748
76,76001,2022-12-31,2234309,46598,2280907
76,76001,2023-12-31,2250842,46388,2297230
76,76001,2024-12-31,2270293,46220,2316513
76,76001,2025-12-31,2291141,46041,2337182
76,76001,2026-12-31,2312726,45910,2358636
76,76001,2027-12-31,2334505,45795,2380300
76,76001,2028-12-31,2356424,45704,2402128
76,76001,2029-12-31,2378228,45639,2423867
76,76001,2030-12-31,2399878,45591,2445469
76,76001,2031-12-31,2421280,45556,2466836
76,76001,2032-12-31,2442220,45515,2487735
76,76001,2033-12-31,2462752,45462,2508214
76,76001,2034-12-31,2482769,45392,2528161
76,76001,2035-12-31,2502360,45309,2547669
76,76020,1985-12-31,7445,8170,15615
76,76020,1986-12-31,7638,7701,15339
76,76020,1987-12-31,7826,7363,15189
76,76020,1988-12-31,7998,7043,15041
76,76020,1989-12-31,8145,6835,14980
76,76020,1990-12-31,8283,6651,14934
76,76020,1991-12-31,8416,6505,14921
76,76020,1992-12-31,8535,6371,14906
76,76020,1993-12-31,8670,6239,14909
76,76020,1994-12-31,8777,6114,14891
76,76020,1995-12-31,8913,6023,14936
76,76020,1996-12-31,9041,5890,14931
76,76020,1997-12-31,9140,5814,14954
76,76020,1998-12-31,9228,5721,14949
76,76020,1999-12-31,9313,5658,14971
76,76020,2000-12-31,9414,5541,14955
76,76020,2001-12-31,9490,5444,14934
76,76020,2002-12-31,9544,5356,14900
76,76020,2003-12-31,9642,5227,14869
76,76020,2004-12-31,9691,5141,14832
76,76020,2005-12-31,9749,5046,14795
76,76020,2006-12-31,9839,4933,14772
76,76020,2007-12-31,9898,4838,14736
76,76020,2008-12-31,9951,4737,14688
76,76020,2009-12-31,10002,4627,14629
76,76020,2010-12-31,10062,4523,14585
76,76020,2011-12-31,10075,4420,14495
76,76020,2012-12-31,10093,4312,14405
76,76020,2013-12-31,10163,4197,14360
76,76020,2014-12-31,10182,4079,14261
76,76020,2015-12-31,10196,3983,14179
76,76020,2016-12-31,10293,3868,14161
76,76020,2017-12-31,10297,3782,14079
76,76020,2018-12-31,10398,3664,14062
76,76020,2019-12-31,10484,3705,14189
76,76020,2020-12-31,10557,3738,14295
76,76020,2021-12-31,10648,3727,14375
76,76020,2022-12-31,10765,3712,14477
76,76020,2023-12-31,10886,3695,14581
76,76020,2024-12-31,10997,3675,14672
76,76020,2025-12-31,11103,3671,14774
76,76020,2026-12-31,11206,3657,14863
76,76020,2027-12-31,11311,3644,14955
76,76020,2028-12-31,11411,3647,15058
76,76020,2029-12-31,11518,3632,15150
76,76020,2030-12-31,11620,3629,15249
76,76020,2031-12-31,11720,3627,15347
76,76020,2032-12-31,11816,3616,15432
76,76020,2033-12-31,11910,3616,15526
76,76020,2034-12-31,11992,3597,15589
76,76020,2035-12-31,12105,3599,15704
76,76036,1985-12-31,12347,7135,19482
76,76036,1986-12-31,12665,6788,19453
76,76036,1987-12-31,12968,6529,19497
76,76036,1988-12-31,13257,6341,19598
76,76036,1989-12-31,13515,6179,19694
76,76036,1990-12-31,13747,6082,19829
76,76036,1991-12-31,13962,5967,19929
76,76036,1992-12-31,14176,5903,20079
76,76036,1993-12-31,14401,5854,20255
76,76036,1994-12-31,14613,5808,20421
76,76036,1995-12-31,14817,5783,20600
76,76036,1996-12-31,15003,5747,20750
76,76036,1997-12-31,15174,5728,20902
76,76036,1998-12-31,15327,5715,21042
76,76036,1999-12-31,15528,5721,21249
76,76036,2000-12-31,15664,5674,21338
76,76036,2001-12-31,15795,5626,21421
76,76036,2002-12-31,15911,5593,21504
76,76036,2003-12-31,16024,5557,21581
76,76036,2004-12-31,16148,5529,21677
76,76036,2005-12-31,16269,5493,21762
76,76036,2006-12-31,16398,5477,21875
76,76036,2007-12-31,16510,5440,21950
76,76036,2008-12-31,16592,5405,21997
76,76036,2009-12-31,16649,5363,22012
76,76036,2010-12-31,16807,5327,22134
76,76036,2011-12-31,16849,5284,22133
76,76036,2012-12-31,16941,5244,22185
76,76036,2013-12-31,16986,5208,22194
76,76036,2014-12-31,17022,5178,22200
76,76036,2015-12-31,17123,5131,22254
76,76036,2016-12-31,17203,5091,22294
76,76036,2017-12-31,17205,5097,22302
76,76036,2018-12-31,17413,5023,22436
76,76036,2019-12-31,17556,4959,22515
76,76036,2020-12-31,17679,4915,22594
76,76036,2021-12-31,17817,4899,22716
76,76036,2022-12-31,17998,4880,22878
76,76036,2023-12-31,18184,4858,23042
76,76036,2024-12-31,18365,4838,23203
76,76036,2025-12-31,18545,4824,23369
76,76036,2026-12-31,18723,4801,23524
76,76036,2027-12-31,18894,4787,23681
76,76036,2028-12-31,19068,4786,23854
76,76036,2029-12-31,19237,4767,24004
76,76036,2030-12-31,19417,4768,24185
76,76036,2031-12-31,19575,4758,24333
76,76036,2032-12-31,19756,4751,24507
76,76036,2033-12-31,19908,4748,24656
76,76036,2034-12-31,20081,4738,24819
76,76036,2035-12-31,20230,4736,24966
76,76041,1985-12-31,8519,13722,22241
76,76041,1986-12-31,8700,12998,21698
76,76041,1987-12-31,8856,12437,21293
76,76041,1988-12-31,8983,11981,20964
76,76041,1989-12-31,9107,11634,20741
76,76041,1990-12-31,9198,11296,20494
76,76041,1991-12-31,9292,11031,20323
76,76041,1992-12-31,9373,10812,20185
76,76041,1993-12-31,9483,10644,20127
76,76041,1994-12-31,9566,10492,20058
76,76041,1995-12-31,9650,10364,20014
76,76041,1996-12-31,9712,10242,19954
76,76041,1997-12-31,9792,10121,19913
76,76041,1998-12-31,9849,9993,19842
76,76041,1999-12-31,9906,9870,19776
76,76041,2000-12-31,9959,9757,19716
76,76041,2001-12-31,9987,9638,19625
76,76041,2002-12-31,10019,9492,19511
76,76041,2003-12-31,10052,9353,19405
76,76041,2004-12-31,10077,9207,19284
76,76041,2005-12-31,10122,9073,19195
76,76041,2006-12-31,10142,8938,19080
76,76041,2007-12-31,10166,8810,18976
76,76041,2008-12-31,10187,8638,18825
76,76041,2009-12-31,10193,8503,18696
76,76041,2010-12-31,10191,8353,18544
76,76041,2011-12-31,10214,8217,18431
76,76041,2012-12-31,10218,8069,18287
76,76041,2013-12-31,10224,7921,18145
76,76041,2014-12-31,10194,7751,17945
76,76041,2015-12-31,10198,7603,17801
76,76041,2016-12-31,10211,7451,17662
76,76041,2017-12-31,10233,7310,17543
76,76041,2018-12-31,10285,7163,17448
76,76041,2019-12-31,10369,6979,17348
76,76041,2020-12-31,10441,6875,17316
76,76041,2021-12-31,10556,6853,17409
76,76041,2022-12-31,10707,6826,17533
76,76041,2023-12-31,10864,6795,17659
76,76041,2024-12-31,10996,6765,17761
76,76041,2025-12-31,11093,6745,17838
76,76041,2026-12-31,11195,6721,17916
76,76041,2027-12-31,11307,6706,18013
76,76041,2028-12-31,11418,6679,18097
76,76041,2029-12-31,11522,6680,18202
76,76041,2030-12-31,11626,6663,18289
76,76041,2031-12-31,11735,6668,18403
76,76041,2032-12-31,11834,6673,18507
76,76041,2033-12-31,11918,6657,18575
76,76041,2034-12-31,12013,6653,18666
76,76041,2035-12-31,12101,6631,18732
76,76054,1985-12-31,3593,6467,10060
76,76054,1986-12-31,3601,6103,9704
76,76054,1987-12-31,3629,5809,9438
76,76054,1988-12-31,3625,5546,9171
76,76054,1989-12-31,3636,5371,9007
76,76054,1990-12-31,3637,5207,8844
76,76054,1991-12-31,3603,5076,8679
76,76054,1992-12-31,3585,4963,8548
76,76054,1993-12-31,3594,4848,8442
76,76054,1994-12-31,3575,4740,8315
76,76054,1995-12-31,3569,4641,8210
76,76054,1996-12-31,3528,4559,8087
76,76054,1997-12-31,3510,4478,7988
76,76054,1998-12-31,3492,4409,7901
76,76054,1999-12-31,3510,4313,7823
76,76054,2000-12-31,3469,4228,7697
76,76054,2001-12-31,3417,4133,7550
76,76054,2002-12-31,3376,4038,7414
76,76054,2003-12-31,3353,3942,7295
76,76054,2004-12-31,3326,3860,7186
76,76054,2005-12-31,3312,3768,7080
76,76054,2006-12-31,3236,3677,6913
76,76054,2007-12-31,3170,3591,6761
76,76054,2008-12-31,3140,3502,6642
76,76054,2009-12-31,3130,3404,6534
76,76054,2010-12-31,3127,3310,6437
76,76054,2011-12-31,3104,3220,6324
76,76054,2012-12-31,3056,3099,6155
76,76054,2013-12-31,2981,3018,5999
76,76054,2014-12-31,2941,2923,5864
76,76054,2015-12-31,2859,2829,5688
76,76054,2016-12-31,2835,2729,5564
76,76054,2017-12-31,2834,2650,5484
76,76054,2018-12-31,2852,2545,5397
76,76054,2019-12-31,2811,2447,5258
76,76054,2020-12-31,2790,2387,5177
76,76054,2021-12-31,2826,2379,5205
76,76054,2022-12-31,2872,2370,5242
76,76054,2023-12-31,2921,2359,5280
76,76054,2024-12-31,2948,2352,5300
76,76054,2025-12-31,2968,2331,5299
76,76054,2026-12-31,2997,2344,5341
76,76054,2027-12-31,3033,2324,5357
76,76054,2028-12-31,3055,2312,5367
76,76054,2029-12-31,3082,2311,5393
76,76054,2030-12-31,3109,2320,5429
76,76054,2031-12-31,3138,2321,5459
76,76054,2032-12-31,3165,2323,5488
76,76054,2033-12-31,3178,2320,5498
76,76054,2034-12-31,3209,2311,5520
76,76054,2035-12-31,3236,2301,5537
76,76100,1985-12-31,3578,17859,21437
76,76100,1986-12-31,3628,17016,20644
76,76100,1987-12-31,3712,16348,20060
76,76100,1988-12-31,3778,15812,19590
76,76100,1989-12-31,3841,15407,19248
76,76100,1990-12-31,3871,15033,18904
76,76100,1991-12-31,3920,14753,18673
76,76100,1992-12-31,3960,14538,18498
76,76100,1993-12-31,4001,14389,18390
76,76100,1994-12-31,4037,14251,18288
76,76100,1995-12-31,4072,14137,18209
76,76100,1996-12-31,4094,14040,18134
76,76100,1997-12-31,4135,13942,18077
76,76100,1998-12-31,4172,13850,18022
76,76100,1999-12-31,4189,13745,17934
76,76100,2000-12-31,4198,13671,17869
76,76100,2001-12-31,4213,13595,17808
76,76100,2002-12-31,4249,13488,17737
76,76100,2003-12-31,4267,13385,17652
76,76100,2004-12-31,4270,13285,17555
76,76100,2005-12-31,4296,13190,17486
76,76100,2006-12-31,4312,13091,17403
76,76100,2007-12-31,4319,12995,17314
76,76100,2008-12-31,4355,12866,17221
76,76100,2009-12-31,4299,12755,17054
76,76100,2010-12-31,4328,12612,16940
76,76100,2011-12-31,4330,12484,16814
76,76100,2012-12-31,4348,12346,16694
76,76100,2013-12-31,4370,12181,16551
76,76100,2014-12-31,4393,12048,16441
76,76100,2015-12-31,4313,11894,16207
76,76100,2016-12-31,4327,11790,16117
76,76100,2017-12-31,4360,11640,16000
76,76100,2018-12-31,4414,11607,16021
76,76100,2019-12-31,4435,11393,15828
76,76100,2020-12-31,4452,11262,15714
76,76100,2021-12-31,4572,11226,15798
76,76100,2022-12-31,4730,11181,15911
76,76100,2023-12-31,4895,11130,16025
76,76100,2024-12-31,4981,11096,16077
76,76100,2025-12-31,5046,11058,16104
76,76100,2026-12-31,5095,11026,16121
76,76100,2027-12-31,5143,10998,16141
76,76100,2028-12-31,5199,10982,16181
76,76100,2029-12-31,5237,10957,16194
76,76100,2030-12-31,5289,10959,16248
76,76100,2031-12-31,5332,10947,16279
76,76100,2032-12-31,5376,10920,16296
76,76100,2033-12-31,5432,10917,16349
76,76100,2034-12-31,5465,10913,16378
76,76100,2035-12-31,5518,10886,16404
76,76109,1985-12-31,188155,42195,230350
76,76109,1986-12-31,192200,41664,233864
76,76109,1987-12-31,195830,41475,237305
76,76109,1988-12-31,199100,41582,240682
76,76109,1989-12-31,201967,41857,243824
76,76109,1990-12-31,204485,42321,246806
76,76109,1991-12-31,206789,42960,249749
76,76109,1992-12-31,209058,43755,252813
76,76109,1993-12-31,211462,44709,256171
76,76109,1994-12-31,213644,45751,259395
76,76109,1995-12-31,215701,46861,262562
76,76109,1996-12-31,217638,48012,265650
76,76109,1997-12-31,219427,49204,268631
76,76109,1998-12-31,221078,50395,271473
76,76109,1999-12-31,222574,51571,274145
76,76109,2000-12-31,223883,52760,276643
76,76109,2001-12-31,225003,53919,278922
76,76109,2002-12-31,225954,55064,281018
76,76109,2003-12-31,226836,56214,283050
76,76109,2004-12-31,227729,57389,285118
76,76109,2005-12-31,228754,58624,287378
76,76109,2006-12-31,229698,59863,289561
76,76109,2007-12-31,230426,61068,291494
76,76109,2008-12-31,230876,62191,293067
76,76109,2009-12-31,231266,63288,294554
76,76109,2010-12-31,231678,64402,296080
76,76109,2011-12-31,232097,65496,297593
76,76109,2012-12-31,232354,66552,298906
76,76109,2013-12-31,232378,67526,299904
76,76109,2014-12-31,232429,68466,300895
76,76109,2015-12-31,232604,69495,302099
76,76109,2016-12-31,232974,70542,303516
76,76109,2017-12-31,233380,71623,305003
76,76109,2018-12-31,235064,73124,308188
76,76109,2019-12-31,236992,73202,310194
76,76109,2020-12-31,238648,73179,311827
76,76109,2021-12-31,240547,72961,313508
76,76109,2022-12-31,243075,72668,315743
76,76109,2023-12-31,245665,72338,318003
76,76109,2024-12-31,248100,72107,320207
76,76109,2025-12-31,250479,71909,322388
76,76109,2026-12-31,252816,71714,324530
76,76109,2027-12-31,255191,71601,326792
76,76109,2028-12-31,257535,71518,329053
76,76109,2029-12-31,259899,71459,331358
76,76109,2030-12-31,262204,71435,333639
76,76109,2031-12-31,264504,71435,335939
76,76109,2032-12-31,266744,71432,338176
76,76109,2033-12-31,268949,71407,340356
76,76109,2034-12-31,271086,71366,342452
76,76109,2035-12-31,273183,71312,344495
76,76111,1985-12-31,95287,15338,110625
76,76111,1986-12-31,97062,14821,111883
76,76111,1987-12-31,98614,14459,113073
76,76111,1988-12-31,100001,14207,114208
76,76111,1989-12-31,101173,14049,115222
76,76111,1990-12-31,102158,13910,116068
76,76111,1991-12-31,103043,13863,116906
76,76111,1992-12-31,103920,13876,117796
76,76111,1993-12-31,104859,13953,118812
76,76111,1994-12-31,105649,14024,119673
76,76111,1995-12-31,106414,14117,120531
76,76111,1996-12-31,107101,14255,121356
76,76111,1997-12-31,107724,14367,122091
76,76111,1998-12-31,108272,14498,122770
76,76111,1999-12-31,108730,14603,123333
76,76111,2000-12-31,109102,14722,123824
76,76111,2001-12-31,109394,14855,124249
76,76111,2002-12-31,109613,14988,124601
76,76111,2003-12-31,109802,15134,124936
76,76111,2004-12-31,110011,15245,125256
76,76111,2005-12-31,110269,15373,125642
76,76111,2006-12-31,110535,15502,126037
76,76111,2007-12-31,110703,15611,126314
76,76111,2008-12-31,110740,15715,126455
76,76111,2009-12-31,110754,15809,126563
76,76111,2010-12-31,110775,15894,126669
76,76111,2011-12-31,110748,15994,126742
76,76111,2012-12-31,110715,16085,126800
76,76111,2013-12-31,110573,16105,126678
76,76111,2014-12-31,110383,16174,126557
76,76111,2015-12-31,110258,16235,126493
76,76111,2016-12-31,110277,16314,126591
76,76111,2017-12-31,110302,16367,126669
76,76111,2018-12-31,110905,16640,127545
76,76111,2019-12-31,110211,18105,128316
76,76111,2020-12-31,109753,19192,128945
76,76111,2021-12-31,110504,19135,129639
76,76111,2022-12-31,111506,19058,130564
76,76111,2023-12-31,112528,18971,131499
76,76111,2024-12-31,113756,18903,132659
76,76111,2025-12-31,114813,18802,133615
76,76111,2026-12-31,115906,18763,134669
76,76111,2027-12-31,116975,18712,135687
76,76111,2028-12-31,118058,18686,136744
76,76111,2029-12-31,119137,18656,137793
76,76111,2030-12-31,120214,18653,138867
76,76111,2031-12-31,121262,18632,139894
76,76111,2032-12-31,122316,18598,140914
76,76111,2033-12-31,123332,18597,141929
76,76111,2034-12-31,124314,18554,142868
76,76111,2035-12-31,125294,18533,143827
76,76113,1985-12-31,9934,17232,27166
76,76113,1986-12-31,10159,16423,26582
76,76113,1987-12-31,10355,15796,26151
76,76113,1988-12-31,10540,15282,25822
76,76113,1989-12-31,10692,14899,25591
76,76113,1990-12-31,10840,14560,25400
76,76113,1991-12-31,10967,14289,25256
76,76113,1992-12-31,11091,14114,25205
76,76113,1993-12-31,11233,13986,25219
76,76113,1994-12-31,11354,13856,25210
76,76113,1995-12-31,11471,13764,25235
76,76113,1996-12-31,11574,13693,25267
76,76113,1997-12-31,11684,13609,25293
76,76113,1998-12-31,11774,13546,25320
76,76113,1999-12-31,11849,13457,25306
76,76113,2000-12-31,11933,13375,25308
76,76113,2001-12-31,11983,13332,25315
76,76113,2002-12-31,12057,13251,25308
76,76113,2003-12-31,12109,13159,25268
76,76113,2004-12-31,12156,13079,25235
76,76113,2005-12-31,12218,13013,25231
76,76113,2006-12-31,12298,12931,25229
76,76113,2007-12-31,12323,12833,25156
76,76113,2008-12-31,12357,12730,25087
76,76113,2009-12-31,12383,12615,24998
76,76113,2010-12-31,12409,12511,24920
76,76113,2011-12-31,12435,12407,24842
76,76113,2012-12-31,12490,12265,24755
76,76113,2013-12-31,12496,12132,24628
76,76113,2014-12-31,12493,12021,24514
76,76113,2015-12-31,12552,11896,24448
76,76113,2016-12-31,12589,11763,24352
76,76113,2017-12-31,12522,11625,24147
76,76113,2018-12-31,12670,11648,24318
76,76113,2019-12-31,12659,11741,24400
76,76113,2020-12-31,12647,11818,24465
76,76113,2021-12-31,12814,11783,24597
76,76113,2022-12-31,13036,11736,24772
76,76113,2023-12-31,13268,11682,24950
76,76113,2024-12-31,13394,11645,25039
76,76113,2025-12-31,13511,11595,25106
76,76113,2026-12-31,13634,11555,25189
76,76113,2027-12-31,13758,11531,25289
76,76113,2028-12-31,13900,11504,25404
76,76113,2029-12-31,14026,11486,25512
76,76113,2030-12-31,14157,11470,25627
76,76113,2031-12-31,14290,11469,25759
76,76113,2032-12-31,14403,11470,25873
76,76113,2033-12-31,14539,11446,25985
76,76113,2034-12-31,14640,11421,26061
76,76113,2035-12-31,14753,11416,26169
76,76122,1985-12-31,25793,10401,36194
76,76122,1986-12-31,26064,9838,35902
76,76122,1987-12-31,26291,9405,35696
76,76122,1988-12-31,26442,9045,35487
76,76122,1989-12-31,26560,8771,35331
76,76122,1990-12-31,26609,8613,35222
76,76122,1991-12-31,26639,8356,34995
76,76122,1992-12-31,26667,8183,34850
76,76122,1993-12-31,26701,8055,34756
76,76122,1994-12-31,26710,7909,34619
76,76122,1995-12-31,26711,7782,34493
76,76122,1996-12-31,26694,7655,34349
76,76122,1997-12-31,26658,7525,34183
76,76122,1998-12-31,26595,7423,34018
76,76122,1999-12-31,26515,7319,33834
76,76122,2000-12-31,26428,7204,33632
76,76122,2001-12-31,26351,7095,33446
76,76122,2002-12-31,26169,6978,33147
76,76122,2003-12-31,26000,6847,32847
76,76122,2004-12-31,25862,6713,32575
76,76122,2005-12-31,25799,6606,32405
76,76122,2006-12-31,25628,6488,32116
76,76122,2007-12-31,25544,6373,31917
76,76122,2008-12-31,25395,6224,31619
76,76122,2009-12-31,25212,6120,31332
76,76122,2010-12-31,25049,5997,31046
76,76122,2011-12-31,24894,5872,30766
76,76122,2012-12-31,24724,5745,30469
76,76122,2013-12-31,24528,5619,30147
76,76122,2014-12-31,24331,5485,29816
76,76122,2015-12-31,24168,5360,29528
76,76122,2016-12-31,24000,5227,29227
76,76122,2017-12-31,23829,5127,28956
76,76122,2018-12-31,23840,4985,28825
76,76122,2019-12-31,23678,4931,28609
76,76122,2020-12-31,23608,4913,28521
76,76122,2021-12-31,23777,4897,28674
76,76122,2022-12-31,24001,4878,28879
76,76122,2023-12-31,24230,4856,29086
76,76122,2024-12-31,24473,4842,29315
76,76122,2025-12-31,24698,4814,29512
76,76122,2026-12-31,24932,4800,29732
76,76122,2027-12-31,25160,4787,29947
76,76122,2028-12-31,25386,4796,30182
76,76122,2029-12-31,25624,4769,30393
76,76122,2030-12-31,25856,4770,30626
76,76122,2031-12-31,26077,4761,30838
76,76122,2032-12-31,26302,4750,31052
76,76122,2033-12-31,26509,4734,31243
76,76122,2034-12-31,26734,4742,31476
76,76122,2035-12-31,26935,4728,31663
76,76126,1985-12-31,6112,6507,12619
76,76126,1986-12-31,6351,6270,12621
76,76126,1987-12-31,6614,6120,12734
76,76126,1988-12-31,6835,5996,12831
76,76126,1989-12-31,7076,5899,12975
76,76126,1990-12-31,7284,5864,13148
76,76126,1991-12-31,7488,5839,13327
76,76126,1992-12-31,7686,5837,13523
76,76126,1993-12-31,7913,5856,13769
76,76126,1994-12-31,8105,5869,13974
76,76126,1995-12-31,8300,5892,14192
76,76126,1996-12-31,8484,5931,14415
76,76126,1997-12-31,8667,5958,14625
76,76126,1998-12-31,8861,5999,14860
76,76126,1999-12-31,9026,6045,15071
76,76126,2000-12-31,9193,6080,15273
76,76126,2001-12-31,9353,6099,15452
76,76126,2002-12-31,9491,6139,15630
76,76126,2003-12-31,9664,6168,15832
76,76126,2004-12-31,9772,6192,15964
76,76126,2005-12-31,9935,6227,16162
76,76126,2006-12-31,10089,6265,16354
76,76126,2007-12-31,10225,6301,16526
76,76126,2008-12-31,10329,6316,16645
76,76126,2009-12-31,10464,6359,16823
76,76126,2010-12-31,10579,6400,16979
76,76126,2011-12-31,10691,6405,17096
76,76126,2012-12-31,10785,6445,17230
76,76126,2013-12-31,10888,6462,17350
76,76126,2014-12-31,11005,6499,17504
76,76126,2015-12-31,11075,6548,17623
76,76126,2016-12-31,11229,6538,17767
76,76126,2017-12-31,11326,6532,17858
76,76126,2018-12-31,11469,6585,18054
76,76126,2019-12-31,11564,6607,18171
76,76126,2020-12-31,11646,6620,18266
76,76126,2021-12-31,11764,6600,18364
76,76126,2022-12-31,11921,6574,18495
76,76126,2023-12-31,12084,6544,18628
76,76126,2024-12-31,12227,6515,18742
76,76126,2025-12-31,12342,6490,18832
76,76126,2026-12-31,12459,6487,18946
76,76126,2027-12-31,12592,6471,19063
76,76126,2028-12-31,12692,6448,19140
76,76126,2029-12-31,12807,6443,19250
76,76126,2030-12-31,12912,6440,19352
76,76126,2031-12-31,13029,6442,19471
76,76126,2032-12-31,13143,6422,19565
76,76126,2033-12-31,13249,6427,19676
76,76126,2034-12-31,13364,6402,19766
76,76126,2035-12-31,13466,6374,19840
76,76130,1985-12-31,16685,39184,55869
76,76130,1986-12-31,17128,38704,55832
76,76130,1987-12-31,17547,38565,56112
76,76130,1988-12-31,17921,38667,56588
76,76130,1989-12-31,18271,38962,57233
76,76130,1990-12-31,18582,39405,57987
76,76130,1991-12-31,18880,40024,58904
76,76130,1992-12-31,19178,40751,59929
76,76130,1993-12-31,19480,41673,61153
76,76130,1994-12-31,19770,42656,62426
76,76130,1995-12-31,20041,43694,63735
76,76130,1996-12-31,20303,44780,65083
76,76130,1997-12-31,20555,45889,66444
76,76130,1998-12-31,20792,47007,67799
76,76130,1999-12-31,21017,48145,69162
76,76130,2000-12-31,21187,49252,70439
76,76130,2001-12-31,21375,50367,71742
76,76130,2002-12-31,21549,51448,72997
76,76130,2003-12-31,21691,52533,74224
76,76130,2004-12-31,21869,53643,75512
76,76130,2005-12-31,22027,54819,76846
76,76130,2006-12-31,22215,55973,78188
76,76130,2007-12-31,22324,57068,79392
76,76130,2008-12-31,22518,58085,80603
76,76130,2009-12-31,22608,59109,81717
76,76130,2010-12-31,22732,60149,82881
76,76130,2011-12-31,22818,61146,83964
76,76130,2012-12-31,22909,62115,85024
76,76130,2013-12-31,22998,63014,86012
76,76130,2014-12-31,23055,63913,86968
76,76130,2015-12-31,23176,64842,88018
76,76130,2016-12-31,23273,65857,89130
76,76130,2017-12-31,23300,66823,90123
76,76130,2018-12-31,23579,68246,91825
76,76130,2019-12-31,23773,69410,93183
76,76130,2020-12-31,23940,70271,94211
76,76130,2021-12-31,24674,70062,94736
76,76130,2022-12-31,25632,69781,95413
76,76130,2023-12-31,26633,69463,96096
76,76130,2024-12-31,27210,69154,96364
76,76130,2025-12-31,27583,68938,96521
76,76130,2026-12-31,27867,68730,96597
76,76130,2027-12-31,28131,68566,96697
76,76130,2028-12-31,28402,68456,96858
76,76130,2029-12-31,28644,68377,97021
76,76130,2030-12-31,28916,68310,97226
76,76130,2031-12-31,29152,68280,97432
76,76130,2032-12-31,29414,68233,97647
76,76130,2033-12-31,29643,68156,97799
76,76130,2034-12-31,29884,68091,97975
76,76130,2035-12-31,30119,68002,98121
76,76147,1985-12-31,107204,6872,114076
76,76147,1986-12-31,109432,6532,115964
76,76147,1987-12-31,111420,6242,117662
76,76147,1988-12-31,113196,6021,119217
76,76147,1989-12-31,114756,5844,120600
76,76147,1990-12-31,116112,5729,121841
76,76147,1991-12-31,117341,5630,122971
76,76147,1992-12-31,118556,5526,124082
76,76147,1993-12-31,119844,5456,125300
76,76147,1994-12-31,120981,5401,126382
76,76147,1995-12-31,122067,5343,127410
76,76147,1996-12-31,123080,5284,128364
76,76147,1997-12-31,124002,5257,129259
76,76147,1998-12-31,124848,5208,130056
76,76147,1999-12-31,125590,5173,130763
76,76147,2000-12-31,126234,5108,131342
76,76147,2001-12-31,126779,5070,131849
76,76147,2002-12-31,127241,5011,132252
76,76147,2003-12-31,127660,4948,132608
76,76147,2004-12-31,128104,4907,133011
76,76147,2005-12-31,128600,4850,133450
76,76147,2006-12-31,129107,4792,133899
76,76147,2007-12-31,129485,4738,134223
76,76147,2008-12-31,129708,4686,134394
76,76147,2009-12-31,129898,4626,134524
76,76147,2010-12-31,130081,4554,134635
76,76147,2011-12-31,130281,4507,134788
76,76147,2012-12-31,130387,4442,134829
76,76147,2013-12-31,130374,4380,134754
76,76147,2014-12-31,130359,4325,134684
76,76147,2015-12-31,130398,4247,134645
76,76147,2016-12-31,130558,4201,134759
76,76147,2017-12-31,130767,4156,134923
76,76147,2018-12-31,131641,4088,135729
76,76147,2019-12-31,132199,4397,136596
76,76147,2020-12-31,132653,4649,137302
76,76147,2021-12-31,133407,4635,138042
76,76147,2022-12-31,134409,4617,139026
76,76147,2023-12-31,135426,4596,140022
76,76147,2024-12-31,136540,4575,141115
76,76147,2025-12-31,137695,4560,142255
76,76147,2026-12-31,138897,4541,143438
76,76147,2027-12-31,140127,4530,144657
76,76147,2028-12-31,141383,4530,145913
76,76147,2029-12-31,142645,4523,147168
76,76147,2030-12-31,143898,4516,148414
76,76147,2031-12-31,145151,4513,149664
76,76147,2032-12-31,146378,4507,150885
76,76147,2033-12-31,147586,4509,152095
76,76147,2034-12-31,148774,4491,153265
76,76147,2035-12-31,149916,4484,154400
76,76233,1985-12-31,8364,30430,38794
76,76233,1986-12-31,8568,29548,38116
76,76233,1987-12-31,8745,28948,37693
76,76233,1988-12-31,8913,28576,37489
76,76233,1989-12-31,9038,28354,37392
76,76233,1990-12-31,9171,28235,37406
76,76233,1991-12-31,9300,28292,37592
76,76233,1992-12-31,9407,28429,37836
76,76233,1993-12-31,9526,28687,38213
76,76233,1994-12-31,9650,28989,38639
76,76233,1995-12-31,9754,29337,39091
76,76233,1996-12-31,9866,29711,39577
76,76233,1997-12-31,9948,30100,40048
76,76233,1998-12-31,10026,30487,40513
76,76233,1999-12-31,10106,30879,40985
76,76233,2000-12-31,10177,31275,41452
76,76233,2001-12-31,10259,31646,41905
76,76233,2002-12-31,10304,32011,42315
76,76233,2003-12-31,10348,32408,42756
76,76233,2004-12-31,10413,32794,43207
76,76233,2005-12-31,10467,33203,43670
76,76233,2006-12-31,10533,33588,44121
76,76233,2007-12-31,10584,33963,44547
76,76233,2008-12-31,10612,34287,44899
76,76233,2009-12-31,10634,34600,45234
76,76233,2010-12-31,10665,34924,45589
76,76233,2011-12-31,10698,35239,45937
76,76233,2012-12-31,10732,35583,46315
76,76233,2013-12-31,10768,35854,46622
76,76233,2014-12-31,10761,36072,46833
76,76233,2015-12-31,10714,36303,47017
76,76233,2016-12-31,10790,36637,47427
76,76233,2017-12-31,10786,36991,47777
76,76233,2018-12-31,10930,37513,48443
76,76233,2019-12-31,10984,37774,48758
76,76233,2020-12-31,11025,37990,49015
76,76233,2021-12-31,11402,37877,49279
76,76233,2022-12-31,11906,37725,49631
76,76233,2023-12-31,12433,37553,49986
76,76233,2024-12-31,12717,37396,50113
76,76233,2025-12-31,12877,37275,50152
76,76233,2026-12-31,13021,37163,50184
76,76233,2027-12-31,13139,37081,50220
76,76233,2028-12-31,13249,36994,50243
76,76233,2029-12-31,13385,36949,50334
76,76233,2030-12-31,13486,36918,50404
76,76233,2031-12-31,13604,36899,50503
76,76233,2032-12-31,13703,36855,50558
76,76233,2033-12-31,13829,36799,50628
76,76233,2034-12-31,13929,36748,50677
76,76233,2035-12-31,14047,36692,50739
76,76243,1985-12-31,2918,12664,15582
76,76243,1986-12-31,2925,12002,14927
76,76243,1987-12-31,2935,11476,14411
76,76243,1988-12-31,2941,11041,13982
76,76243,1989-12-31,2925,10701,13626
76,76243,1990-12-31,2932,10400,13332
76,76243,1991-12-31,2925,10158,13083
76,76243,1992-12-31,2925,9970,12895
76,76243,1993-12-31,2923,9794,12717
76,76243,1994-12-31,2919,9664,12583
76,76243,1995-12-31,2901,9528,12429
76,76243,1996-12-31,2888,9409,12297
76,76243,1997-12-31,2869,9301,12170
76,76243,1998-12-31,2864,9169,12033
76,76243,1999-12-31,2828,9058,11886
76,76243,2000-12-31,2830,8961,11791
76,76243,2001-12-31,2828,8834,11662
76,76243,2002-12-31,2803,8697,11500
76,76243,2003-12-31,2778,8557,11335
76,76243,2004-12-31,2708,8430,11138
76,76243,2005-12-31,2681,8286,10967
76,76243,2006-12-31,2638,8183,10821
76,76243,2007-12-31,2614,8043,10657
76,76243,2008-12-31,2637,7900,10537
76,76243,2009-12-31,2618,7763,10381
76,76243,2010-12-31,2609,7623,10232
76,76243,2011-12-31,2602,7489,10091
76,76243,2012-12-31,2540,7357,9897
76,76243,2013-12-31,2476,7202,9678
76,76243,2014-12-31,2408,7069,9477
76,76243,2015-12-31,2379,6915,9294
76,76243,2016-12-31,2380,6797,9177
76,76243,2017-12-31,2388,6641,9029
76,76243,2018-12-31,2407,6502,8909
76,76243,2019-12-31,2378,6318,8696
76,76243,2020-12-31,2360,6202,8562
76,76243,2021-12-31,2426,6182,8608
76,76243,2022-12-31,2513,6157,8670
76,76243,2023-12-31,2603,6129,8732
76,76243,2024-12-31,2632,6103,8735
76,76243,2025-12-31,2662,6081,8743
76,76243,2026-12-31,2682,6058,8740
76,76243,2027-12-31,2701,6051,8752
76,76243,2028-12-31,2730,6037,8767
76,76243,2029-12-31,2758,6031,8789
76,76243,2030-12-31,2777,6007,8784
76,76243,2031-12-31,2804,6012,8816
76,76243,2032-12-31,2826,6011,8837
76,76243,2033-12-31,2857,6004,8861
76,76243,2034-12-31,2881,5985,8866
76,76243,2035-12-31,2886,5978,8864
76,76246,1985-12-31,3766,10221,13987
76,76246,1986-12-31,3807,9640,13447
76,76246,1987-12-31,3828,9147,12975
76,76246,1988-12-31,3826,8753,12579
76,76246,1989-12-31,3844,8417,12261
76,76246,1990-12-31,3842,8151,11993
76,76246,1991-12-31,3830,7917,11747
76,76246,1992-12-31,3826,7711,11537
76,76246,1993-12-31,3789,7542,11331
76,76246,1994-12-31,3809,7376,11185
76,76246,1995-12-31,3797,7224,11021
76,76246,1996-12-31,3782,7076,10858
76,76246,1997-12-31,3774,6920,10694
76,76246,1998-12-31,3780,6809,10589
76,76246,1999-12-31,3752,6664,10416
76,76246,2000-12-31,3719,6504,10223
76,76246,2001-12-31,3705,6351,10056
76,76246,2002-12-31,3674,6196,9870
76,76246,2003-12-31,3646,6034,9680
76,76246,2004-12-31,3620,5893,9513
76,76246,2005-12-31,3594,5732,9326
76,76246,2006-12-31,3569,5588,9157
76,76246,2007-12-31,3521,5432,8953
76,76246,2008-12-31,3514,5268,8782
76,76246,2009-12-31,3466,5110,8576
76,76246,2010-12-31,3443,4946,8389
76,76246,2011-12-31,3395,4777,8172
76,76246,2012-12-31,3377,4614,7991
76,76246,2013-12-31,3360,4461,7821
76,76246,2014-12-31,3300,4304,7604
76,76246,2015-12-31,3261,4131,7392
76,76246,2016-12-31,3188,3961,7149
76,76246,2017-12-31,3164,3833,6997
76,76246,2018-12-31,3198,3647,6845
76,76246,2019-12-31,3151,3486,6637
76,76246,2020-12-31,3122,3384,6506
76,76246,2021-12-31,3168,3373,6541
76,76246,2022-12-31,3228,3360,6588
76,76246,2023-12-31,3291,3344,6635
76,76246,2024-12-31,3320,3335,6655
76,76246,2025-12-31,3353,3325,6678
76,76246,2026-12-31,3381,3306,6687
76,76246,2027-12-31,3413,3303,6716
76,76246,2028-12-31,3445,3284,6729
76,76246,2029-12-31,3466,3281,6747
76,76246,2030-12-31,3502,3294,6796
76,76246,2031-12-31,3532,3275,6807
76,76246,2032-12-31,3564,3268,6832
76,76246,2033-12-31,3590,3265,6855
76,76246,2034-12-31,3613,3278,6891
76,76246,2035-12-31,3657,3261,6918
76,76248,1985-12-31,27768,21581,49349
76,76248,1986-12-31,28400,20766,49166
76,76248,1987-12-31,28980,20159,49139
76,76248,1988-12-31,29511,19714,49225
76,76248,1989-12-31,29978,19404,49382
76,76248,1990-12-31,30381,19145,49526
76,76248,1991-12-31,30764,18988,49752
76,76248,1992-12-31,31157,18922,50079
76,76248,1993-12-31,31543,18932,50475
76,76248,1994-12-31,31908,18961,50869
76,76248,1995-12-31,32253,19016,51269
76,76248,1996-12-31,32575,19097,51672
76,76248,1997-12-31,32884,19177,52061
76,76248,1998-12-31,33179,19269,52448
76,76248,1999-12-31,33416,19369,52785
76,76248,2000-12-31,33658,19435,53093
76,76248,2001-12-31,33847,19525,53372
76,76248,2002-12-31,34012,19608,53620
76,76248,2003-12-31,34207,19712,53919
76,76248,2004-12-31,34370,19791,54161
76,76248,2005-12-31,34541,19869,54410
76,76248,2006-12-31,34744,19953,54697
76,76248,2007-12-31,34893,20022,54915
76,76248,2008-12-31,35005,20070,55075
76,76248,2009-12-31,35086,20103,55189
76,76248,2010-12-31,35191,20153,55344
76,76248,2011-12-31,35302,20179,55481
76,76248,2012-12-31,35361,20214,55575
76,76248,2013-12-31,35411,20218,55629
76,76248,2014-12-31,35448,20208,55656
76,76248,2015-12-31,35508,20217,55725
76,76248,2016-12-31,35598,20278,55876
76,76248,2017-12-31,35624,20255,55879
76,76248,2018-12-31,35977,20493,56470
76,76248,2019-12-31,36068,20767,56835
76,76248,2020-12-31,36160,20973,57133
76,76248,2021-12-31,36530,20911,57441
76,76248,2022-12-31,37024,20827,57851
76,76248,2023-12-31,37533,20732,58265
76,76248,2024-12-31,37867,20660,58527
76,76248,2025-12-31,38234,20580,58814
76,76248,2026-12-31,38598,20518,59116
76,76248,2027-12-31,38951,20453,59404
76,76248,2028-12-31,39315,20418,59733
76,76248,2029-12-31,39678,20388,60066
76,76248,2030-12-31,40037,20357,60394
76,76248,2031-12-31,40392,20346,60738
76,76248,2032-12-31,40742,20324,61066
76,76248,2033-12-31,41067,20307,61374
76,76248,2034-12-31,41410,20273,61683
76,76248,2035-12-31,41717,20237,61954
76,76250,1985-12-31,5059,10221,15280
76,76250,1986-12-31,5133,9621,14754
76,76250,1987-12-31,5206,9139,14345
76,76250,1988-12-31,5279,8691,13970
76,76250,1989-12-31,5299,8390,13689
76,76250,1990-12-31,5327,8125,13452
76,76250,1991-12-31,5359,7869,13228
76,76250,1992-12-31,5387,7685,13072
76,76250,1993-12-31,5428,7507,12935
76,76250,1994-12-31,5464,7327,12791
76,76250,1995-12-31,5480,7176,12656
76,76250,1996-12-31,5509,7023,12532
76,76250,1997-12-31,5524,6868,12392
76,76250,1998-12-31,5534,6736,12270
76,76250,1999-12-31,5533,6585,12118
76,76250,2000-12-31,5544,6438,11982
76,76250,2001-12-31,5554,6273,11827
76,76250,2002-12-31,5534,6116,11650
76,76250,2003-12-31,5542,5953,11495
76,76250,2004-12-31,5530,5792,11322
76,76250,2005-12-31,5547,5620,11167
76,76250,2006-12-31,5544,5488,11032
76,76250,2007-12-31,5541,5318,10859
76,76250,2008-12-31,5502,5161,10663
76,76250,2009-12-31,5478,4990,10468
76,76250,2010-12-31,5506,4828,10334
76,76250,2011-12-31,5506,4669,10175
76,76250,2012-12-31,5492,4490,9982
76,76250,2013-12-31,5438,4314,9752
76,76250,2014-12-31,5425,4164,9589
76,76250,2015-12-31,5379,3985,9364
76,76250,2016-12-31,5332,3822,9154
76,76250,2017-12-31,5347,3652,8999
76,76250,2018-12-31,5397,3489,8886
76,76250,2019-12-31,5399,3312,8711
76,76250,2020-12-31,5413,3203,8616
76,76250,2021-12-31,5469,3193,8662
76,76250,2022-12-31,5544,3180,8724
76,76250,2023-12-31,5621,3166,8787
76,76250,2024-12-31,5670,3157,8827
76,76250,2025-12-31,5729,3149,8878
76,76250,2026-12-31,5779,3148,8927
76,76250,2027-12-31,5836,3143,8979
76,76250,2028-12-31,5894,3124,9018
76,76250,2029-12-31,5941,3125,9066
76,76250,2030-12-31,6002,3114,9116
76,76250,2031-12-31,6060,3119,9179
76,76250,2032-12-31,6105,3118,9223
76,76250,2033-12-31,6155,3113,9268
76,76250,2034-12-31,6205,3104,9309
76,76250,2035-12-31,6252,3097,9349
76,76275,1985-12-31,35393,12466,47859
76,76275,1986-12-31,36034,12157,48191
76,76275,1987-12-31,36563,11969,48532
76,76275,1988-12-31,37040,11884,48924
76,76275,1989-12-31,37436,11862,49298
76,76275,1990-12-31,37774,11857,49631
76,76275,1991-12-31,38077,11918,49995
76,76275,1992-12-31,38364,12015,50379
76,76275,1993-12-31,38682,12182,50864
76,76275,1994-12-31,38941,12359,51300
76,76275,1995-12-31,39203,12536,51739
76,76275,1996-12-31,39419,12761,52180
76,76275,1997-12-31,39616,12985,52601
76,76275,1998-12-31,39788,13198,52986
76,76275,1999-12-31,39939,13413,53352
76,76275,2000-12-31,40058,13630,53688
76,76275,2001-12-31,40136,13867,54003
76,76275,2002-12-31,40198,14069,54267
76,76275,2003-12-31,40236,14274,54510
76,76275,2004-12-31,40280,14484,54764
76,76275,2005-12-31,40345,14706,55051
76,76275,2006-12-31,40405,14928,55333
76,76275,2007-12-31,40447,15136,55583
76,76275,2008-12-31,40422,15321,55743
76,76275,2009-12-31,40387,15518,55905
76,76275,2010-12-31,40360,15696,56056
76,76275,2011-12-31,40332,15878,56210
76,76275,2012-12-31,40277,16051,56328
76,76275,2013-12-31,40204,16178,56382
76,76275,2014-12-31,40110,16325,56435
76,76275,2015-12-31,40055,16475,56530
76,76275,2016-12-31,40054,16659,56713
76,76275,2017-12-31,39988,16891,56879
76,76275,2018-12-31,40195,17179,57374
76,76275,2019-12-31,40285,17411,57696
76,76275,2020-12-31,40411,17550,57961
76,76275,2021-12-31,40775,17498,58273
76,76275,2022-12-31,41261,17428,58689
76,76275,2023-12-31,41761,17348,59109
76,76275,2024-12-31,42149,17248,59397
76,76275,2025-12-31,42536,17208,59744
76,76275,2026-12-31,42931,17159,60090
76,76275,2027-12-31,43318,17124,60442
76,76275,2028-12-31,43717,17093,60810
76,76275,2029-12-31,44120,17063,61183
76,76275,2030-12-31,44512,17053,61565
76,76275,2031-12-31,44896,17046,61942
76,76275,2032-12-31,45291,17030,62321
76,76275,2033-12-31,45658,17008,62666
76,76275,2034-12-31,46023,16988,63011
76,76275,2035-12-31,46388,16965,63353
76,76306,1985-12-31,6135,11592,17727
76,76306,1986-12-31,6324,11194,17518
76,76306,1987-12-31,6550,10908,17458
76,76306,1988-12-31,6748,10725,17473
76,76306,1989-12-31,6932,10602,17534
76,76306,1990-12-31,7090,10508,17598
76,76306,1991-12-31,7250,10463,17713
76,76306,1992-12-31,7405,10463,17868
76,76306,1993-12-31,7534,10506,18040
76,76306,1994-12-31,7737,10576,18313
76,76306,1995-12-31,7901,10643,18544
76,76306,1996-12-31,8048,10730,18778
76,76306,1997-12-31,8198,10824,19022
76,76306,1998-12-31,8342,10928,19270
76,76306,1999-12-31,8447,11022,19469
76,76306,2000-12-31,8583,11135,19718
76,76306,2001-12-31,8696,11239,19935
76,76306,2002-12-31,8797,11310,20107
76,76306,2003-12-31,8913,11392,20305
76,76306,2004-12-31,9012,11467,20479
76,76306,2005-12-31,9121,11571,20692
76,76306,2006-12-31,9211,11673,20884
76,76306,2007-12-31,9328,11756,21084
76,76306,2008-12-31,9417,11842,21259
76,76306,2009-12-31,9559,11879,21438
76,76306,2010-12-31,9593,11963,21556
76,76306,2011-12-31,9670,12039,21709
76,76306,2012-12-31,9753,12088,21841
76,76306,2013-12-31,9824,12139,21963
76,76306,2014-12-31,9921,12162,22083
76,76306,2015-12-31,9958,12231,22189
76,76306,2016-12-31,10129,12252,22381
76,76306,2017-12-31,10106,12279,22385
76,76306,2018-12-31,10242,12499,22741
76,76306,2019-12-31,10358,12550,22908
76,76306,2020-12-31,10449,12597,23046
76,76306,2021-12-31,10614,12560,23174
76,76306,2022-12-31,10831,12509,23340
76,76306,2023-12-31,11055,12452,23507
76,76306,2024-12-31,11238,12380,23618
76,76306,2025-12-31,11382,12345,23727
76,76306,2026-12-31,11512,12312,23824
76,76306,2027-12-31,11630,12284,23914
76,76306,2028-12-31,11747,12261,24008
76,76306,2029-12-31,11853,12250,24103
76,76306,2030-12-31,11952,12241,24193
76,76306,2031-12-31,12070,12217,24287
76,76306,2032-12-31,12172,12209,24381
76,76306,2033-12-31,12251,12211,24462
76,76306,2034-12-31,12360,12198,24558
76,76306,2035-12-31,12465,12170,24635
76,76318,1985-12-31,14484,15518,30002
76,76318,1986-12-31,14870,14878,29748
76,76318,1987-12-31,15228,14366,29594
76,76318,1988-12-31,15559,13971,29530
76,76318,1989-12-31,15861,13702,29563
76,76318,1990-12-31,16134,13455,29589
76,76318,1991-12-31,16383,13272,29655
76,76318,1992-12-31,16636,13179,29815
76,76318,1993-12-31,16915,13131,30046
76,76318,1994-12-31,17153,13098,30251
76,76318,1995-12-31,17393,13084,30477
76,76318,1996-12-31,17618,13085,30703
76,76318,1997-12-31,17820,13078,30898
76,76318,1998-12-31,18023,13101,31124
76,76318,1999-12-31,18211,13091,31302
76,76318,2000-12-31,18395,13084,31479
76,76318,2001-12-31,18541,13117,31658
76,76318,2002-12-31,18689,13118,31807
76,76318,2003-12-31,18833,13110,31943
76,76318,2004-12-31,18958,13103,32061
76,76318,2005-12-31,19101,13106,32207
76,76318,2006-12-31,19258,13101,32359
76,76318,2007-12-31,19383,13095,32478
76,76318,2008-12-31,19474,13076,32550
76,76318,2009-12-31,19579,13040,32619
76,76318,2010-12-31,19682,13022,32704
76,76318,2011-12-31,19764,12989,32753
76,76318,2012-12-31,19838,12907,32745
76,76318,2013-12-31,19916,12855,32771
76,76318,2014-12-31,19995,12802,32797
76,76318,2015-12-31,20035,12773,32808
76,76318,2016-12-31,20124,12714,32838
76,76318,2017-12-31,20222,12688,32910
76,76318,2018-12-31,20421,12770,33191
76,76318,2019-12-31,20589,12816,33405
76,76318,2020-12-31,20733,12845,33578
76,76318,2021-12-31,20952,12807,33759
76,76318,2022-12-31,21245,12755,34000
76,76318,2023-12-31,21546,12697,34243
76,76318,2024-12-31,21798,12646,34444
76,76318,2025-12-31,22021,12591,34612
76,76318,2026-12-31,22221,12559,34780
76,76318,2027-12-31,22430,12532,34962
76,76318,2028-12-31,22649,12492,35141
76,76318,2029-12-31,22848,12481,35329
76,76318,2030-12-31,23060,12473,35533
76,76318,2031-12-31,23247,12471,35718
76,76318,2032-12-31,23451,12467,35918
76,76318,2033-12-31,23644,12438,36082
76,76318,2034-12-31,23842,12425,36267
76,76318,2035-12-31,24019,12397,36416
76,76364,1985-12-31,24833,24812,49645
76,76364,1986-12-31,28436,24296,52732
76,76364,1987-12-31,32038,23968,56006
76,76364,1988-12-31,35599,23840,59439
76,76364,1989-12-31,39153,23836,62989
76,76364,1990-12-31,42644,23902,66546
76,76364,1991-12-31,46113,24079,70192
76,76364,1992-12-31,49563,24376,73939
76,76364,1993-12-31,53066,24729,77795
76,76364,1994-12-31,56495,25166,81661
76,76364,1995-12-31,59901,25606,85507
76,76364,1996-12-31,63265,26076,89341
76,76364,1997-12-31,66592,26566,93158
76,76364,1998-12-31,69858,27061,96919
76,76364,1999-12-31,73065,27567,100632
76,76364,2000-12-31,76217,28053,104270
76,76364,2001-12-31,79243,28529,107772
76,76364,2002-12-31,82214,29005,111219
76,76364,2003-12-31,85125,29497,114622
76,76364,2004-12-31,88014,29996,118010
76,76364,2005-12-31,90934,30496,121430
76,76364,2006-12-31,93822,30995,124817
76,76364,2007-12-31,96591,31483,128074
76,76364,2008-12-31,99220,31922,131142
76,76364,2009-12-31,101789,32336,134125
76,76364,2010-12-31,104328,32787,137115
76,76364,2011-12-31,106841,33225,140066
76,76364,2012-12-31,109238,33635,142873
76,76364,2013-12-31,111498,34029,145527
76,76364,2014-12-31,113748,34374,148122
76,76364,2015-12-31,116010,34767,150777
76,76364,2016-12-31,118343,35182,153525
76,76364,2017-12-31,120671,35642,156313
76,76364,2018-12-31,123615,36262,159877
76,76364,2019-12-31,127409,36750,164159
76,76364,2020-12-31,130114,37033,167147
76,76364,2021-12-31,131156,36923,168079
76,76364,2022-12-31,132505,36775,169280
76,76364,2023-12-31,133885,36607,170492
76,76364,2024-12-31,135157,36487,171644
76,76364,2025-12-31,136458,36363,172821
76,76364,2026-12-31,137735,36262,173997
76,76364,2027-12-31,139036,36173,175209
76,76364,2028-12-31,140323,36111,176434
76,76364,2029-12-31,141617,36055,177672
76,76364,2030-12-31,142909,36020,178929
76,76364,2031-12-31,144162,35998,180160
76,76364,2032-12-31,145417,35959,181376
76,76364,2033-12-31,146630,35918,182548
76,76364,2034-12-31,147797,35878,183675
76,76364,2035-12-31,148963,35823,184786
76,76377,1985-12-31,2178,11538,13716
76,76377,1986-12-31,2158,11183,13341
76,76377,1987-12-31,2212,10972,13184
76,76377,1988-12-31,2263,10763,13026
76,76377,1989-12-31,2315,10672,12987
76,76377,1990-12-31,2359,10564,12923
76,76377,1991-12-31,2394,10560,12954
76,76377,1992-12-31,2433,10610,13043
76,76377,1993-12-31,2456,10687,13143
76,76377,1994-12-31,2490,10764,13254
76,76377,1995-12-31,2509,10874,13383
76,76377,1996-12-31,2535,10977,13512
76,76377,1997-12-31,2584,11104,13688
76,76377,1998-12-31,2609,11210,13819
76,76377,1999-12-31,2626,11328,13954
76,76377,2000-12-31,2663,11478,14141
76,76377,2001-12-31,2674,11605,14279
76,76377,2002-12-31,2697,11720,14417
76,76377,2003-12-31,2717,11844,14561
76,76377,2004-12-31,2734,11963,14697
76,76377,2005-12-31,2761,12102,14863
76,76377,2006-12-31,2741,12227,14968
76,76377,2007-12-31,2759,12348,15107
76,76377,2008-12-31,2785,12446,15231
76,76377,2009-12-31,2739,12516,15255
76,76377,2010-12-31,2780,12632,15412
76,76377,2011-12-31,2814,12709,15523
76,76377,2012-12-31,2848,12805,15653
76,76377,2013-12-31,2851,12869,15720
76,76377,2014-12-31,2797,12924,15721
76,76377,2015-12-31,2817,13020,15837
76,76377,2016-12-31,2851,13106,15957
76,76377,2017-12-31,2864,13221,16085
76,76377,2018-12-31,2901,13415,16316
76,76377,2019-12-31,2925,13497,16422
76,76377,2020-12-31,2945,13564,16509
76,76377,2021-12-31,3074,13524,16598
76,76377,2022-12-31,3247,13469,16716
76,76377,2023-12-31,3428,13408,16836
76,76377,2024-12-31,3523,13362,16885
76,76377,2025-12-31,3569,13308,16877
76,76377,2026-12-31,3612,13260,16872
76,76377,2027-12-31,3659,13217,16876
76,76377,2028-12-31,3689,13192,16881
76,76377,2029-12-31,3714,13180,16894
76,76377,2030-12-31,3751,13155,16906
76,76377,2031-12-31,3779,13152,16931
76,76377,2032-12-31,3808,13129,16937
76,76377,2033-12-31,3843,13109,16952
76,76377,2034-12-31,3881,13078,16959
76,76377,2035-12-31,3910,13048,16958
76,76400,1985-12-31,16270,8500,24770
76,76400,1986-12-31,16834,8137,24971
76,76400,1987-12-31,17372,7876,25248
76,76400,1988-12-31,17894,7662,25556
76,76400,1989-12-31,18358,7484,25842
76,76400,1990-12-31,18810,7385,26195
76,76400,1991-12-31,19233,7319,26552
76,76400,1992-12-31,19661,7251,26912
76,76400,1993-12-31,20088,7208,27296
76,76400,1994-12-31,20516,7170,27686
76,76400,1995-12-31,20904,7180,28084
76,76400,1996-12-31,21300,7177,28477
76,76400,1997-12-31,21671,7172,28843
76,76400,1998-12-31,22019,7175,29194
76,76400,1999-12-31,22373,7203,29576
76,76400,2000-12-31,22690,7194,29884
76,76400,2001-12-31,22998,7171,30169
76,76400,2002-12-31,23287,7175,30462
76,76400,2003-12-31,23563,7157,30720
76,76400,2004-12-31,23845,7145,30990
76,76400,2005-12-31,24119,7132,31251
76,76400,2006-12-31,24413,7146,31559
76,76400,2007-12-31,24669,7131,31800
76,76400,2008-12-31,24896,7127,32023
76,76400,2009-12-31,25117,7106,32223
76,76400,2010-12-31,25333,7106,32439
76,76400,2011-12-31,25550,7099,32649
76,76400,2012-12-31,25730,7060,32790
76,76400,2013-12-31,25889,7083,32972
76,76400,2014-12-31,26076,7031,33107
76,76400,2015-12-31,26255,6990,33245
76,76400,2016-12-31,26447,6965,33412
76,76400,2017-12-31,26617,6931,33548
76,76400,2018-12-31,26991,6962,33953
76,76400,2019-12-31,27329,6915,34244
76,76400,2020-12-31,27603,6890,34493
76,76400,2021-12-31,27817,6868,34685
76,76400,2022-12-31,28092,6841,34933
76,76400,2023-12-31,28374,6809,35183
76,76400,2024-12-31,28646,6778,35424
76,76400,2025-12-31,28935,6766,35701
76,76400,2026-12-31,29202,6748,35950
76,76400,2027-12-31,29480,6716,36196
76,76400,2028-12-31,29754,6705,36459
76,76400,2029-12-31,30039,6697,36736
76,76400,2030-12-31,30308,6699,37007
76,76400,2031-12-31,30594,6664,37258
76,76400,2032-12-31,30850,6685,37535
76,76400,2033-12-31,31116,6679,37795
76,76400,2034-12-31,31372,6634,38006
76,76400,2035-12-31,31614,6640,38254
76,76403,1985-12-31,9671,7973,17644
76,76403,1986-12-31,9780,7525,17305
76,76403,1987-12-31,9864,7144,17008
76,76403,1988-12-31,9923,6862,16785
76,76403,1989-12-31,9972,6589,16561
76,76403,1990-12-31,9993,6409,16402
76,76403,1991-12-31,10006,6224,16230
76,76403,1992-12-31,10034,6065,16099
76,76403,1993-12-31,10043,5934,15977
76,76403,1994-12-31,10055,5804,15859
76,76403,1995-12-31,10052,5692,15744
76,76403,1996-12-31,10044,5594,15638
76,76403,1997-12-31,10062,5504,15566
76,76403,1998-12-31,10031,5419,15450
76,76403,1999-12-31,10014,5315,15329
76,76403,2000-12-31,9967,5208,15175
76,76403,2001-12-31,9948,5073,15021
76,76403,2002-12-31,9899,4982,14881
76,76403,2003-12-31,9847,4846,14693
76,76403,2004-12-31,9807,4751,14558
76,76403,2005-12-31,9762,4644,14406
76,76403,2006-12-31,9727,4508,14235
76,76403,2007-12-31,9681,4412,14093
76,76403,2008-12-31,9638,4289,13927
76,76403,2009-12-31,9553,4159,13712
76,76403,2010-12-31,9545,4056,13601
76,76403,2011-12-31,9450,3936,13386
76,76403,2012-12-31,9378,3816,13194
76,76403,2013-12-31,9268,3688,12956
76,76403,2014-12-31,9207,3569,12776
76,76403,2015-12-31,9232,3455,12687
76,76403,2016-12-31,9088,3320,12408
76,76403,2017-12-31,9060,3234,12294
76,76403,2018-12-31,9082,3092,12174
76,76403,2019-12-31,9022,2959,11981
76,76403,2020-12-31,9001,2866,11867
76,76403,2021-12-31,9074,2857,11931
76,76403,2022-12-31,9171,2845,12016
76,76403,2023-12-31,9270,2832,12102
76,76403,2024-12-31,9355,2815,12170
76,76403,2025-12-31,9443,2808,12251
76,76403,2026-12-31,9533,2798,12331
76,76403,2027-12-31,9622,2790,12412
76,76403,2028-12-31,9720,2783,12503
76,76403,2029-12-31,9810,2791,12601
76,76403,2030-12-31,9902,2782,12684
76,76403,2031-12-31,9983,2780,12763
76,76403,2032-12-31,10073,2783,12856
76,76403,2033-12-31,10154,2759,12913
76,76403,2034-12-31,10238,2767,13005
76,76403,2035-12-31,10321,2759,13080
76,76497,1985-12-31,8720,8685,17405
76,76497,1986-12-31,8856,8166,17022
76,76497,1987-12-31,8926,7774,16700
76,76497,1988-12-31,9004,7461,16465
76,76497,1989-12-31,9085,7185,16270
76,76497,1990-12-31,9135,6982,16117
76,76497,1991-12-31,9179,6786,15965
76,76497,1992-12-31,9225,6621,15846
76,76497,1993-12-31,9269,6485,15754
76,76497,1994-12-31,9288,6343,15631
76,76497,1995-12-31,9325,6220,15545
76,76497,1996-12-31,9336,6110,15446
76,76497,1997-12-31,9336,5983,15319
76,76497,1998-12-31,9390,5883,15273
76,76497,1999-12-31,9391,5783,15174
76,76497,2000-12-31,9384,5690,15074
76,76497,2001-12-31,9374,5542,14916
76,76497,2002-12-31,9358,5401,14759
76,76497,2003-12-31,9338,5294,14632
76,76497,2004-12-31,9321,5170,14491
76,76497,2005-12-31,9303,5028,14331
76,76497,2006-12-31,9302,4930,14232
76,76497,2007-12-31,9273,4780,14053
76,76497,2008-12-31,9246,4663,13909
76,76497,2009-12-31,9219,4537,13756
76,76497,2010-12-31,9184,4416,13600
76,76497,2011-12-31,9145,4284,13429
76,76497,2012-12-31,9124,4130,13254
76,76497,2013-12-31,9067,4005,13072
76,76497,2014-12-31,9034,3886,12920
76,76497,2015-12-31,9031,3754,12785
76,76497,2016-12-31,8946,3614,12560
76,76497,2017-12-31,8894,3500,12394
76,76497,2018-12-31,8949,3363,12312
76,76497,2019-12-31,9036,3104,12140
76,76497,2020-12-31,9114,2928,12042
76,76497,2021-12-31,9188,2919,12107
76,76497,2022-12-31,9286,2907,12193
76,76497,2023-12-31,9387,2894,12281
76,76497,2024-12-31,9488,2876,12364
76,76497,2025-12-31,9605,2875,12480
76,76497,2026-12-31,9711,2870,12581
76,76497,2027-12-31,9834,2852,12686
76,76497,2028-12-31,9941,2855,12796
76,76497,2029-12-31,10062,2842,12904
76,76497,2030-12-31,10190,2837,13027
76,76497,2031-12-31,10321,2846,13167
76,76497,2032-12-31,10435,2838,13273
76,76497,2033-12-31,10567,2833,13400
76,76497,2034-12-31,10705,2833,13538
76,76497,2035-12-31,10844,2827,13671
76,76520,1985-12-31,205316,51161,256477
76,76520,1986-12-31,210346,50045,260391
76,76520,1987-12-31,214933,49378,264311
76,76520,1988-12-31,219126,49086,268212
76,76520,1989-12-31,222895,49009,271904
76,76520,1990-12-31,226275,49175,275450
76,76520,1991-12-31,229409,49555,278964
76,76520,1992-12-31,232529,50101,282630
76,76520,1993-12-31,235798,50849,286647
76,76520,1994-12-31,238761,51693,290454
76,76520,1995-12-31,241606,52600,294206
76,76520,1996-12-31,244315,53564,297879
76,76520,1997-12-31,246871,54550,301421
76,76520,1998-12-31,249233,55557,304790
76,76520,1999-12-31,251425,56559,307984
76,76520,2000-12-31,253401,57548,310949
76,76520,2001-12-31,255172,58529,313701
76,76520,2002-12-31,256754,59500,316254
76,76520,2003-12-31,258251,60440,318691
76,76520,2004-12-31,259791,61438,321229
76,76520,2005-12-31,261409,62459,323868
76,76520,2006-12-31,263094,63470,326564
76,76520,2007-12-31,264506,64443,328949
76,76520,2008-12-31,265576,65322,330898
76,76520,2009-12-31,266546,66197,332743
76,76520,2010-12-31,267574,67093,334667
76,76520,2011-12-31,268559,67961,336520
76,76520,2012-12-31,269347,68774,338121
76,76520,2013-12-31,269872,69526,339398
76,76520,2014-12-31,270403,70267,340670
76,76520,2015-12-31,271046,71033,342079
76,76520,2016-12-31,271950,71885,343835
76,76520,2017-12-31,272871,72778,345649
76,76520,2018-12-31,275254,74040,349294
76,76520,2019-12-31,277519,74497,352016
76,76520,2020-12-31,279465,74820,354285
76,76520,2021-12-31,281662,74597,356259
76,76520,2022-12-31,284508,74298,358806
76,76520,2023-12-31,287415,73960,361375
76,76520,2024-12-31,290261,73651,363912
76,76520,2025-12-31,293050,73387,366437
76,76520,2026-12-31,295844,73146,368990
76,76520,2027-12-31,298651,72982,371633
76,76520,2028-12-31,301463,72851,374314
76,76520,2029-12-31,304216,72738,376954
76,76520,2030-12-31,306960,72682,379642
76,76520,2031-12-31,309666,72636,382302
76,76520,2032-12-31,312329,72567,384896
76,76520,2033-12-31,314921,72492,387413
76,76520,2034-12-31,317446,72402,389848
76,76520,2035-12-31,319903,72276,392179
76,76563,1985-12-31,31848,7452,39300
76,76563,1986-12-31,32587,7151,39738
76,76563,1987-12-31,33258,6911,40169
76,76563,1988-12-31,33853,6723,40576
76,76563,1989-12-31,34401,6583,40984
76,76563,1990-12-31,34882,6511,41393
76,76563,1991-12-31,35332,6426,41758
76,76563,1992-12-31,35771,6379,42150
76,76563,1993-12-31,36233,6387,42620
76,76563,1994-12-31,36650,6347,42997
76,76563,1995-12-31,37048,6327,43375
76,76563,1996-12-31,37435,6335,43770
76,76563,1997-12-31,37795,6337,44132
76,76563,1998-12-31,38127,6331,44458
76,76563,1999-12-31,38426,6348,44774
76,76563,2000-12-31,38700,6359,45059
76,76563,2001-12-31,38926,6341,45267
76,76563,2002-12-31,39145,6337,45482
76,76563,2003-12-31,39349,6327,45676
76,76563,2004-12-31,39550,6319,45869
76,76563,2005-12-31,39763,6310,46073
76,76563,2006-12-31,39976,6318,46294
76,76563,2007-12-31,40155,6305,46460
76,76563,2008-12-31,40281,6297,46578
76,76563,2009-12-31,40392,6293,46685
76,76563,2010-12-31,40516,6289,46805
76,76563,2011-12-31,40626,6288,46914
76,76563,2012-12-31,40717,6259,46976
76,76563,2013-12-31,40758,6289,47047
76,76563,2014-12-31,40815,6247,47062
76,76563,2015-12-31,40896,6209,47105
76,76563,2016-12-31,41000,6181,47181
76,76563,2017-12-31,41094,6167,47261
76,76563,2018-12-31,41422,6193,47615
76,76563,2019-12-31,41761,6157,47918
76,76563,2020-12-31,42052,6113,48165
76,76563,2021-12-31,42330,6094,48424
76,76563,2022-12-31,42701,6069,48770
76,76563,2023-12-31,43078,6041,49119
76,76563,2024-12-31,43419,6018,49437
76,76563,2025-12-31,43828,5992,49820
76,76563,2026-12-31,44233,5988,50221
76,76563,2027-12-31,44642,5967,50609
76,76563,2028-12-31,45052,5942,50994
76,76563,2029-12-31,45476,5945,51421
76,76563,2030-12-31,45873,5927,51800
76,76563,2031-12-31,46275,5935,52210
76,76563,2032-12-31,46649,5928,52577
76,76563,2033-12-31,47049,5919,52968
76,76563,2034-12-31,47426,5906,53332
76,76563,2035-12-31,47805,5909,53714
76,76606,1985-12-31,6111,8761,14872
76,76606,1986-12-31,6322,8348,14670
76,76606,1987-12-31,6527,7997,14524
76,76606,1988-12-31,6722,7719,14441
76,76606,1989-12-31,6892,7479,14371
76,76606,1990-12-31,7046,7336,14382
76,76606,1991-12-31,7216,7180,14396
76,76606,1992-12-31,7377,7061,14438
76,76606,1993-12-31,7532,6973,14505
76,76606,1994-12-31,7672,6902,14574
76,76606,1995-12-31,7826,6842,14668
76,76606,1996-12-31,7985,6767,14752
76,76606,1997-12-31,8111,6704,14815
76,76606,1998-12-31,8245,6654,14899
76,76606,1999-12-31,8360,6612,14972
76,76606,2000-12-31,8475,6546,15021
76,76606,2001-12-31,8601,6481,15082
76,76606,2002-12-31,8690,6419,15109
76,76606,2003-12-31,8753,6342,15095
76,76606,2004-12-31,8884,6276,15160
76,76606,2005-12-31,9005,6193,15198
76,76606,2006-12-31,9054,6136,15190
76,76606,2007-12-31,9187,6090,15277
76,76606,2008-12-31,9289,6013,15302
76,76606,2009-12-31,9353,5972,15325
76,76606,2010-12-31,9439,5819,15258
76,76606,2011-12-31,9533,5796,15329
76,76606,2012-12-31,9585,5702,15287
76,76606,2013-12-31,9643,5621,15264
76,76606,2014-12-31,9722,5544,15266
76,76606,2015-12-31,9773,5475,15248
76,76606,2016-12-31,9870,5416,15286
76,76606,2017-12-31,9923,5307,15230
76,76606,2018-12-31,10047,5260,15307
76,76606,2019-12-31,10130,5165,15295
76,76606,2020-12-31,10201,5103,15304
76,76606,2021-12-31,10299,5087,15386
76,76606,2022-12-31,10430,5066,15496
76,76606,2023-12-31,10564,5043,15607
76,76606,2024-12-31,10682,5021,15703
76,76606,2025-12-31,10775,5009,15784
76,76606,2026-12-31,10881,4994,15875
76,76606,2027-12-31,10979,4982,15961
76,76606,2028-12-31,11079,4973,16052
76,76606,2029-12-31,11188,4966,16154
76,76606,2030-12-31,11289,4965,16254
76,76606,2031-12-31,11390,4955,16345
76,76606,2032-12-31,11488,4946,16434
76,76606,2033-12-31,11573,4925,16498
76,76606,2034-12-31,11670,4921,16591
76,76606,2035-12-31,11753,4922,16675
76,76616,1985-12-31,3747,14957,18704
76,76616,1986-12-31,3942,14178,18120
76,76616,1987-12-31,4096,13573,17669
76,76616,1988-12-31,4239,13088,17327
76,76616,1989-12-31,4404,12715,17119
76,76616,1990-12-31,4551,12370,16921
76,76616,1991-12-31,4688,12086,16774
76,76616,1992-12-31,4819,11863,16682
76,76616,1993-12-31,4966,11692,16658
76,76616,1994-12-31,5093,11539,16632
76,76616,1995-12-31,5213,11407,16620
76,76616,1996-12-31,5347,11271,16618
76,76616,1997-12-31,5485,11156,16641
76,76616,1998-12-31,5594,11026,16620
76,76616,1999-12-31,5709,10905,16614
76,76616,2000-12-31,5824,10805,16629
76,76616,2001-12-31,5905,10685,16590
76,76616,2002-12-31,6056,10538,16594
76,76616,2003-12-31,6094,10397,16491
76,76616,2004-12-31,6222,10255,16477
76,76616,2005-12-31,6306,10130,16436
76,76616,2006-12-31,6397,9994,16391
76,76616,2007-12-31,6497,9854,16351
76,76616,2008-12-31,6597,9710,16307
76,76616,2009-12-31,6651,9531,16182
76,76616,2010-12-31,6763,9426,16189
76,76616,2011-12-31,6843,9239,16082
76,76616,2012-12-31,6888,9120,16008
76,76616,2013-12-31,6985,8945,15930
76,76616,2014-12-31,7032,8782,15814
76,76616,2015-12-31,7094,8640,15734
76,76616,2016-12-31,7139,8475,15614
76,76616,2017-12-31,7256,8332,15588
76,76616,2018-12-31,7358,8196,15554
76,76616,2019-12-31,7356,8127,15483
76,76616,2020-12-31,7348,8115,15463
76,76616,2021-12-31,7457,8089,15546
76,76616,2022-12-31,7600,8057,15657
76,76616,2023-12-31,7749,8020,15769
76,76616,2024-12-31,7820,7982,15802
76,76616,2025-12-31,7896,7950,15846
76,76616,2026-12-31,7965,7934,15899
76,76616,2027-12-31,8045,7913,15958
76,76616,2028-12-31,8118,7889,16007
76,76616,2029-12-31,8192,7882,16074
76,76616,2030-12-31,8266,7871,16137
76,76616,2031-12-31,8344,7862,16206
76,76616,2032-12-31,8406,7855,16261
76,76616,2033-12-31,8480,7852,16332
76,76616,2034-12-31,8551,7826,16377
76,76616,2035-12-31,8622,7808,16430
76,76622,1985-12-31,18193,18639,36832
76,76622,1986-12-31,18741,17654,36395
76,76622,1987-12-31,19251,16867,36118
76,76622,1988-12-31,19741,16233,35974
76,76622,1989-12-31,20178,15722,35900
76,76622,1990-12-31,20592,15244,35836
76,76622,1991-12-31,20973,14869,35842
76,76622,1992-12-31,21363,14580,35943
76,76622,1993-12-31,21769,14330,36099
76,76622,1994-12-31,22151,14107,36258
76,76622,1995-12-31,22509,13893,36402
76,76622,1996-12-31,22855,13693,36548
76,76622,1997-12-31,23191,13511,36702
76,76622,1998-12-31,23512,13318,36830
76,76622,1999-12-31,23804,13120,36924
76,76622,2000-12-31,24086,12926,37012
76,76622,2001-12-31,24344,12775,37119
76,76622,2002-12-31,24589,12582,37171
76,76622,2003-12-31,24816,12380,37196
76,76622,2004-12-31,25051,12179,37230
76,76622,2005-12-31,25291,11996,37287
76,76622,2006-12-31,25542,11791,37333
76,76622,2007-12-31,25759,11607,37366
76,76622,2008-12-31,25945,11371,37316
76,76622,2009-12-31,26112,11150,37262
76,76622,2010-12-31,26296,10927,37223
76,76622,2011-12-31,26466,10710,37176
76,76622,2012-12-31,26615,10486,37101
76,76622,2013-12-31,26735,10249,36984
76,76622,2014-12-31,26873,10017,36890
76,76622,2015-12-31,27003,9786,36789
76,76622,2016-12-31,27174,9572,36746
76,76622,2017-12-31,27327,9347,36674
76,76622,2018-12-31,27626,9171,36797
76,76622,2019-12-31,27854,8913,36767
76,76622,2020-12-31,28050,8736,36786
76,76622,2021-12-31,28276,8708,36984
76,76622,2022-12-31,28575,8673,37248
76,76622,2023-12-31,28881,8634,37515
76,76622,2024-12-31,29176,8598,37774
76,76622,2025-12-31,29451,8578,38029
76,76622,2026-12-31,29732,8556,38288
76,76622,2027-12-31,30034,8525,38559
76,76622,2028-12-31,30304,8503,38807
76,76622,2029-12-31,30585,8491,39076
76,76622,2030-12-31,30865,8479,39344
76,76622,2031-12-31,31136,8470,39606
76,76622,2032-12-31,31413,8467,39880
76,76622,2033-12-31,31680,8445,40125
76,76622,2034-12-31,31941,8440,40381
76,76622,2035-12-31,32179,8420,40599
76,76670,1985-12-31,3744,10511,14255
76,76670,1986-12-31,3917,10111,14028
76,76670,1987-12-31,4081,9782,13863
76,76670,1988-12-31,4244,9547,13791
76,76670,1989-12-31,4405,9358,13763
76,76670,1990-12-31,4590,9191,13781
76,76670,1991-12-31,4702,9146,13848
76,76670,1992-12-31,4878,9075,13953
76,76670,1993-12-31,4963,9055,14018
76,76670,1994-12-31,5167,9066,14233
76,76670,1995-12-31,5269,9076,14345
76,76670,1996-12-31,5420,9112,14532
76,76670,1997-12-31,5527,9142,14669
76,76670,1998-12-31,5673,9160,14833
76,76670,1999-12-31,5794,9188,14982
76,76670,2000-12-31,5914,9228,15142
76,76670,2001-12-31,6034,9240,15274
76,76670,2002-12-31,6133,9258,15391
76,76670,2003-12-31,6218,9261,15479
76,76670,2004-12-31,6365,9282,15647
76,76670,2005-12-31,6433,9288,15721
76,76670,2006-12-31,6534,9311,15845
76,76670,2007-12-31,6661,9330,15991
76,76670,2008-12-31,6727,9335,16062
76,76670,2009-12-31,6819,9340,16159
76,76670,2010-12-31,6911,9341,16252
76,76670,2011-12-31,6984,9347,16331
76,76670,2012-12-31,7074,9351,16425
76,76670,2013-12-31,7167,9370,16537
76,76670,2014-12-31,7194,9346,16540
76,76670,2015-12-31,7332,9373,16705
76,76670,2016-12-31,7305,9332,16637
76,76670,2017-12-31,7477,9304,16781
76,76670,2018-12-31,7571,9371,16942
76,76670,2019-12-31,7686,9396,17082
76,76670,2020-12-31,7776,9425,17201
76,76670,2021-12-31,7900,9397,17297
76,76670,2022-12-31,8061,9359,17420
76,76670,2023-12-31,8228,9317,17545
76,76670,2024-12-31,8418,9269,17687
76,76670,2025-12-31,8617,9245,17862
76,76670,2026-12-31,8826,9207,18033
76,76670,2027-12-31,9025,9198,18223
76,76670,2028-12-31,9224,9182,18406
76,76670,2029-12-31,9416,9165,18581
76,76670,2030-12-31,9591,9163,18754
76,76670,2031-12-31,9754,9153,18907
76,76670,2032-12-31,9895,9122,19017
76,76670,2033-12-31,10032,9132,19164
76,76670,2034-12-31,10154,9115,19269
76,76670,2035-12-31,10275,9110,19385
76,76736,1985-12-31,36691,24957,61648
76,76736,1986-12-31,37009,23570,60579
76,76736,1987-12-31,37245,22471,59716
76,76736,1988-12-31,37407,21581,58988
76,76736,1989-12-31,37495,20849,58344
76,76736,1990-12-31,37507,20208,57715
76,76736,1991-12-31,37477,19648,57125
76,76736,1992-12-31,37434,19195,56629
76,76736,1993-12-31,37423,18804,56227
76,76736,1994-12-31,37365,18440,55805
76,76736,1995-12-31,37287,18093,55380
76,76736,1996-12-31,37178,17770,54948
76,76736,1997-12-31,37071,17428,54499
76,76736,1998-12-31,36909,17120,54029
76,76736,1999-12-31,36733,16801,53534
76,76736,2000-12-31,36531,16453,52984
76,76736,2001-12-31,36301,16147,52448
76,76736,2002-12-31,36049,15833,51882
76,76736,2003-12-31,35798,15509,51307
76,76736,2004-12-31,35555,15206,50761
76,76736,2005-12-31,35323,14895,50218
76,76736,2006-12-31,35095,14562,49657
76,76736,2007-12-31,34852,14229,49081
76,76736,2008-12-31,34562,13887,48449
76,76736,2009-12-31,34273,13511,47784
76,76736,2010-12-31,33968,13139,47107
76,76736,2011-12-31,33695,12761,46456
76,76736,2012-12-31,33390,12411,45801
76,76736,2013-12-31,33060,12031,45091
76,76736,2014-12-31,32736,11672,44408
76,76736,2015-12-31,32434,11319,43753
76,76736,2016-12-31,32174,10945,43119
76,76736,2017-12-31,31875,10591,42466
76,76736,2018-12-31,31816,10317,42133
76,76736,2019-12-31,31496,10007,41503
76,76736,2020-12-31,31331,9822,41153
76,76736,2021-12-31,31583,9791,41374
76,76736,2022-12-31,31918,9752,41670
76,76736,2023-12-31,32261,9707,41968
76,76736,2024-12-31,32553,9668,42221
76,76736,2025-12-31,32862,9621,42483
76,76736,2026-12-31,33176,9596,42772
76,76736,2027-12-31,33488,9568,43056
76,76736,2028-12-31,33787,9556,43343
76,76736,2029-12-31,34109,9527,43636
76,76736,2030-12-31,34432,9526,43958
76,76736,2031-12-31,34732,9531,44263
76,76736,2032-12-31,35021,9512,44533
76,76736,2033-12-31,35308,9496,44804
76,76736,2034-12-31,35591,9489,45080
76,76736,2035-12-31,35880,9453,45333
76,76823,1985-12-31,9133,8923,18056
76,76823,1986-12-31,9281,8451,17732
76,76823,1987-12-31,9401,8063,17464
76,76823,1988-12-31,9510,7750,17260
76,76823,1989-12-31,9596,7507,17103
76,76823,1990-12-31,9677,7346,17023
76,76823,1991-12-31,9737,7185,16922
76,76823,1992-12-31,9805,7024,16829
76,76823,1993-12-31,9869,6916,16785
76,76823,1994-12-31,9923,6817,16740
76,76823,1995-12-31,9958,6747,16705
76,76823,1996-12-31,10012,6651,16663
76,76823,1997-12-31,10052,6574,16626
76,76823,1998-12-31,10070,6466,16536
76,76823,1999-12-31,10113,6452,16565
76,76823,2000-12-31,10112,6353,16465
76,76823,2001-12-31,10138,6240,16378
76,76823,2002-12-31,10132,6152,16284
76,76823,2003-12-31,10132,6064,16196
76,76823,2004-12-31,10122,5976,16098
76,76823,2005-12-31,10094,5891,15985
76,76823,2006-12-31,10122,5810,15932
76,76823,2007-12-31,10133,5718,15851
76,76823,2008-12-31,10133,5615,15748
76,76823,2009-12-31,10133,5542,15675
76,76823,2010-12-31,10116,5449,15565
76,76823,2011-12-31,10106,5283,15389
76,76823,2012-12-31,10071,5246,15317
76,76823,2013-12-31,10023,5128,15151
76,76823,2014-12-31,9961,5030,14991
76,76823,2015-12-31,9939,4932,14871
76,76823,2016-12-31,9903,4848,14751
76,76823,2017-12-31,9882,4724,14606
76,76823,2018-12-31,9968,4644,14612
76,76823,2019-12-31,9958,4509,14467
76,76823,2020-12-31,9972,4417,14389
76,76823,2021-12-31,10063,4403,14466
76,76823,2022-12-31,10185,4385,14570
76,76823,2023-12-31,10309,4365,14674
76,76823,2024-12-31,10398,4352,14750
76,76823,2025-12-31,10507,4327,14834
76,76823,2026-12-31,10604,4331,14935
76,76823,2027-12-31,10704,4314,15018
76,76823,2028-12-31,10802,4287,15089
76,76823,2029-12-31,10895,4287,15182
76,76823,2030-12-31,10994,4297,15291
76,76823,2031-12-31,11091,4282,15373
76,76823,2032-12-31,11190,4279,15469
76,76823,2033-12-31,11300,4264,15564
76,76823,2034-12-31,11385,4271,15656
76,76823,2035-12-31,11466,4261,15727
76,76828,1985-12-31,7533,16038,23571
76,76828,1986-12-31,7673,15276,22949
76,76828,1987-12-31,7783,14674,22457
76,76828,1988-12-31,7897,14197,22094
76,76828,1989-12-31,8000,13832,21832
76,76828,1990-12-31,8078,13497,21575
76,76828,1991-12-31,8163,13237,21400
76,76828,1992-12-31,8231,13040,21271
76,76828,1993-12-31,8313,12903,21216
76,76828,1994-12-31,8368,12796,21164
76,76828,1995-12-31,8440,12695,21135
76,76828,1996-12-31,8491,12591,21082
76,76828,1997-12-31,8530,12515,21045
76,76828,1998-12-31,8596,12445,21041
76,76828,1999-12-31,8627,12353,20980
76,76828,2000-12-31,8667,12274,20941
76,76828,2001-12-31,8694,12195,20889
76,76828,2002-12-31,8717,12093,20810
76,76828,2003-12-31,8734,12001,20735
76,76828,2004-12-31,8754,11896,20650
76,76828,2005-12-31,8775,11821,20596
76,76828,2006-12-31,8796,11740,20536
76,76828,2007-12-31,8813,11633,20446
76,76828,2008-12-31,8811,11544,20355
76,76828,2009-12-31,8818,11396,20214
76,76828,2010-12-31,8845,11265,20110
76,76828,2011-12-31,8811,11149,19960
76,76828,2012-12-31,8792,11029,19821
76,76828,2013-12-31,8779,10892,19671
76,76828,2014-12-31,8758,10773,19531
76,76828,2015-12-31,8778,10652,19430
76,76828,2016-12-31,8740,10524,19264
76,76828,2017-12-31,8750,10440,19190
76,76828,2018-12-31,8857,10369,19226
76,76828,2019-12-31,8930,10143,19073
76,76828,2020-12-31,8992,9990,18982
76,76828,2021-12-31,9126,9958,19084
76,76828,2022-12-31,9302,9918,19220
76,76828,2023-12-31,9485,9873,19358
76,76828,2024-12-31,9619,9840,19459
76,76828,2025-12-31,9720,9805,19525
76,76828,2026-12-31,9816,9775,19591
76,76828,2027-12-31,9908,9756,19664
76,76828,2028-12-31,10001,9737,19738
76,76828,2029-12-31,10095,9726,19821
76,76828,2030-12-31,10182,9710,19892
76,76828,2031-12-31,10287,9716,20003
76,76828,2032-12-31,10362,9709,20071
76,76828,2033-12-31,10452,9688,20140
76,76828,2034-12-31,10525,9676,20201
76,76828,2035-12-31,10616,9659,20275
76,76834,1985-12-31,116870,28436,145306
76,76834,1986-12-31,120338,27716,148054
76,76834,1987-12-31,123569,27238,150807
76,76834,1988-12-31,126569,26971,153540
76,76834,1989-12-31,129345,26840,156185
76,76834,1990-12-31,131898,26814,158712
76,76834,1991-12-31,134285,26935,161220
76,76834,1992-12-31,136700,27142,163842
76,76834,1993-12-31,139181,27453,166634
76,76834,1994-12-31,141492,27816,169308
76,76834,1995-12-31,143750,28210,171960
76,76834,1996-12-31,145903,28646,174549
76,76834,1997-12-31,147979,29084,177063
76,76834,1998-12-31,149919,29541,179460
76,76834,1999-12-31,151763,29994,181757
76,76834,2000-12-31,153477,30438,183915
76,76834,2001-12-31,155063,30862,185925
76,76834,2002-12-31,156533,31287,187820
76,76834,2003-12-31,157954,31741,189695
76,76834,2004-12-31,159369,32175,191544
76,76834,2005-12-31,160845,32640,193485
76,76834,2006-12-31,162330,33081,195411
76,76834,2007-12-31,163659,33519,197178
76,76834,2008-12-31,164772,33908,198680
76,76834,2009-12-31,165817,34282,200099
76,76834,2010-12-31,166874,34630,201504
76,76834,2011-12-31,167923,35065,202988
76,76834,2012-12-31,168834,35445,204279
76,76834,2013-12-31,169578,35766,205344
76,76834,2014-12-31,170309,36043,206352
76,76834,2015-12-31,171128,36357,207485
76,76834,2016-12-31,172084,36771,208855
76,76834,2017-12-31,173041,37164,210205
76,76834,2018-12-31,174951,37734,212685
76,76834,2019-12-31,176619,39359,215978
76,76834,2020-12-31,178030,40782,218812
76,76834,2021-12-31,179371,40661,220032
76,76834,2022-12-31,181107,40497,221604
76,76834,2023-12-31,182878,40313,223191
76,76834,2024-12-31,184683,40123,224806
76,76834,2025-12-31,186458,40020,226478
76,76834,2026-12-31,188272,39873,228145
76,76834,2027-12-31,190103,39777,229880
76,76834,2028-12-31,191929,39704,231633
76,76834,2029-12-31,193717,39660,233377
76,76834,2030-12-31,195523,39616,235139
76,76834,2031-12-31,197266,39585,236851
76,76834,2032-12-31,198992,39562,238554
76,76834,2033-12-31,200654,39525,240179
76,76834,2034-12-31,202318,39454,241772
76,76834,2035-12-31,203917,39403,243320
76,76845,1985-12-31,2151,4827,6978
76,76845,1986-12-31,2164,4570,6734
76,76845,1987-12-31,2203,4341,6544
76,76845,1988-12-31,2223,4215,6438
76,76845,1989-12-31,2250,4107,6357
76,76845,1990-12-31,2282,4018,6300
76,76845,1991-12-31,2312,3949,6261
76,76845,1992-12-31,2350,3883,6233
76,76845,1993-12-31,2362,3826,6188
76,76845,1994-12-31,2380,3793,6173
76,76845,1995-12-31,2393,3773,6166
76,76845,1996-12-31,2397,3736,6133
76,76845,1997-12-31,2429,3726,6155
76,76845,1998-12-31,2448,3687,6135
76,76845,1999-12-31,2505,3637,6142
76,76845,2000-12-31,2506,3612,6118
76,76845,2001-12-31,2456,3558,6014
76,76845,2002-12-31,2458,3536,5994
76,76845,2003-12-31,2482,3536,6018
76,76845,2004-12-31,2503,3458,5961
76,76845,2005-12-31,2521,3424,5945
76,76845,2006-12-31,2459,3414,5873
76,76845,2007-12-31,2473,3326,5799
76,76845,2008-12-31,2482,3334,5816
76,76845,2009-12-31,2499,3285,5784
76,76845,2010-12-31,2524,3242,5766
76,76845,2011-12-31,2545,3201,5746
76,76845,2012-12-31,2548,3158,5706
76,76845,2013-12-31,2512,3111,5623
76,76845,2014-12-31,2482,3073,5555
76,76845,2015-12-31,2498,3050,5548
76,76845,2016-12-31,2508,3017,5525
76,76845,2017-12-31,2517,2916,5433
76,76845,2018-12-31,2549,2916,5465
76,76845,2019-12-31,2506,2906,5412
76,76845,2020-12-31,2477,2904,5381
76,76845,2021-12-31,2517,2893,5410
76,76845,2022-12-31,2567,2882,5449
76,76845,2023-12-31,2620,2868,5488
76,76845,2024-12-31,2641,2858,5499
76,76845,2025-12-31,2669,2842,5511
76,76845,2026-12-31,2682,2835,5517
76,76845,2027-12-31,2713,2826,5539
76,76845,2028-12-31,2741,2821,5562
76,76845,2029-12-31,2758,2815,5573
76,76845,2030-12-31,2784,2818,5602
76,76845,2031-12-31,2805,2807,5612
76,76845,2032-12-31,2832,2811,5643
76,76845,2033-12-31,2859,2810,5669
76,76845,2034-12-31,2878,2797,5675
76,76845,2035-12-31,2900,2795,5695
76,76863,1985-12-31,4484,9132,13616
76,76863,1986-12-31,4532,8576,13108
76,76863,1987-12-31,4564,8148,12712
76,76863,1988-12-31,4586,7806,12392
76,76863,1989-12-31,4615,7497,12112
76,76863,1990-12-31,4600,7260,11860
76,76863,1991-12-31,4620,7010,11630
76,76863,1992-12-31,4621,6866,11487
76,76863,1993-12-31,4629,6710,11339
76,76863,1994-12-31,4630,6556,11186
76,76863,1995-12-31,4621,6415,11036
76,76863,1996-12-31,4620,6284,10904
76,76863,1997-12-31,4630,6163,10793
76,76863,1998-12-31,4597,6037,10634
76,76863,1999-12-31,4576,5902,10478
76,76863,2000-12-31,4563,5777,10340
76,76863,2001-12-31,4547,5617,10164
76,76863,2002-12-31,4521,5492,10013
76,76863,2003-12-31,4464,5342,9806
76,76863,2004-12-31,4452,5187,9639
76,76863,2005-12-31,4428,5047,9475
76,76863,2006-12-31,4408,4917,9325
76,76863,2007-12-31,4387,4778,9165
76,76863,2008-12-31,4368,4632,9000
76,76863,2009-12-31,4341,4491,8832
76,76863,2010-12-31,4309,4347,8656
76,76863,2011-12-31,4284,4210,8494
76,76863,2012-12-31,4264,4035,8299
76,76863,2013-12-31,4259,3897,8156
76,76863,2014-12-31,4204,3763,7967
76,76863,2015-12-31,4096,3613,7709
76,76863,2016-12-31,4045,3476,7521
76,76863,2017-12-31,4055,3319,7374
76,76863,2018-12-31,4094,3169,7263
76,76863,2019-12-31,4082,2988,7070
76,76863,2020-12-31,4084,2866,6950
76,76863,2021-12-31,4130,2857,6987
76,76863,2022-12-31,4192,2845,7037
76,76863,2023-12-31,4256,2832,7088
76,76863,2024-12-31,4301,2826,7127
76,76863,2025-12-31,4337,2808,7145
76,76863,2026-12-31,4365,2814,7179
76,76863,2027-12-31,4418,2798,7216
76,76863,2028-12-31,4454,2802,7256
76,76863,2029-12-31,4508,2778,7286
76,76863,2030-12-31,4539,2788,7327
76,76863,2031-12-31,4589,2780,7369
76,76863,2032-12-31,4635,2768,7403
76,76863,2033-12-31,4655,2772,7427
76,76863,2034-12-31,4693,2774,7467
76,76863,2035-12-31,4733,2753,7486
76,76869,1985-12-31,3929,6136,10065
76,76869,1986-12-31,4102,5873,9975
76,76869,1987-12-31,4298,5643,9941
76,76869,1988-12-31,4448,5474,9922
76,76869,1989-12-31,4635,5356,9991
76,76869,1990-12-31,4772,5289,10061
76,76869,1991-12-31,4912,5231,10143
76,76869,1992-12-31,5046,5179,10225
76,76869,1993-12-31,5209,5168,10377
76,76869,1994-12-31,5342,5121,10463
76,76869,1995-12-31,5484,5105,10589
76,76869,1996-12-31,5632,5100,10732
76,76869,1997-12-31,5759,5116,10875
76,76869,1998-12-31,5906,5125,11031
76,76869,1999-12-31,6055,5118,11173
76,76869,2000-12-31,6185,5111,11296
76,76869,2001-12-31,6279,5091,11370
76,76869,2002-12-31,6364,5068,11432
76,76869,2003-12-31,6500,5053,11553
76,76869,2004-12-31,6621,5064,11685
76,76869,2005-12-31,6738,5039,11777
76,76869,2006-12-31,6804,5021,11825
76,76869,2007-12-31,6934,5012,11946
76,76869,2008-12-31,7043,5019,12062
76,76869,2009-12-31,7118,4978,12096
76,76869,2010-12-31,7199,4972,12171
76,76869,2011-12-31,7306,4957,12263
76,76869,2012-12-31,7375,4931,12306
76,76869,2013-12-31,7454,4906,12360
76,76869,2014-12-31,7538,4892,12430
76,76869,2015-12-31,7632,4887,12519
76,76869,2016-12-31,7631,4895,12526
76,76869,2017-12-31,7787,4800,12587
76,76869,2018-12-31,7899,4835,12734
76,76869,2019-12-31,8016,4801,12817
76,76869,2020-12-31,8108,4776,12884
76,76869,2021-12-31,8192,4761,12953
76,76869,2022-12-31,8304,4742,13046
76,76869,2023-12-31,8419,4720,13139
76,76869,2024-12-31,8537,4704,13241
76,76869,2025-12-31,8661,4669,13330
76,76869,2026-12-31,8788,4663,13451
76,76869,2027-12-31,8908,4654,13562
76,76869,2028-12-31,9050,4632,13682
76,76869,2029-12-31,9172,4630,13802
76,76869,2030-12-31,9297,4641,13938
76,76869,2031-12-31,9432,4637,14069
76,76869,2032-12-31,9568,4615,14183
76,76869,2033-12-31,9725,4608,14333
76,76869,2034-12-31,9842,4618,14460
76,76869,2035-12-31,9973,4614,14587
76,76890,1985-12-31,5122,9879,15001
76,76890,1986-12-31,5304,9462,14766
76,76890,1987-12-31,5453,9124,14577
76,76890,1988-12-31,5614,8881,14495
76,76890,1989-12-31,5755,8648,14403
76,76890,1990-12-31,5903,8515,14418
76,76890,1991-12-31,6039,8403,14442
76,76890,1992-12-31,6164,8320,14484
76,76890,1993-12-31,6299,8269,14568
76,76890,1994-12-31,6431,8241,14672
76,76890,1995-12-31,6546,8230,14776
76,76890,1996-12-31,6668,8199,14867
76,76890,1997-12-31,6769,8191,14960
76,76890,1998-12-31,6870,8171,15041
76,76890,1999-12-31,6981,8178,15159
76,76890,2000-12-31,7059,8183,15242
76,76890,2001-12-31,7156,8162,15318
76,76890,2002-12-31,7253,8136,15389
76,76890,2003-12-31,7313,8110,15423
76,76890,2004-12-31,7405,8072,15477
76,76890,2005-12-31,7485,8057,15542
76,76890,2006-12-31,7573,8051,15624
76,76890,2007-12-31,7654,8030,15684
76,76890,2008-12-31,7724,8013,15737
76,76890,2009-12-31,7773,7983,15756
76,76890,2010-12-31,7841,7946,15787
76,76890,2011-12-31,7904,7955,15859
76,76890,2012-12-31,7959,7869,15828
76,76890,2013-12-31,8015,7816,15831
76,76890,2014-12-31,8018,7826,15844
76,76890,2015-12-31,8141,7806,15947
76,76890,2016-12-31,8094,7777,15871
76,76890,2017-12-31,8239,7701,15940
76,76890,2018-12-31,8326,7693,16019
76,76890,2019-12-31,8383,7734,16117
76,76890,2020-12-31,8431,7766,16197
76,76890,2021-12-31,8541,7743,16284
76,76890,2022-12-31,8688,7712,16400
76,76890,2023-12-31,8841,7677,16518
76,76890,2024-12-31,8942,7652,16594
76,76890,2025-12-31,9036,7611,16647
76,76890,2026-12-31,9129,7594,16723
76,76890,2027-12-31,9205,7596,16801
76,76890,2028-12-31,9291,7582,16873
76,76890,2029-12-31,9372,7558,16930
76,76890,2030-12-31,9465,7529,16994
76,76890,2031-12-31,9541,7533,17074
76,76890,2032-12-31,9623,7544,17167
76,76890,2033-12-31,9699,7526,17225
76,76890,2034-12-31,9784,7507,17291
76,76890,2035-12-31,9855,7480,17335
76,76892,1985-12-31,51164,8751,59915
76,76892,1986-12-31,53215,8657,61872
76,76892,1987-12-31,55169,8597,63766
76,76892,1988-12-31,57035,8620,65655
76,76892,1989-12-31,58801,8625,67426
76,76892,1990-12-31,60455,8738,69193
76,76892,1991-12-31,62057,8843,70900
76,76892,1992-12-31,63659,9004,72663
76,76892,1993-12-31,65302,9186,74488
76,76892,1994-12-31,66859,9401,76260
76,76892,1995-12-31,68383,9603,77986
76,76892,1996-12-31,69880,9838,79718
76,76892,1997-12-31,71321,10083,81404
76,76892,1998-12-31,72699,10319,83018
76,76892,1999-12-31,74050,10518,84568
76,76892,2000-12-31,75314,10782,86096
76,76892,2001-12-31,76508,11022,87530
76,76892,2002-12-31,77635,11232,88867
76,76892,2003-12-31,78745,11454,90199
76,76892,2004-12-31,79848,11698,91546
76,76892,2005-12-31,80986,11928,92914
76,76892,2006-12-31,82106,12166,94272
76,76892,2007-12-31,83152,12409,95561
76,76892,2008-12-31,84073,12609,96682
76,76892,2009-12-31,84955,12845,97800
76,76892,2010-12-31,85852,13022,98874
76,76892,2011-12-31,86724,13240,99964
76,76892,2012-12-31,87534,13437,100971
76,76892,2013-12-31,88244,13584,101828
76,76892,2014-12-31,88956,13773,102729
76,76892,2015-12-31,89707,13958,103665
76,76892,2016-12-31,90511,14166,104677
76,76892,2017-12-31,91337,14412,105749
76,76892,2018-12-31,92630,14704,107334
76,76892,2019-12-31,93991,14898,108889
76,76892,2020-12-31,95072,14997,110069
76,76892,2021-12-31,95731,14952,110683
76,76892,2022-12-31,96582,14892,111474
76,76892,2023-12-31,97447,14825,112272
76,76892,2024-12-31,98313,14769,113082
76,76892,2025-12-31,99240,14727,113967
76,76892,2026-12-31,100173,14653,114826
76,76892,2027-12-31,101111,14599,115710
76,76892,2028-12-31,102032,14570,116602
76,76892,2029-12-31,102968,14566,117534
76,76892,2030-12-31,103877,14580,118457
76,76892,2031-12-31,104779,14563,119342
76,76892,2032-12-31,105661,14555,120216
76,76892,2033-12-31,106527,14536,121063
76,76892,2034-12-31,107375,14524,121899
76,76892,2035-12-31,108206,14500,122706
76,76895,1985-12-31,25594,9439,35033
76,76895,1986-12-31,26134,9126,35260
76,76895,1987-12-31,26629,8895,35524
76,76895,1988-12-31,27069,8716,35785
76,76895,1989-12-31,27444,8589,36033
76,76895,1990-12-31,27790,8546,36336
76,76895,1991-12-31,28096,8515,36611
76,76895,1992-12-31,28401,8508,36909
76,76895,1993-12-31,28718,8557,37275
76,76895,1994-12-31,29014,8604,37618
76,76895,1995-12-31,29276,8650,37926
76,76895,1996-12-31,29534,8728,38262
76,76895,1997-12-31,29771,8803,38574
76,76895,1998-12-31,29979,8876,38855
76,76895,1999-12-31,30175,8966,39141
76,76895,2000-12-31,30346,9050,39396
76,76895,2001-12-31,30483,9119,39602
76,76895,2002-12-31,30606,9177,39783
76,76895,2003-12-31,30716,9231,39947
76,76895,2004-12-31,30823,9296,40119
76,76895,2005-12-31,30955,9377,40332
76,76895,2006-12-31,31102,9447,40549
76,76895,2007-12-31,31205,9525,40730
76,76895,2008-12-31,31257,9582,40839
76,76895,2009-12-31,31315,9631,40946
76,76895,2010-12-31,31374,9687,41061
76,76895,2011-12-31,31426,9739,41165
76,76895,2012-12-31,31450,9790,41240
76,76895,2013-12-31,31457,9841,41298
76,76895,2014-12-31,31475,9883,41358
76,76895,2015-12-31,31481,9917,41398
76,76895,2016-12-31,31559,9970,41529
76,76895,2017-12-31,31579,10046,41625
76,76895,2018-12-31,31812,10113,41925
76,76895,2019-12-31,32042,10149,42191
76,76895,2020-12-31,32227,10180,42407
76,76895,2021-12-31,32485,10150,42635
76,76895,2022-12-31,32831,10109,42940
76,76895,2023-12-31,33184,10063,43247
76,76895,2024-12-31,33496,10014,43510
76,76895,2025-12-31,33812,9975,43787
76,76895,2026-12-31,34117,9953,44070
76,76895,2027-12-31,34425,9947,44372
76,76895,2028-12-31,34740,9934,44674
76,76895,2029-12-31,35064,9916,44980
76,76895,2030-12-31,35388,9887,45275
76,76895,2031-12-31,35710,9860,45570
76,76895,2032-12-31,36029,9853,45882
76,76895,2033-12-31,36328,9837,46165
76,76895,2034-12-31,36627,9817,46444
76,76895,2035-12-31,36909,9808,46717
81,81001,1985-12-31,40689,14565,55254
81,81001,1986-12-31,42159,14165,56324
81,81001,1987-12-31,43633,13783,57416
81,81001,1988-12-31,45160,13431,58591
81,81001,1989-12-31,46694,13068,59762
81,81001,1990-12-31,47518,13146,60664
81,81001,1991-12-31,48899,12936,61835
81,81001,1992-12-31,50269,12768,63037
81,81001,1993-12-31,51579,12431,64010
81,81001,1994-12-31,52855,12421,65276
81,81001,1995-12-31,54076,12236,66312
81,81001,1996-12-31,55182,12165,67347
81,81001,1997-12-31,56232,12083,68315
81,81001,1998-12-31,57161,11982,69143
81,81001,1999-12-31,58031,11938,69969
81,81001,2000-12-31,58799,11816,70615
81,81001,2001-12-31,59485,11746,71231
81,81001,2002-12-31,60088,11620,71708
81,81001,2003-12-31,60614,11523,72137
81,81001,2004-12-31,61099,11426,72525
81,81001,2005-12-31,61423,11294,72717
81,81001,2006-12-31,61861,11192,73053
81,81001,2007-12-31,62365,11110,73475
81,81001,2008-12-31,62903,11025,73928
81,81001,2009-12-31,63481,10960,74441
81,81001,2010-12-31,64087,10910,74997
81,81001,2011-12-31,64690,10874,75564
81,81001,2012-12-31,65288,10828,76116
81,81001,2013-12-31,66016,10782,76798
81,81001,2014-12-31,66781,10779,77560
81,81001,2015-12-31,67665,10771,78436
81,81001,2016-12-31,68985,10848,79833
81,81001,2017-12-31,70835,10989,81824
81,81001,2018-12-31,74195,11390,85585
81,81001,2019-12-31,79286,12589,91875
81,81001,2020-12-31,83256,13558,96814
81,81001,2021-12-31,85193,13950,99143
81,81001,2022-12-31,86184,14181,100365
81,81001,2023-12-31,87065,14392,101457
81,81001,2024-12-31,87839,14588,102427
81,81001,2025-12-31,88582,14783,103365
81,81001,2026-12-31,89309,14969,104278
81,81001,2027-12-31,90070,15162,105232
81,81001,2028-12-31,90830,15356,106186
81,81001,2029-12-31,91588,15527,107115
81,81001,2030-12-31,92353,15709,108062
81,81001,2031-12-31,93147,15877,109024
81,81001,2032-12-31,93876,16064,109940
81,81001,2033-12-31,94598,16240,110838
81,81001,2034-12-31,95304,16416,111720
81,81001,2035-12-31,95977,16600,112577
81,81065,1985-12-31,8355,18687,27042
81,81065,1986-12-31,8584,19101,27685
81,81065,1987-12-31,8854,19485,28339
81,81065,1988-12-31,9109,19806,28915
81,81065,1989-12-31,9338,20084,29422
81,81065,1990-12-31,9461,21148,30609
81,81065,1991-12-31,9705,21663,31368
81,81065,1992-12-31,9915,22132,32047
81,81065,1993-12-31,10120,22663,32783
81,81065,1994-12-31,10332,23100,33432
81,81065,1995-12-31,10531,23580,34111
81,81065,1996-12-31,10706,24070,34776
81,81065,1997-12-31,10862,24568,35430
81,81065,1998-12-31,11017,25060,36077
81,81065,1999-12-31,11141,25532,36673
81,81065,2000-12-31,11278,26002,37280
81,81065,2001-12-31,11369,26458,37827
81,81065,2002-12-31,11453,26892,38345
81,81065,2003-12-31,11531,27298,38829
81,81065,2004-12-31,11595,27661,39256
81,81065,2005-12-31,11629,27988,39617
81,81065,2006-12-31,11689,28361,40050
81,81065,2007-12-31,11761,28750,40511
81,81065,2008-12-31,11831,29170,41001
81,81065,2009-12-31,11918,29589,41507
81,81065,2010-12-31,12013,30014,42027
81,81065,2011-12-31,12075,30469,42544
81,81065,2012-12-31,12171,30919,43090
81,81065,2013-12-31,12296,31410,43706
81,81065,2014-12-31,12426,31924,44350
81,81065,2015-12-31,12549,32500,45049
81,81065,2016-12-31,12779,33306,46085
81,81065,2017-12-31,13108,34334,47442
81,81065,2018-12-31,13720,36121,49841
81,81065,2019-12-31,14796,38611,53407
81,81065,2020-12-31,15678,40531,56209
81,81065,2021-12-31,15867,41695,57562
81,81065,2022-12-31,15883,42387,58270
81,81065,2023-12-31,15886,43019,58905
81,81065,2024-12-31,15971,43616,59587
81,81065,2025-12-31,16082,44179,60261
81,81065,2026-12-31,16205,44741,60946
81,81065,2027-12-31,16316,45270,61586
81,81065,2028-12-31,16456,45814,62270
81,81065,2029-12-31,16585,46334,62919
81,81065,2030-12-31,16747,46887,63634
81,81065,2031-12-31,16874,47418,64292
81,81065,2032-12-31,17018,47922,64940
81,81065,2033-12-31,17156,48410,65566
81,81065,2034-12-31,17260,48894,66154
81,81065,2035-12-31,17387,49362,66749
81,81220,1985-12-31,2819,4169,6988
81,81220,1986-12-31,2839,3999,6838
81,81220,1987-12-31,2821,3791,6612
81,81220,1988-12-31,2842,3628,6470
81,81220,1989-12-31,2854,3460,6314
81,81220,1990-12-31,2821,3368,6189
81,81220,1991-12-31,2804,3258,6062
81,81220,1992-12-31,2803,3127,5930
81,81220,1993-12-31,2794,3058,5852
81,81220,1994-12-31,2810,2946,5756
81,81220,1995-12-31,2801,2837,5638
81,81220,1996-12-31,2781,2746,5527
81,81220,1997-12-31,2776,2623,5399
81,81220,1998-12-31,2769,2548,5317
81,81220,1999-12-31,2766,2470,5236
81,81220,2000-12-31,2731,2390,5121
81,81220,2001-12-31,2731,2301,5032
81,81220,2002-12-31,2715,2223,4938
81,81220,2003-12-31,2703,2123,4826
81,81220,2004-12-31,2656,2055,4711
81,81220,2005-12-31,2631,1960,4591
81,81220,2006-12-31,2621,1898,4519
81,81220,2007-12-31,2605,1812,4417
81,81220,2008-12-31,2551,1764,4315
81,81220,2009-12-31,2512,1708,4220
81,81220,2010-12-31,2508,1655,4163
81,81220,2011-12-31,2529,1560,4089
81,81220,2012-12-31,2540,1520,4060
81,81220,2013-12-31,2551,1455,4006
81,81220,2014-12-31,2521,1386,3907
81,81220,2015-12-31,2523,1332,3855
81,81220,2016-12-31,2542,1301,3843
81,81220,2017-12-31,2600,1299,3899
81,81220,2018-12-31,2682,1243,3925
81,81220,2019-12-31,2813,1229,4042
81,81220,2020-12-31,2920,1223,4143
81,81220,2021-12-31,2984,1258,4242
81,81220,2022-12-31,3015,1279,4294
81,81220,2023-12-31,3043,1298,4341
81,81220,2024-12-31,3073,1307,4380
81,81220,2025-12-31,3095,1327,4422
81,81220,2026-12-31,3119,1349,4468
81,81220,2027-12-31,3133,1365,4498
81,81220,2028-12-31,3153,1385,4538
81,81220,2029-12-31,3187,1401,4588
81,81220,2030-12-31,3206,1414,4620
81,81220,2031-12-31,3234,1425,4659
81,81220,2032-12-31,3261,1438,4699
81,81220,2033-12-31,3278,1454,4732
81,81220,2034-12-31,3301,1467,4768
81,81220,2035-12-31,3321,1484,4805
81,81300,1985-12-31,0,0,0
81,81300,1986-12-31,0,0,0
81,81300,1987-12-31,0,0,0
81,81300,1988-12-31,0,0,0
81,81300,1989-12-31,0,0,0
81,81300,1990-12-31,1739,5303,7042
81,81300,1991-12-31,2131,5451,7582
81,81300,1992-12-31,2534,5546,8080
81,81300,1993-12-31,2908,5703,8611
81,81300,1994-12-31,3263,5811,9074
81,81300,1995-12-31,3628,5974,9602
81,81300,1996-12-31,3990,6067,10057
81,81300,1997-12-31,4298,6180,10478
81,81300,1998-12-31,4617,6300,10917
81,81300,1999-12-31,4912,6401,11313
81,81300,2000-12-31,5228,6539,11767
81,81300,2001-12-31,5497,6623,12120
81,81300,2002-12-31,5778,6758,12536
81,81300,2003-12-31,6023,6852,12875
81,81300,2004-12-31,6249,6935,13184
81,81300,2005-12-31,6461,7006,13467
81,81300,2006-12-31,6664,7107,13771
81,81300,2007-12-31,6889,7205,14094
81,81300,2008-12-31,7108,7320,14428
81,81300,2009-12-31,7325,7428,14753
81,81300,2010-12-31,7540,7514,15054
81,81300,2011-12-31,7741,7642,15383
81,81300,2012-12-31,7984,7752,15736
81,81300,2013-12-31,8180,7894,16074
81,81300,2014-12-31,8432,8000,16432
81,81300,2015-12-31,8662,8156,16818
81,81300,2016-12-31,8963,8340,17303
81,81300,2017-12-31,9317,8599,17916
81,81300,2018-12-31,9886,9052,18938
81,81300,2019-12-31,10575,9084,19659
81,81300,2020-12-31,11112,9036,20148
81,81300,2021-12-31,11334,9295,20629
81,81300,2022-12-31,11433,9450,20883
81,81300,2023-12-31,11519,9591,21110
81,81300,2024-12-31,11613,9740,21353
81,81300,2025-12-31,11690,9866,21556
81,81300,2026-12-31,11786,9990,21776
81,81300,2027-12-31,11875,10114,21989
81,81300,2028-12-31,11962,10234,22196
81,81300,2029-12-31,12056,10365,22421
81,81300,2030-12-31,12164,10471,22635
81,81300,2031-12-31,12263,10579,22842
81,81300,2032-12-31,12366,10707,23073
81,81300,2033-12-31,12456,10831,23287
81,81300,2034-12-31,12547,10936,23483
81,81300,2035-12-31,12635,11050,23685
81,81591,1985-12-31,1791,2105,3896
81,81591,1986-12-31,1839,2046,3885
81,81591,1987-12-31,1884,1981,3865
81,81591,1988-12-31,1921,1893,3814
81,81591,1989-12-31,1996,1855,3851
81,81591,1990-12-31,2020,1854,3874
81,81591,1991-12-31,2054,1834,3888
81,81591,1992-12-31,2116,1803,3919
81,81591,1993-12-31,2169,1800,3969
81,81591,1994-12-31,2211,1754,3965
81,81591,1995-12-31,2228,1740,3968
81,81591,1996-12-31,2280,1707,3987
81,81591,1997-12-31,2322,1686,4008
81,81591,1998-12-31,2357,1662,4019
81,81591,1999-12-31,2370,1632,4002
81,81591,2000-12-31,2396,1614,4010
81,81591,2001-12-31,2427,1589,4016
81,81591,2002-12-31,2441,1571,4012
81,81591,2003-12-31,2483,1558,4041
81,81591,2004-12-31,2466,1515,3981
81,81591,2005-12-31,2470,1496,3966
81,81591,2006-12-31,2501,1478,3979
81,81591,2007-12-31,2514,1466,3980
81,81591,2008-12-31,2545,1459,4004
81,81591,2009-12-31,2577,1464,4041
81,81591,2010-12-31,2559,1455,4014
81,81591,2011-12-31,2596,1454,4050
81,81591,2012-12-31,2646,1439,4085
81,81591,2013-12-31,2662,1422,4084
81,81591,2014-12-31,2633,1410,4043
81,81591,2015-12-31,2691,1374,4065
81,81591,2016-12-31,2737,1364,4101
81,81591,2017-12-31,2808,1395,4203
81,81591,2018-12-31,2952,1447,4399
81,81591,2019-12-31,3154,1534,4688
81,81591,2020-12-31,3312,1607,4919
81,81591,2021-12-31,3383,1653,5036
81,81591,2022-12-31,3417,1681,5098
81,81591,2023-12-31,3448,1706,5154
81,81591,2024-12-31,3467,1723,5190
81,81591,2025-12-31,3494,1752,5246
81,81591,2026-12-31,3525,1766,5291
81,81591,2027-12-31,3549,1795,5344
81,81591,2028-12-31,3582,1803,5385
81,81591,2029-12-31,3614,1833,5447
81,81591,2030-12-31,3653,1853,5506
81,81591,2031-12-31,3668,1879,5547
81,81591,2032-12-31,3697,1899,5596
81,81591,2033-12-31,3734,1918,5652
81,81591,2034-12-31,3756,1938,5694
81,81591,2035-12-31,3779,1963,5742
81,81736,1985-12-31,28540,18568,47108
81,81736,1986-12-31,29135,18017,47152
81,81736,1987-12-31,29792,17511,47303
81,81736,1988-12-31,30454,16971,47425
81,81736,1989-12-31,31138,16463,47601
81,81736,1990-12-31,31359,16613,47972
81,81736,1991-12-31,31975,16335,48310
81,81736,1992-12-31,32555,16056,48611
81,81736,1993-12-31,33126,15789,48915
81,81736,1994-12-31,33666,15539,49205
81,81736,1995-12-31,34189,15309,49498
81,81736,1996-12-31,34638,15115,49753
81,81736,1997-12-31,35053,14943,49996
81,81736,1998-12-31,35415,14756,50171
81,81736,1999-12-31,35748,14584,50332
81,81736,2000-12-31,36007,14411,50418
81,81736,2001-12-31,36214,14268,50482
81,81736,2002-12-31,36398,14076,50474
81,81736,2003-12-31,36510,13915,50425
81,81736,2004-12-31,36641,13760,50401
81,81736,2005-12-31,36682,13559,50241
81,81736,2006-12-31,36796,13389,50185
81,81736,2007-12-31,36933,13259,50192
81,81736,2008-12-31,37113,13093,50206
81,81736,2009-12-31,37319,12971,50290
81,81736,2010-12-31,37539,12880,50419
81,81736,2011-12-31,37756,12776,50532
81,81736,2012-12-31,37981,12689,50670
81,81736,2013-12-31,38257,12627,50884
81,81736,2014-12-31,38602,12570,51172
81,81736,2015-12-31,38990,12548,51538
81,81736,2016-12-31,39648,12600,52248
81,81736,2017-12-31,40585,12724,53309
81,81736,2018-12-31,42415,13139,55554
81,81736,2019-12-31,45327,14370,59697
81,81736,2020-12-31,47597,15407,63004
81,81736,2021-12-31,48667,15853,64520
81,81736,2022-12-31,49198,16116,65314
81,81736,2023-12-31,49670,16356,66026
81,81736,2024-12-31,50102,16589,66691
81,81736,2025-12-31,50508,16817,67325
81,81736,2026-12-31,50931,17031,67962
81,81736,2027-12-31,51348,17237,68585
81,81736,2028-12-31,51767,17451,69218
81,81736,2029-12-31,52193,17658,69851
81,81736,2030-12-31,52616,17861,70477
81,81736,2031-12-31,53062,18071,71133
81,81736,2032-12-31,53491,18260,71751
81,81736,2033-12-31,53901,18470,72371
81,81736,2034-12-31,54303,18684,72987
81,81736,2035-12-31,54681,18866,73547
81,81794,1985-12-31,20927,7124,28051
81,81794,1986-12-31,21195,8830,30025
81,81794,1987-12-31,21478,10422,31900
81,81794,1988-12-31,21781,11908,33689
81,81794,1989-12-31,22107,13259,35366
81,81794,1990-12-31,22108,7214,29322
81,81794,1991-12-31,22377,7554,29931
81,81794,1992-12-31,22656,7990,30646
81,81794,1993-12-31,22927,8378,31305
81,81794,1994-12-31,23180,8705,31885
81,81794,1995-12-31,23386,9092,32478
81,81794,1996-12-31,23589,9426,33015
81,81794,1997-12-31,23743,9780,33523
81,81794,1998-12-31,23871,10139,34010
81,81794,1999-12-31,23978,10460,34438
81,81794,2000-12-31,24041,10796,34837
81,81794,2001-12-31,24094,11097,35191
81,81794,2002-12-31,24101,11395,35496
81,81794,2003-12-31,24097,11673,35770
81,81794,2004-12-31,24096,11961,36057
81,81794,2005-12-31,24024,12229,36253
81,81794,2006-12-31,24015,12491,36506
81,81794,2007-12-31,24018,12766,36784
81,81794,2008-12-31,24062,13052,37114
81,81794,2009-12-31,24121,13332,37453
81,81794,2010-12-31,24209,13630,37839
81,81794,2011-12-31,24276,13911,38187
81,81794,2012-12-31,24356,14203,38559
81,81794,2013-12-31,24461,14516,38977
81,81794,2014-12-31,24614,14853,39467
81,81794,2015-12-31,24804,15207,40011
81,81794,2016-12-31,25142,15651,40793
81,81794,2017-12-31,25694,16215,41909
81,81794,2018-12-31,26784,17148,43932
81,81794,2019-12-31,27905,18836,46741
81,81794,2020-12-31,28711,20258,48969
81,81794,2021-12-31,29294,20844,50138
81,81794,2022-12-31,29564,21190,50754
81,81794,2023-12-31,29802,21506,51308
81,81794,2024-12-31,30014,21802,51816
81,81794,2025-12-31,30252,22086,52338
81,81794,2026-12-31,30469,22380,52849
81,81794,2027-12-31,30717,22673,53390
81,81794,2028-12-31,30950,22939,53889
81,81794,2029-12-31,31201,23212,54413
81,81794,2030-12-31,31453,23474,54927
81,81794,2031-12-31,31708,23748,55456
81,81794,2032-12-31,31950,24018,55968
81,81794,2033-12-31,32178,24277,56455
81,81794,2034-12-31,32411,24535,56946
81,81794,2035-12-31,32627,24799,57426
85,85001,1985-12-31,22306,17114,39420
85,85001,1986-12-31,25111,17702,42813
85,85001,1987-12-31,28039,18179,46218
85,85001,1988-12-31,31275,18519,49794
85,85001,1989-12-31,35084,18632,53716
85,85001,1990-12-31,39508,18476,57984
85,85001,1991-12-31,44687,18107,62794
85,85001,1992-12-31,50508,17500,68008
85,85001,1993-12-31,56667,16816,73483
85,85001,1994-12-31,62854,16087,78941
85,85001,1995-12-31,68833,15511,84344
85,85001,1996-12-31,74307,15110,89417
85,85001,1997-12-31,79227,14861,94088
85,85001,1998-12-31,83618,14837,98455
85,85001,1999-12-31,87663,14939,102602
85,85001,2000-12-31,91345,15188,106533
85,85001,2001-12-31,94780,15508,110288
85,85001,2002-12-31,98051,15902,113953
85,85001,2003-12-31,101153,16343,117496
85,85001,2004-12-31,104209,16834,121043
85,85001,2005-12-31,107202,17321,124523
85,85001,2006-12-31,110197,17868,128065
85,85001,2007-12-31,113103,18404,131507
85,85001,2008-12-31,115918,18971,134889
85,85001,2009-12-31,118716,19528,138244
85,85001,2010-12-31,121458,20090,141548
85,85001,2011-12-31,124144,20657,144801
85,85001,2012-12-31,126803,21204,148007
85,85001,2013-12-31,129446,21764,151210
85,85001,2014-12-31,131979,22319,154298
85,85001,2015-12-31,134518,22899,157417
85,85001,2016-12-31,137250,23497,160747
85,85001,2017-12-31,140198,24097,164295
85,85001,2018-12-31,143619,24814,168433
85,85001,2019-12-31,148434,25176,173610
85,85001,2020-12-31,152421,25267,177688
85,85001,2021-12-31,154177,25178,179355
85,85001,2022-12-31,155478,25035,180513
85,85001,2023-12-31,156674,24874,181548
85,85001,2024-12-31,158204,24738,182942
85,85001,2025-12-31,159703,24619,184322
85,85001,2026-12-31,161119,24523,185642
85,85001,2027-12-31,162513,24446,186959
85,85001,2028-12-31,163861,24380,188241
85,85001,2029-12-31,165150,24351,189501
85,85001,2030-12-31,166409,24367,190776
85,85001,2031-12-31,167616,24382,191998
85,85001,2032-12-31,168763,24395,193158
85,85001,2033-12-31,169872,24402,194274
85,85001,2034-12-31,170907,24408,195315
85,85001,2035-12-31,171911,24398,196309
85,85010,1985-12-31,7238,12190,19428
85,85010,1986-12-31,7448,12319,19767
85,85010,1987-12-31,7764,12389,20153
85,85010,1988-12-31,8193,12321,20514
85,85010,1989-12-31,8789,12131,20920
85,85010,1990-12-31,9553,11782,21335
85,85010,1991-12-31,10476,11305,21781
85,85010,1992-12-31,11545,10735,22280
85,85010,1993-12-31,12662,10111,22773
85,85010,1994-12-31,13784,9483,23267
85,85010,1995-12-31,14836,8995,23831
85,85010,1996-12-31,15745,8590,24335
85,85010,1997-12-31,16598,8314,24912
85,85010,1998-12-31,17299,8169,25468
85,85010,1999-12-31,17940,8099,26039
85,85010,2000-12-31,18536,8102,26638
85,85010,2001-12-31,19033,8143,27176
85,85010,2002-12-31,19527,8213,27740
85,85010,2003-12-31,19993,8310,28303
85,85010,2004-12-31,20450,8442,28892
85,85010,2005-12-31,20912,8567,29479
85,85010,2006-12-31,21362,8701,30063
85,85010,2007-12-31,21818,8852,30670
85,85010,2008-12-31,22230,8982,31212
85,85010,2009-12-31,22657,9139,31796
85,85010,2010-12-31,23065,9270,32335
85,85010,2011-12-31,23491,9410,32901
85,85010,2012-12-31,23891,9543,33434
85,85010,2013-12-31,24296,9665,33961
85,85010,2014-12-31,24686,9796,34482
85,85010,2015-12-31,25068,9923,34991
85,85010,2016-12-31,25495,10037,35532
85,85010,2017-12-31,26000,10210,36210
85,85010,2018-12-31,26517,10398,36915
85,85010,2019-12-31,27183,10330,37513
85,85010,2020-12-31,27750,10260,38010
85,85010,2021-12-31,28139,10221,38360
85,85010,2022-12-31,28443,10164,38607
85,85010,2023-12-31,28729,10099,38828
85,85010,2024-12-31,28977,10062,39039
85,85010,2025-12-31,29251,9996,39247
85,85010,2026-12-31,29514,9960,39474
85,85010,2027-12-31,29753,9922,39675
85,85010,2028-12-31,29999,9926,39925
85,85010,2029-12-31,30227,9911,40138
85,85010,2030-12-31,30474,9891,40365
85,85010,2031-12-31,30687,9901,40588
85,85010,2032-12-31,30896,9909,40805
85,85010,2033-12-31,31080,9900,40980
85,85010,2034-12-31,31302,9889,41191
85,85010,2035-12-31,31461,9909,41370
85,85015,1985-12-31,56,2846,2902
85,85015,1986-12-31,41,2841,2882
85,85015,1987-12-31,90,2756,2846
85,85015,1988-12-31,227,2696,2923
85,85015,1989-12-31,261,2592,2853
85,85015,1990-12-31,306,2529,2835
85,85015,1991-12-31,364,2310,2674
85,85015,1992-12-31,421,2201,2622
85,85015,1993-12-31,488,1991,2479
85,85015,1994-12-31,538,1855,2393
85,85015,1995-12-31,603,1721,2324
85,85015,1996-12-31,652,1586,2238
85,85015,1997-12-31,713,1520,2233
85,85015,1998-12-31,770,1447,2217
85,85015,1999-12-31,811,1414,2225
85,85015,2000-12-31,846,1341,2187
85,85015,2001-12-31,903,1330,2233
85,85015,2002-12-31,950,1332,2282
85,85015,2003-12-31,977,1291,2268
85,85015,2004-12-31,1013,1279,2292
85,85015,2005-12-31,1043,1263,2306
85,85015,2006-12-31,1070,1249,2319
85,85015,2007-12-31,1145,1234,2379
85,85015,2008-12-31,1173,1222,2395
85,85015,2009-12-31,1196,1217,2413
85,85015,2010-12-31,1247,1182,2429
85,85015,2011-12-31,1275,1117,2392
85,85015,2012-12-31,1318,1127,2445
85,85015,2013-12-31,1328,1144,2472
85,85015,2014-12-31,1322,1144,2466
85,85015,2015-12-31,1368,1077,2445
85,85015,2016-12-31,1447,1086,2533
85,85015,2017-12-31,1471,1013,2484
85,85015,2018-12-31,1499,1001,2500
85,85015,2019-12-31,1537,1034,2571
85,85015,2020-12-31,1570,1064,2634
85,85015,2021-12-31,1599,1060,2659
85,85015,2022-12-31,1622,1054,2676
85,85015,2023-12-31,1644,1047,2691
85,85015,2024-12-31,1656,1040,2696
85,85015,2025-12-31,1668,1025,2693
85,85015,2026-12-31,1686,1015,2701
85,85015,2027-12-31,1699,1014,2713
85,85015,2028-12-31,1716,1018,2734
85,85015,2029-12-31,1724,1016,2740
85,85015,2030-12-31,1737,1016,2753
85,85015,2031-12-31,1756,1016,2772
85,85015,2032-12-31,1761,1023,2784
85,85015,2033-12-31,1775,1031,2806
85,85015,2034-12-31,1785,1031,2816
85,85015,2035-12-31,1797,1024,2821
85,85125,1985-12-31,1688,10205,11893
85,85125,1986-12-31,1696,10268,11964
85,85125,1987-12-31,1759,10239,11998
85,85125,1988-12-31,1784,10130,11914
85,85125,1989-12-31,1902,9937,11839
85,85125,1990-12-31,2053,9573,11626
85,85125,1991-12-31,2223,9135,11358
85,85125,1992-12-31,2440,8628,11068
85,85125,1993-12-31,2654,8071,10725
85,85125,1994-12-31,2888,7544,10432
85,85125,1995-12-31,3088,7094,10182
85,85125,1996-12-31,3256,6743,9999
85,85125,1997-12-31,3403,6486,9889
85,85125,1998-12-31,3541,6326,9867
85,85125,1999-12-31,3656,6231,9887
85,85125,2000-12-31,3758,6214,9972
85,85125,2001-12-31,3845,6204,10049
85,85125,2002-12-31,3933,6220,10153
85,85125,2003-12-31,4022,6264,10286
85,85125,2004-12-31,4106,6320,10426
85,85125,2005-12-31,4173,6369,10542
85,85125,2006-12-31,4263,6427,10690
85,85125,2007-12-31,4342,6495,10837
85,85125,2008-12-31,4405,6563,10968
85,85125,2009-12-31,4495,6615,11110
85,85125,2010-12-31,4552,6688,11240
85,85125,2011-12-31,4633,6750,11383
85,85125,2012-12-31,4703,6802,11505
85,85125,2013-12-31,4761,6863,11624
85,85125,2014-12-31,4833,6909,11742
85,85125,2015-12-31,4922,6944,11866
85,85125,2016-12-31,5013,7012,12025
85,85125,2017-12-31,5058,7091,12149
85,85125,2018-12-31,5167,7161,12328
85,85125,2019-12-31,5304,6899,12203
85,85125,2020-12-31,5421,6687,12108
85,85125,2021-12-31,5557,6662,12219
85,85125,2022-12-31,5674,6624,12298
85,85125,2023-12-31,5787,6582,12369
85,85125,2024-12-31,5860,6537,12397
85,85125,2025-12-31,5932,6510,12442
85,85125,2026-12-31,5986,6486,12472
85,85125,2027-12-31,6036,6456,12492
85,85125,2028-12-31,6081,6444,12525
85,85125,2029-12-31,6126,6441,12567
85,85125,2030-12-31,6178,6439,12617
85,85125,2031-12-31,6219,6436,12655
85,85125,2032-12-31,6263,6441,12704
85,85125,2033-12-31,6304,6443,12747
85,85125,2034-12-31,6340,6444,12784
85,85125,2035-12-31,6386,6428,12814
85,85136,1985-12-31,200,1581,1781
85,85136,1986-12-31,177,1577,1754
85,85136,1987-12-31,187,1529,1716
85,85136,1988-12-31,201,1511,1712
85,85136,1989-12-31,196,1444,1640
85,85136,1990-12-31,231,1409,1640
85,85136,1991-12-31,239,1370,1609
85,85136,1992-12-31,261,1236,1497
85,85136,1993-12-31,291,1161,1452
85,85136,1994-12-31,313,1069,1382
85,85136,1995-12-31,373,984,1357
85,85136,1996-12-31,406,942,1348
85,85136,1997-12-31,348,912,1260
85,85136,1998-12-31,389,866,1255
85,85136,1999-12-31,425,858,1283
85,85136,2000-12-31,451,826,1277
85,85136,2001-12-31,471,812,1283
85,85136,2002-12-31,480,804,1284
85,85136,2003-12-31,486,827,1313
85,85136,2004-12-31,483,810,1293
85,85136,2005-12-31,507,804,1311
85,85136,2006-12-31,502,814,1316
85,85136,2007-12-31,493,797,1290
85,85136,2008-12-31,543,822,1365
85,85136,2009-12-31,522,814,1336
85,85136,2010-12-31,513,800,1313
85,85136,2011-12-31,540,803,1343
85,85136,2012-12-31,552,791,1343
85,85136,2013-12-31,580,809,1389
85,85136,2014-12-31,602,820,1422
85,85136,2015-12-31,612,798,1410
85,85136,2016-12-31,617,791,1408
85,85136,2017-12-31,620,759,1379
85,85136,2018-12-31,636,781,1417
85,85136,2019-12-31,652,733,1385
85,85136,2020-12-31,666,703,1369
85,85136,2021-12-31,682,700,1382
85,85136,2022-12-31,694,696,1390
85,85136,2023-12-31,706,692,1398
85,85136,2024-12-31,709,689,1398
85,85136,2025-12-31,714,681,1395
85,85136,2026-12-31,723,681,1404
85,85136,2027-12-31,728,678,1406
85,85136,2028-12-31,740,677,1417
85,85136,2029-12-31,746,680,1426
85,85136,2030-12-31,752,681,1433
85,85136,2031-12-31,752,677,1429
85,85136,2032-12-31,760,681,1441
85,85136,2033-12-31,763,678,1441
85,85136,2034-12-31,772,679,1451
85,85136,2035-12-31,770,676,1446
85,85139,1985-12-31,3141,7912,11053
85,85139,1986-12-31,3246,7974,11220
85,85139,1987-12-31,3362,8005,11367
85,85139,1988-12-31,3541,7891,11432
85,85139,1989-12-31,3789,7774,11563
85,85139,1990-12-31,4105,7532,11637
85,85139,1991-12-31,4503,7199,11702
85,85139,1992-12-31,4949,6826,11775
85,85139,1993-12-31,5420,6404,11824
85,85139,1994-12-31,5894,5992,11886
85,85139,1995-12-31,6328,5635,11963
85,85139,1996-12-31,6732,5374,12106
85,85139,1997-12-31,7070,5171,12241
85,85139,1998-12-31,7375,5052,12427
85,85139,1999-12-31,7635,4987,12622
85,85139,2000-12-31,7868,4960,12828
85,85139,2001-12-31,8100,4978,13078
85,85139,2002-12-31,8314,4990,13304
85,85139,2003-12-31,8481,5045,13526
85,85139,2004-12-31,8704,5104,13808
85,85139,2005-12-31,8869,5161,14030
85,85139,2006-12-31,9081,5231,14312
85,85139,2007-12-31,9246,5281,14527
85,85139,2008-12-31,9424,5351,14775
85,85139,2009-12-31,9606,5426,15032
85,85139,2010-12-31,9775,5478,15253
85,85139,2011-12-31,9945,5547,15492
85,85139,2012-12-31,10129,5614,15743
85,85139,2013-12-31,10280,5663,15943
85,85139,2014-12-31,10485,5717,16202
85,85139,2015-12-31,10615,5764,16379
85,85139,2016-12-31,10835,5844,16679
85,85139,2017-12-31,10957,5870,16827
85,85139,2018-12-31,11216,5995,17211
85,85139,2019-12-31,11459,5900,17359
85,85139,2020-12-31,11660,5803,17463
85,85139,2021-12-31,11843,5781,17624
85,85139,2022-12-31,11988,5749,17737
85,85139,2023-12-31,12127,5712,17839
85,85139,2024-12-31,12240,5683,17923
85,85139,2025-12-31,12354,5648,18002
85,85139,2026-12-31,12476,5627,18103
85,85139,2027-12-31,12587,5610,18197
85,85139,2028-12-31,12683,5597,18280
85,85139,2029-12-31,12786,5593,18379
85,85139,2030-12-31,12874,5595,18469
85,85139,2031-12-31,12965,5599,18564
85,85139,2032-12-31,13060,5600,18660
85,85139,2033-12-31,13139,5610,18749
85,85139,2034-12-31,13229,5604,18833
85,85139,2035-12-31,13294,5592,18886
85,85162,1985-12-31,3436,5263,8699
85,85162,1986-12-31,3533,5341,8874
85,85162,1987-12-31,3659,5404,9063
85,85162,1988-12-31,3862,5418,9280
85,85162,1989-12-31,4134,5378,9512
85,85162,1990-12-31,4480,5263,9743
85,85162,1991-12-31,4909,5038,9947
85,85162,1992-12-31,5391,4840,10231
85,85162,1993-12-31,5899,4577,10476
85,85162,1994-12-31,6407,4359,10766
85,85162,1995-12-31,6883,4142,11025
85,85162,1996-12-31,7318,3969,11287
85,85162,1997-12-31,7693,3886,11579
85,85162,1998-12-31,8012,3804,11816
85,85162,1999-12-31,8299,3798,12097
85,85162,2000-12-31,8562,3818,12380
85,85162,2001-12-31,8801,3862,12663
85,85162,2002-12-31,9029,3895,12924
85,85162,2003-12-31,9248,3973,13221
85,85162,2004-12-31,9443,4056,13499
85,85162,2005-12-31,9646,4172,13818
85,85162,2006-12-31,9850,4244,14094
85,85162,2007-12-31,10054,4331,14385
85,85162,2008-12-31,10242,4421,14663
85,85162,2009-12-31,10437,4504,14941
85,85162,2010-12-31,10621,4592,15213
85,85162,2011-12-31,10810,4708,15518
85,85162,2012-12-31,10979,4787,15766
85,85162,2013-12-31,11177,4863,16040
85,85162,2014-12-31,11355,4956,16311
85,85162,2015-12-31,11545,5059,16604
85,85162,2016-12-31,11719,5148,16867
85,85162,2017-12-31,11878,5215,17093
85,85162,2018-12-31,12178,5359,17537
85,85162,2019-12-31,12487,5310,17797
85,85162,2020-12-31,12751,5258,18009
85,85162,2021-12-31,12937,5238,18175
85,85162,2022-12-31,13083,5209,18292
85,85162,2023-12-31,13222,5175,18397
85,85162,2024-12-31,13356,5141,18497
85,85162,2025-12-31,13478,5115,18593
85,85162,2026-12-31,13587,5100,18687
85,85162,2027-12-31,13710,5073,18783
85,85162,2028-12-31,13830,5065,18895
85,85162,2029-12-31,13935,5056,18991
85,85162,2030-12-31,14038,5059,19097
85,85162,2031-12-31,14143,5061,19204
85,85162,2032-12-31,14231,5065,19296
85,85162,2033-12-31,14323,5062,19385
85,85162,2034-12-31,14412,5058,19470
85,85162,2035-12-31,14497,5073,19570
85,85225,1985-12-31,639,8295,8934
85,85225,1986-12-31,644,8360,9004
85,85225,1987-12-31,653,8401,9054
85,85225,1988-12-31,700,8370,9070
85,85225,1989-12-31,732,8238,8970
85,85225,1990-12-31,777,8004,8781
85,85225,1991-12-31,847,7679,8526
85,85225,1992-12-31,919,7290,8209
85,85225,1993-12-31,997,6871,7868
85,85225,1994-12-31,1072,6435,7507
85,85225,1995-12-31,1158,6090,7248
85,85225,1996-12-31,1216,5817,7033
85,85225,1997-12-31,1269,5629,6898
85,85225,1998-12-31,1310,5527,6837
85,85225,1999-12-31,1351,5471,6822
85,85225,2000-12-31,1376,5450,6826
85,85225,2001-12-31,1429,5478,6907
85,85225,2002-12-31,1454,5533,6987
85,85225,2003-12-31,1493,5596,7089
85,85225,2004-12-31,1521,5670,7191
85,85225,2005-12-31,1535,5756,7291
85,85225,2006-12-31,1571,5848,7419
85,85225,2007-12-31,1581,5914,7495
85,85225,2008-12-31,1631,6026,7657
85,85225,2009-12-31,1658,6124,7782
85,85225,2010-12-31,1692,6212,7904
85,85225,2011-12-31,1724,6296,8020
85,85225,2012-12-31,1749,6377,8126
85,85225,2013-12-31,1805,6453,8258
85,85225,2014-12-31,1782,6529,8311
85,85225,2015-12-31,1789,6605,8394
85,85225,2016-12-31,1851,6705,8556
85,85225,2017-12-31,1873,6790,8663
85,85225,2018-12-31,1904,6922,8826
85,85225,2019-12-31,1949,6789,8738
85,85225,2020-12-31,1988,6725,8713
85,85225,2021-12-31,2093,6700,8793
85,85225,2022-12-31,2188,6662,8850
85,85225,2023-12-31,2281,6619,8900
85,85225,2024-12-31,2321,6580,8901
85,85225,2025-12-31,2345,6568,8913
85,85225,2026-12-31,2372,6521,8893
85,85225,2027-12-31,2388,6523,8911
85,85225,2028-12-31,2413,6481,8894
85,85225,2029-12-31,2436,6477,8913
85,85225,2030-12-31,2446,6475,8921
85,85225,2031-12-31,2466,6479,8945
85,85225,2032-12-31,2490,6479,8969
85,85225,2033-12-31,2512,6476,8988
85,85225,2034-12-31,2524,6479,9003
85,85225,2035-12-31,2527,6494,9021
85,85230,1985-12-31,1371,3906,5277
85,85230,1986-12-31,1433,4072,5505
85,85230,1987-12-31,1503,4238,5741
85,85230,1988-12-31,1592,4362,5954
85,85230,1989-12-31,1729,4434,6163
85,85230,1990-12-31,1873,4448,6321
85,85230,1991-12-31,2069,4407,6476
85,85230,1992-12-31,2283,4285,6568
85,85230,1993-12-31,2511,4148,6659
85,85230,1994-12-31,2755,4042,6797
85,85230,1995-12-31,2953,3902,6855
85,85230,1996-12-31,3141,3831,6972
85,85230,1997-12-31,3323,3788,7111
85,85230,1998-12-31,3466,3808,7274
85,85230,1999-12-31,3599,3858,7457
85,85230,2000-12-31,3724,3944,7668
85,85230,2001-12-31,3828,4043,7871
85,85230,2002-12-31,3925,4184,8109
85,85230,2003-12-31,4017,4310,8327
85,85230,2004-12-31,4106,4463,8569
85,85230,2005-12-31,4192,4617,8809
85,85230,2006-12-31,4291,4789,9080
85,85230,2007-12-31,4389,4979,9368
85,85230,2008-12-31,4488,5138,9626
85,85230,2009-12-31,4583,5309,9892
85,85230,2010-12-31,4663,5468,10131
85,85230,2011-12-31,4738,5654,10392
85,85230,2012-12-31,4836,5835,10671
85,85230,2013-12-31,4902,6009,10911
85,85230,2014-12-31,5001,6183,11184
85,85230,2015-12-31,5104,6355,11459
85,85230,2016-12-31,5151,6563,11714
85,85230,2017-12-31,5282,6747,12029
85,85230,2018-12-31,5376,6964,12340
85,85230,2019-12-31,5516,6998,12514
85,85230,2020-12-31,5635,7017,12652
85,85230,2021-12-31,5776,6992,12768
85,85230,2022-12-31,5898,6953,12851
85,85230,2023-12-31,6016,6908,12924
85,85230,2024-12-31,6091,6857,12948
85,85230,2025-12-31,6150,6818,12968
85,85230,2026-12-31,6209,6789,12998
85,85230,2027-12-31,6266,6769,13035
85,85230,2028-12-31,6317,6750,13067
85,85230,2029-12-31,6367,6744,13111
85,85230,2030-12-31,6412,6762,13174
85,85230,2031-12-31,6451,6760,13211
85,85230,2032-12-31,6504,6767,13271
85,85230,2033-12-31,6545,6780,13325
85,85230,2034-12-31,6573,6772,13345
85,85230,2035-12-31,6615,6757,13372
85,85250,1985-12-31,8918,8033,16951
85,85250,1986-12-31,8887,8278,17165
85,85250,1987-12-31,9035,8508,17543
85,85250,1988-12-31,9321,8658,17979
85,85250,1989-12-31,9826,8721,18547
85,85250,1990-12-31,10497,8656,19153
85,85250,1991-12-31,11362,8450,19812
85,85250,1992-12-31,12351,8177,20528
85,85250,1993-12-31,13407,7850,21257
85,85250,1994-12-31,14424,7472,21896
85,85250,1995-12-31,15388,7204,22592
85,85250,1996-12-31,16211,7001,23212
85,85250,1997-12-31,16909,6889,23798
85,85250,1998-12-31,17524,6871,24395
85,85250,1999-12-31,18052,6914,24966
85,85250,2000-12-31,18514,7021,25535
85,85250,2001-12-31,18931,7154,26085
85,85250,2002-12-31,19322,7341,26663
85,85250,2003-12-31,19692,7534,27226
85,85250,2004-12-31,20045,7751,27796
85,85250,2005-12-31,20406,7985,28391
85,85250,2006-12-31,20764,8225,28989
85,85250,2007-12-31,21116,8463,29579
85,85250,2008-12-31,21453,8717,30170
85,85250,2009-12-31,21799,8968,30767
85,85250,2010-12-31,22136,9223,31359
85,85250,2011-12-31,22461,9479,31940
85,85250,2012-12-31,22780,9732,32512
85,85250,2013-12-31,23104,9976,33080
85,85250,2014-12-31,23453,10232,33685
85,85250,2015-12-31,23741,10473,34214
85,85250,2016-12-31,24080,10710,34790
85,85250,2017-12-31,24467,11015,35482
85,85250,2018-12-31,24933,11344,36277
85,85250,2019-12-31,25103,11758,36861
85,85250,2020-12-31,25302,12045,37347
85,85250,2021-12-31,25688,12002,37690
85,85250,2022-12-31,25998,11935,37933
85,85250,2023-12-31,26293,11858,38151
85,85250,2024-12-31,26543,11795,38338
85,85250,2025-12-31,26809,11727,38536
85,85250,2026-12-31,27037,11688,38725
85,85250,2027-12-31,27270,11645,38915
85,85250,2028-12-31,27475,11609,39084
85,85250,2029-12-31,27697,11602,39299
85,85250,2030-12-31,27918,11604,39522
85,85250,2031-12-31,28125,11618,39743
85,85250,2032-12-31,28327,11609,39936
85,85250,2033-12-31,28496,11614,40110
85,85250,2034-12-31,28659,11609,40268
85,85250,2035-12-31,28826,11616,40442
85,85263,1985-12-31,1804,6556,8360
85,85263,1986-12-31,1875,6615,8490
85,85263,1987-12-31,1957,6611,8568
85,85263,1988-12-31,2065,6573,8638
85,85263,1989-12-31,2223,6456,8679
85,85263,1990-12-31,2430,6251,8681
85,85263,1991-12-31,2677,6007,8684
85,85263,1992-12-31,2920,5690,8610
85,85263,1993-12-31,3248,5315,8563
85,85263,1994-12-31,3521,5025,8546
85,85263,1995-12-31,3782,4734,8516
85,85263,1996-12-31,4026,4504,8530
85,85263,1997-12-31,4246,4342,8588
85,85263,1998-12-31,4429,4253,8682
85,85263,1999-12-31,4607,4199,8806
85,85263,2000-12-31,4754,4205,8959
85,85263,2001-12-31,4846,4204,9050
85,85263,2002-12-31,4980,4238,9218
85,85263,2003-12-31,5126,4278,9404
85,85263,2004-12-31,5236,4330,9566
85,85263,2005-12-31,5363,4384,9747
85,85263,2006-12-31,5485,4444,9929
85,85263,2007-12-31,5589,4504,10093
85,85263,2008-12-31,5694,4559,10253
85,85263,2009-12-31,5812,4615,10427
85,85263,2010-12-31,5917,4680,10597
85,85263,2011-12-31,6027,4735,10762
85,85263,2012-12-31,6124,4791,10915
85,85263,2013-12-31,6250,4854,11104
85,85263,2014-12-31,6380,4875,11255
85,85263,2015-12-31,6451,4969,11420
85,85263,2016-12-31,6567,4996,11563
85,85263,2017-12-31,6655,5081,11736
85,85263,2018-12-31,6822,5145,11967
85,85263,2019-12-31,6966,5035,12001
85,85263,2020-12-31,7083,4976,12059
85,85263,2021-12-31,7213,4957,12170
85,85263,2022-12-31,7319,4929,12248
85,85263,2023-12-31,7420,4898,12318
85,85263,2024-12-31,7496,4863,12359
85,85263,2025-12-31,7558,4843,12401
85,85263,2026-12-31,7635,4821,12456
85,85263,2027-12-31,7696,4809,12505
85,85263,2028-12-31,7761,4796,12557
85,85263,2029-12-31,7832,4792,12624
85,85263,2030-12-31,7890,4793,12683
85,85263,2031-12-31,7938,4801,12739
85,85263,2032-12-31,7994,4804,12798
85,85263,2033-12-31,8040,4799,12839
85,85263,2034-12-31,8084,4795,12879
85,85263,2035-12-31,8136,4793,12929
85,85279,1985-12-31,0,3381,3381
85,85279,1986-12-31,51,3345,3396
85,85279,1987-12-31,52,3319,3371
85,85279,1988-12-31,52,3227,3279
85,85279,1989-12-31,46,3128,3174
85,85279,1990-12-31,48,2976,3024
85,85279,1991-12-31,71,2783,2854
85,85279,1992-12-31,106,2614,2720
85,85279,1993-12-31,123,2417,2540
85,85279,1994-12-31,152,2229,2381
85,85279,1995-12-31,84,2059,2143
85,85279,1996-12-31,114,1917,2031
85,85279,1997-12-31,135,1804,1939
85,85279,1998-12-31,174,1775,1949
85,85279,1999-12-31,166,1733,1899
85,85279,2000-12-31,151,1662,1813
85,85279,2001-12-31,161,1629,1790
85,85279,2002-12-31,168,1623,1791
85,85279,2003-12-31,188,1593,1781
85,85279,2004-12-31,193,1588,1781
85,85279,2005-12-31,208,1560,1768
85,85279,2006-12-31,209,1547,1756
85,85279,2007-12-31,205,1575,1780
85,85279,2008-12-31,213,1526,1739
85,85279,2009-12-31,204,1493,1697
85,85279,2010-12-31,260,1499,1759
85,85279,2011-12-31,260,1472,1732
85,85279,2012-12-31,269,1460,1729
85,85279,2013-12-31,252,1386,1638
85,85279,2014-12-31,283,1390,1673
85,85279,2015-12-31,320,1396,1716
85,85279,2016-12-31,311,1402,1713
85,85279,2017-12-31,306,1371,1677
85,85279,2018-12-31,312,1322,1634
85,85279,2019-12-31,320,1398,1718
85,85279,2020-12-31,327,1469,1796
85,85279,2021-12-31,349,1464,1813
85,85279,2022-12-31,369,1456,1825
85,85279,2023-12-31,389,1446,1835
85,85279,2024-12-31,401,1424,1825
85,85279,2025-12-31,403,1426,1829
85,85279,2026-12-31,396,1416,1812
85,85279,2027-12-31,389,1411,1800
85,85279,2028-12-31,392,1421,1813
85,85279,2029-12-31,400,1416,1816
85,85279,2030-12-31,405,1413,1818
85,85279,2031-12-31,415,1413,1828
85,85279,2032-12-31,420,1417,1837
85,85279,2033-12-31,424,1409,1833
85,85279,2034-12-31,428,1413,1841
85,85279,2035-12-31,430,1414,1844
85,85300,1985-12-31,975,2842,3817
85,85300,1986-12-31,926,2843,3769
85,85300,1987-12-31,907,2831,3738
85,85300,1988-12-31,933,2797,3730
85,85300,1989-12-31,955,2729,3684
85,85300,1990-12-31,1009,2638,3647
85,85300,1991-12-31,1051,2539,3590
85,85300,1992-12-31,1130,2363,3493
85,85300,1993-12-31,1201,2192,3393
85,85300,1994-12-31,1284,2082,3366
85,85300,1995-12-31,1348,1929,3277
85,85300,1996-12-31,1371,1852,3223
85,85300,1997-12-31,1433,1784,3217
85,85300,1998-12-31,1454,1709,3163
85,85300,1999-12-31,1488,1682,3170
85,85300,2000-12-31,1499,1669,3168
85,85300,2001-12-31,1526,1672,3198
85,85300,2002-12-31,1537,1665,3202
85,85300,2003-12-31,1560,1677,3237
85,85300,2004-12-31,1568,1659,3227
85,85300,2005-12-31,1588,1718,3306
85,85300,2006-12-31,1583,1685,3268
85,85300,2007-12-31,1622,1732,3354
85,85300,2008-12-31,1626,1752,3378
85,85300,2009-12-31,1625,1748,3373
85,85300,2010-12-31,1656,1762,3418
85,85300,2011-12-31,1689,1768,3457
85,85300,2012-12-31,1689,1778,3467
85,85300,2013-12-31,1692,1772,3464
85,85300,2014-12-31,1717,1775,3492
85,85300,2015-12-31,1711,1794,3505
85,85300,2016-12-31,1729,1800,3529
85,85300,2017-12-31,1752,1814,3566
85,85300,2018-12-31,1781,1844,3625
85,85300,2019-12-31,1768,1815,3583
85,85300,2020-12-31,1765,1804,3569
85,85300,2021-12-31,1805,1797,3602
85,85300,2022-12-31,1838,1787,3625
85,85300,2023-12-31,1870,1776,3646
85,85300,2024-12-31,1877,1760,3637
85,85300,2025-12-31,1897,1763,3660
85,85300,2026-12-31,1920,1754,3674
85,85300,2027-12-31,1942,1745,3687
85,85300,2028-12-31,1955,1747,3702
85,85300,2029-12-31,1959,1747,3706
85,85300,2030-12-31,1974,1741,3715
85,85300,2031-12-31,1999,1742,3741
85,85300,2032-12-31,2011,1740,3751
85,85300,2033-12-31,2025,1736,3761
85,85300,2034-12-31,2033,1745,3778
85,85300,2035-12-31,2048,1740,3788
85,85315,1985-12-31,425,891,1316
85,85315,1986-12-31,417,908,1325
85,85315,1987-12-31,409,912,1321
85,85315,1988-12-31,443,915,1358
85,85315,1989-12-31,432,940,1372
85,85315,1990-12-31,465,910,1375
85,85315,1991-12-31,523,891,1414
85,85315,1992-12-31,547,808,1355
85,85315,1993-12-31,595,777,1372
85,85315,1994-12-31,634,758,1392
85,85315,1995-12-31,647,724,1371
85,85315,1996-12-31,697,705,1402
85,85315,1997-12-31,742,692,1434
85,85315,1998-12-31,767,672,1439
85,85315,1999-12-31,757,688,1445
85,85315,2000-12-31,786,698,1484
85,85315,2001-12-31,811,713,1524
85,85315,2002-12-31,814,728,1542
85,85315,2003-12-31,823,742,1565
85,85315,2004-12-31,831,749,1580
85,85315,2005-12-31,852,762,1614
85,85315,2006-12-31,862,789,1651
85,85315,2007-12-31,863,820,1683
85,85315,2008-12-31,884,844,1728
85,85315,2009-12-31,911,866,1777
85,85315,2010-12-31,920,886,1806
85,85315,2011-12-31,930,919,1849
85,85315,2012-12-31,924,931,1855
85,85315,2013-12-31,922,946,1868
85,85315,2014-12-31,922,967,1889
85,85315,2015-12-31,994,998,1992
85,85315,2016-12-31,1008,1012,2020
85,85315,2017-12-31,1015,1035,2050
85,85315,2018-12-31,1020,1070,2090
85,85315,2019-12-31,1043,1030,2073
85,85315,2020-12-31,1063,996,2059
85,85315,2021-12-31,1086,992,2078
85,85315,2022-12-31,1104,987,2091
85,85315,2023-12-31,1123,980,2103
85,85315,2024-12-31,1135,974,2109
85,85315,2025-12-31,1142,969,2111
85,85315,2026-12-31,1156,963,2119
85,85315,2027-12-31,1165,956,2121
85,85315,2028-12-31,1175,960,2135
85,85315,2029-12-31,1182,957,2139
85,85315,2030-12-31,1187,955,2142
85,85315,2031-12-31,1201,955,2156
85,85315,2032-12-31,1209,959,2168
85,85315,2033-12-31,1224,959,2183
85,85315,2034-12-31,1230,950,2180
85,85315,2035-12-31,1238,956,2194
85,85325,1985-12-31,1049,7113,8162
85,85325,1986-12-31,1036,7172,8208
85,85325,1987-12-31,1052,7151,8203
85,85325,1988-12-31,1095,7098,8193
85,85325,1989-12-31,1155,6973,8128
85,85325,1990-12-31,1255,6777,8032
85,85325,1991-12-31,1349,6482,7831
85,85325,1992-12-31,1484,6120,7604
85,85325,1993-12-31,1613,5740,7353
85,85325,1994-12-31,1753,5392,7145
85,85325,1995-12-31,1866,5085,6951
85,85325,1996-12-31,1937,4852,6789
85,85325,1997-12-31,2030,4684,6714
85,85325,1998-12-31,2107,4555,6662
85,85325,1999-12-31,2182,4494,6676
85,85325,2000-12-31,2252,4474,6726
85,85325,2001-12-31,2325,4488,6813
85,85325,2002-12-31,2311,4515,6826
85,85325,2003-12-31,2377,4562,6939
85,85325,2004-12-31,2420,4613,7033
85,85325,2005-12-31,2480,4660,7140
85,85325,2006-12-31,2513,4738,7251
85,85325,2007-12-31,2526,4777,7303
85,85325,2008-12-31,2592,4844,7436
85,85325,2009-12-31,2661,4900,7561
85,85325,2010-12-31,2711,4957,7668
85,85325,2011-12-31,2753,5020,7773
85,85325,2012-12-31,2810,5067,7877
85,85325,2013-12-31,2838,5127,7965
85,85325,2014-12-31,2896,5173,8069
85,85325,2015-12-31,2927,5211,8138
85,85325,2016-12-31,2925,5271,8196
85,85325,2017-12-31,2987,5333,8320
85,85325,2018-12-31,3058,5408,8466
85,85325,2019-12-31,3028,5350,8378
85,85325,2020-12-31,3005,5341,8346
85,85325,2021-12-31,3102,5321,8423
85,85325,2022-12-31,3186,5291,8477
85,85325,2023-12-31,3269,5257,8526
85,85325,2024-12-31,3307,5226,8533
85,85325,2025-12-31,3333,5190,8523
85,85325,2026-12-31,3363,5176,8539
85,85325,2027-12-31,3393,5148,8541
85,85325,2028-12-31,3416,5145,8561
85,85325,2029-12-31,3455,5143,8598
85,85325,2030-12-31,3476,5123,8599
85,85325,2031-12-31,3505,5135,8640
85,85325,2032-12-31,3518,5127,8645
85,85325,2033-12-31,3544,5140,8684
85,85325,2034-12-31,3567,5133,8700
85,85325,2035-12-31,3584,5122,8706
85,85400,1985-12-31,1324,8872,10196
85,85400,1986-12-31,1234,8862,10096
85,85400,1987-12-31,1180,8803,9983
85,85400,1988-12-31,1150,8686,9836
85,85400,1989-12-31,1158,8460,9618
85,85400,1990-12-31,1209,8160,9369
85,85400,1991-12-31,1249,7762,9011
85,85400,1992-12-31,1325,7285,8610
85,85400,1993-12-31,1373,6817,8190
85,85400,1994-12-31,1439,6303,7742
85,85400,1995-12-31,1507,5910,7417
85,85400,1996-12-31,1545,5576,7121
85,85400,1997-12-31,1567,5356,6923
85,85400,1998-12-31,1590,5197,6787
85,85400,1999-12-31,1600,5082,6682
85,85400,2000-12-31,1592,5020,6612
85,85400,2001-12-31,1584,4999,6583
85,85400,2002-12-31,1597,4986,6583
85,85400,2003-12-31,1608,5006,6614
85,85400,2004-12-31,1603,5008,6611
85,85400,2005-12-31,1585,5035,6620
85,85400,2006-12-31,1583,5069,6652
85,85400,2007-12-31,1589,5080,6669
85,85400,2008-12-31,1595,5098,6693
85,85400,2009-12-31,1597,5125,6722
85,85400,2010-12-31,1598,5139,6737
85,85400,2011-12-31,1598,5152,6750
85,85400,2012-12-31,1610,5164,6774
85,85400,2013-12-31,1621,5175,6796
85,85400,2014-12-31,1582,5179,6761
85,85400,2015-12-31,1620,5199,6819
85,85400,2016-12-31,1614,5176,6790
85,85400,2017-12-31,1627,5241,6868
85,85400,2018-12-31,1634,5239,6873
85,85400,2019-12-31,1577,5094,6671
85,85400,2020-12-31,1547,5020,6567
85,85400,2021-12-31,1626,5001,6627
85,85400,2022-12-31,1697,4973,6670
85,85400,2023-12-31,1767,4941,6708
85,85400,2024-12-31,1785,4917,6702
85,85400,2025-12-31,1796,4885,6681
85,85400,2026-12-31,1814,4860,6674
85,85400,2027-12-31,1831,4854,6685
85,85400,2028-12-31,1846,4840,6686
85,85400,2029-12-31,1858,4839,6697
85,85400,2030-12-31,1874,4838,6712
85,85400,2031-12-31,1883,4834,6717
85,85400,2032-12-31,1897,4841,6738
85,85400,2033-12-31,1915,4840,6755
85,85400,2034-12-31,1919,4851,6770
85,85400,2035-12-31,1936,4845,6781
85,85410,1985-12-31,1486,7541,9027
85,85410,1986-12-31,1836,7716,9552
85,85410,1987-12-31,2170,7848,10018
85,85410,1988-12-31,2537,7917,10454
85,85410,1989-12-31,2964,7867,10831
85,85410,1990-12-31,3420,7764,11184
85,85410,1991-12-31,3957,7529,11486
85,85410,1992-12-31,4544,7227,11771
85,85410,1993-12-31,5163,6896,12059
85,85410,1994-12-31,5819,6550,12369
85,85410,1995-12-31,6415,6277,12692
85,85410,1996-12-31,7005,6065,13070
85,85410,1997-12-31,7538,5939,13477
85,85410,1998-12-31,8005,5891,13896
85,85410,1999-12-31,8436,5885,14321
85,85410,2000-12-31,8839,5958,14797
85,85410,2001-12-31,9219,6053,15272
85,85410,2002-12-31,9592,6177,15769
85,85410,2003-12-31,9907,6306,16213
85,85410,2004-12-31,10252,6472,16724
85,85410,2005-12-31,10583,6621,17204
85,85410,2006-12-31,10905,6798,17703
85,85410,2007-12-31,11234,6963,18197
85,85410,2008-12-31,11537,7139,18676
85,85410,2009-12-31,11850,7324,19174
85,85410,2010-12-31,12149,7498,19647
85,85410,2011-12-31,12438,7667,20105
85,85410,2012-12-31,12733,7844,20577
85,85410,2013-12-31,13018,8042,21060
85,85410,2014-12-31,13298,8195,21493
85,85410,2015-12-31,13581,8356,21937
85,85410,2016-12-31,13863,8539,22402
85,85410,2017-12-31,14186,8760,22946
85,85410,2018-12-31,14549,8978,23527
85,85410,2019-12-31,15247,9198,24445
85,85410,2020-12-31,15811,9362,25173
85,85410,2021-12-31,16082,9328,25410
85,85410,2022-12-31,16297,9276,25573
85,85410,2023-12-31,16503,9217,25720
85,85410,2024-12-31,16681,9174,25855
85,85410,2025-12-31,16835,9138,25973
85,85410,2026-12-31,16986,9090,26076
85,85410,2027-12-31,17134,9069,26203
85,85410,2028-12-31,17282,9038,26320
85,85410,2029-12-31,17414,9028,26442
85,85410,2030-12-31,17541,9039,26580
85,85410,2031-12-31,17656,9036,26692
85,85410,2032-12-31,17787,9037,26824
85,85410,2033-12-31,17912,9048,26960
85,85410,2034-12-31,18032,9043,27075
85,85410,2035-12-31,18134,9034,27168
85,85430,1985-12-31,1907,6591,8498
85,85430,1986-12-31,1925,6685,8610
85,85430,1987-12-31,2022,6750,8772
85,85430,1988-12-31,2122,6754,8876
85,85430,1989-12-31,2268,6660,8928
85,85430,1990-12-31,2474,6482,8956
85,85430,1991-12-31,2723,6278,9001
85,85430,1992-12-31,2975,5957,8932
85,85430,1993-12-31,3283,5630,8913
85,85430,1994-12-31,3575,5331,8906
85,85430,1995-12-31,3838,5083,8921
85,85430,1996-12-31,4100,4873,8973
85,85430,1997-12-31,4314,4720,9034
85,85430,1998-12-31,4504,4656,9160
85,85430,1999-12-31,4650,4637,9287
85,85430,2000-12-31,4816,4656,9472
85,85430,2001-12-31,4940,4695,9635
85,85430,2002-12-31,5088,4744,9832
85,85430,2003-12-31,5205,4826,10031
85,85430,2004-12-31,5314,4915,10229
85,85430,2005-12-31,5428,5003,10431
85,85430,2006-12-31,5550,5096,10646
85,85430,2007-12-31,5669,5208,10877
85,85430,2008-12-31,5775,5299,11074
85,85430,2009-12-31,5878,5407,11285
85,85430,2010-12-31,6003,5515,11518
85,85430,2011-12-31,6104,5622,11726
85,85430,2012-12-31,6204,5712,11916
85,85430,2013-12-31,6315,5807,12122
85,85430,2014-12-31,6420,5906,12326
85,85430,2015-12-31,6523,5995,12518
85,85430,2016-12-31,6670,6109,12779
85,85430,2017-12-31,6757,6211,12968
85,85430,2018-12-31,6891,6342,13233
85,85430,2019-12-31,7066,6284,13350
85,85430,2020-12-31,7215,6234,13449
85,85430,2021-12-31,7363,6210,13573
85,85430,2022-12-31,7484,6176,13660
85,85430,2023-12-31,7602,6136,13738
85,85430,2024-12-31,7687,6096,13783
85,85430,2025-12-31,7754,6064,13818
85,85430,2026-12-31,7829,6043,13872
85,85430,2027-12-31,7910,6019,13929
85,85430,2028-12-31,7971,6019,13990
85,85430,2029-12-31,8024,5998,14022
85,85430,2030-12-31,8082,6005,14087
85,85430,2031-12-31,8140,6015,14155
85,85430,2032-12-31,8193,6021,14214
85,85430,2033-12-31,8247,6010,14257
85,85430,2034-12-31,8309,6022,14331
85,85430,2035-12-31,8362,6024,14386
85,85440,1985-12-31,8643,3124,11767
85,85440,1986-12-31,8701,3388,12089
85,85440,1987-12-31,8904,3670,12574
85,85440,1988-12-31,9257,3901,13158
85,85440,1989-12-31,9814,4075,13889
85,85440,1990-12-31,10555,4182,14737
85,85440,1991-12-31,11457,4232,15689
85,85440,1992-12-31,12506,4237,16743
85,85440,1993-12-31,13612,4181,17793
85,85440,1994-12-31,14692,4132,18824
85,85440,1995-12-31,15720,4062,19782
85,85440,1996-12-31,16611,4052,20663
85,85440,1997-12-31,17385,4095,21480
85,85440,1998-12-31,18065,4157,22222
85,85440,1999-12-31,18636,4272,22908
85,85440,2000-12-31,19149,4423,23572
85,85440,2001-12-31,19610,4607,24217
85,85440,2002-12-31,20047,4794,24841
85,85440,2003-12-31,20465,5011,25476
85,85440,2004-12-31,20876,5235,26111
85,85440,2005-12-31,21263,5468,26731
85,85440,2006-12-31,21665,5713,27378
85,85440,2007-12-31,22065,5970,28035
85,85440,2008-12-31,22454,6211,28665
85,85440,2009-12-31,22828,6464,29292
85,85440,2010-12-31,23209,6740,29949
85,85440,2011-12-31,23577,6999,30576
85,85440,2012-12-31,23938,7272,31210
85,85440,2013-12-31,24294,7536,31830
85,85440,2014-12-31,24656,7794,32450
85,85440,2015-12-31,25024,8072,33096
85,85440,2016-12-31,25381,8330,33711
85,85440,2017-12-31,25844,8669,34513
85,85440,2018-12-31,26322,8983,35305
85,85440,2019-12-31,26647,9146,35793
85,85440,2020-12-31,26991,9193,36184
85,85440,2021-12-31,27357,9160,36517
85,85440,2022-12-31,27643,9109,36752
85,85440,2023-12-31,27913,9050,36963
85,85440,2024-12-31,28188,8992,37180
85,85440,2025-12-31,28443,8941,37384
85,85440,2026-12-31,28699,8906,37605
85,85440,2027-12-31,28940,8885,37825
85,85440,2028-12-31,29180,8856,38036
85,85440,2029-12-31,29422,8846,38268
85,85440,2030-12-31,29636,8853,38489
85,85440,2031-12-31,29860,8864,38724
85,85440,2032-12-31,30056,8859,38915
85,85440,2033-12-31,30248,8859,39107
85,85440,2034-12-31,30417,8866,39283
85,85440,2035-12-31,30599,8869,39468
86,86001,1985-12-31,7699,17261,24960
86,86001,1986-12-31,8399,18291,26690
86,86001,1987-12-31,9016,19321,28337
86,86001,1988-12-31,9681,20360,30041
86,86001,1989-12-31,10312,21394,31706
86,86001,1990-12-31,10938,22395,33333
86,86001,1991-12-31,11572,23384,34956
86,86001,1992-12-31,12261,24361,36622
86,86001,1993-12-31,12321,5419,17740
86,86001,1994-12-31,13385,5983,19368
86,86001,1995-12-31,14464,6539,21003
86,86001,1996-12-31,15589,7061,22650
86,86001,1997-12-31,16940,7517,24457
86,86001,1998-12-31,18497,7897,26394
86,86001,1999-12-31,20169,8223,28392
86,86001,2000-12-31,21871,8531,30402
86,86001,2001-12-31,23418,8874,32292
86,86001,2002-12-31,24797,9253,34050
86,86001,2003-12-31,26010,9672,35682
86,86001,2004-12-31,27059,10123,37182
86,86001,2005-12-31,28028,10628,38656
86,86001,2006-12-31,28907,11162,40069
86,86001,2007-12-31,29755,11673,41428
86,86001,2008-12-31,30590,12210,42800
86,86001,2009-12-31,31405,12759,44164
86,86001,2010-12-31,32211,13327,45538
86,86001,2011-12-31,32999,13892,46891
86,86001,2012-12-31,33746,14448,48194
86,86001,2013-12-31,34484,15015,49499
86,86001,2014-12-31,35218,15543,50761
86,86001,2015-12-31,35980,16098,52078
86,86001,2016-12-31,36789,16672,53461
86,86001,2017-12-31,37608,17290,54898
86,86001,2018-12-31,38457,17941,56398
86,86001,2019-12-31,39629,18087,57716
86,86001,2020-12-31,40689,18249,58938
86,86001,2021-12-31,41364,18391,59755
86,86001,2022-12-31,42044,18528,60572
86,86001,2023-12-31,42725,18666,61391
86,86001,2024-12-31,43518,18813,62331
86,86001,2025-12-31,44311,18929,63240
86,86001,2026-12-31,45110,19069,64179
86,86001,2027-12-31,45919,19218,65137
86,86001,2028-12-31,46702,19361,66063
86,86001,2029-12-31,47462,19537,66999
86,86001,2030-12-31,48240,19695,67935
86,86001,2031-12-31,48995,19877,68872
86,86001,2032-12-31,49743,20029,69772
86,86001,2033-12-31,50476,20220,70696
86,86001,2034-12-31,51198,20439,71637
86,86001,2035-12-31,51909,20675,72584
86,86219,1985-12-31,1575,1072,2647
86,86219,1986-12-31,1564,1097,2661
86,86219,1987-12-31,1609,1122,2731
86,86219,1988-12-31,1609,1150,2759
86,86219,1989-12-31,1627,1174,2801
86,86219,1990-12-31,1629,1192,2821
86,86219,1991-12-31,1670,1216,2886
86,86219,1992-12-31,1694,1244,2938
86,86219,1993-12-31,1645,1323,2968
86,86219,1994-12-31,1719,1360,3079
86,86219,1995-12-31,1792,1380,3172
86,86219,1996-12-31,1883,1388,3271
86,86219,1997-12-31,2005,1396,3401
86,86219,1998-12-31,2124,1391,3515
86,86219,1999-12-31,2321,1395,3716
86,86219,2000-12-31,2398,1426,3824
86,86219,2001-12-31,2507,1437,3944
86,86219,2002-12-31,2615,1453,4068
86,86219,2003-12-31,2701,1486,4187
86,86219,2004-12-31,2777,1500,4277
86,86219,2005-12-31,2846,1560,4406
86,86219,2006-12-31,2903,1571,4474
86,86219,2007-12-31,2944,1606,4550
86,86219,2008-12-31,2932,1618,4550
86,86219,2009-12-31,2994,1677,4671
86,86219,2010-12-31,3023,1703,4726
86,86219,2011-12-31,3074,1763,4837
86,86219,2012-12-31,3127,1778,4905
86,86219,2013-12-31,3139,1826,4965
86,86219,2014-12-31,3154,1884,5038
86,86219,2015-12-31,3219,1917,5136
86,86219,2016-12-31,3285,1932,5217
86,86219,2017-12-31,3350,1954,5304
86,86219,2018-12-31,3419,1988,5407
86,86219,2019-12-31,3417,2052,5469
86,86219,2020-12-31,3434,2096,5530
86,86219,2021-12-31,3493,2113,5606
86,86219,2022-12-31,3554,2128,5682
86,86219,2023-12-31,3615,2144,5759
86,86219,2024-12-31,3676,2147,5823
86,86219,2025-12-31,3743,2169,5912
86,86219,2026-12-31,3814,2178,5992
86,86219,2027-12-31,3881,2191,6072
86,86219,2028-12-31,3939,2220,6159
86,86219,2029-12-31,4009,2236,6245
86,86219,2030-12-31,4069,2261,6330
86,86219,2031-12-31,4140,2272,6412
86,86219,2032-12-31,4201,2304,6505
86,86219,2033-12-31,4272,2318,6590
86,86219,2034-12-31,4333,2314,6647
86,86219,2035-12-31,4401,2343,6744
86,86320,1985-12-31,6638,8548,15186
86,86320,1986-12-31,6809,8814,15623
86,86320,1987-12-31,6966,9109,16075
86,86320,1988-12-31,7176,9401,16577
86,86320,1989-12-31,7373,9654,17027
86,86320,1990-12-31,7586,9917,17503
86,86320,1991-12-31,7810,10174,17984
86,86320,1992-12-31,8079,10441,18520
86,86320,1993-12-31,7942,11075,19017
86,86320,1994-12-31,8454,11355,19809
86,86320,1995-12-31,8985,11632,20617
86,86320,1996-12-31,9522,11904,21426
86,86320,1997-12-31,10198,12078,22276
86,86320,1998-12-31,10992,12167,23159
86,86320,1999-12-31,11843,12212,24055
86,86320,2000-12-31,12688,12222,24910
86,86320,2001-12-31,13453,12285,25738
86,86320,2002-12-31,14098,12405,26503
86,86320,2003-12-31,14653,12624,27277
86,86320,2004-12-31,15120,12878,27998
86,86320,2005-12-31,15543,13186,28729
86,86320,2006-12-31,15885,13496,29381
86,86320,2007-12-31,16251,13823,30074
86,86320,2008-12-31,16594,14176,30770
86,86320,2009-12-31,16931,14544,31475
86,86320,2010-12-31,17241,14914,32155
86,86320,2011-12-31,17563,15276,32839
86,86320,2012-12-31,17891,15647,33538
86,86320,2013-12-31,18201,16003,34204
86,86320,2014-12-31,18512,16335,34847
86,86320,2015-12-31,18815,16709,35524
86,86320,2016-12-31,19152,17072,36224
86,86320,2017-12-31,19508,17471,36979
86,86320,2018-12-31,19833,17912,37745
86,86320,2019-12-31,20325,17919,38244
86,86320,2020-12-31,20787,17957,38744
86,86320,2021-12-31,21177,18096,39273
86,86320,2022-12-31,21579,18231,39810
86,86320,2023-12-31,21980,18367,40347
86,86320,2024-12-31,22389,18481,40870
86,86320,2025-12-31,22795,18642,41437
86,86320,2026-12-31,23219,18795,42014
86,86320,2027-12-31,23615,18928,42543
86,86320,2028-12-31,24020,19094,43114
86,86320,2029-12-31,24429,19224,43653
86,86320,2030-12-31,24818,19338,44156
86,86320,2031-12-31,25198,19417,44615
86,86320,2032-12-31,25584,19417,45001
86,86320,2033-12-31,25975,19234,45209
86,86320,2034-12-31,26347,18761,45108
86,86320,2035-12-31,26734,17838,44572
86,86568,1985-12-31,10672,33298,43970
86,86568,1986-12-31,11208,32643,43851
86,86568,1987-12-31,11645,32028,43673
86,86568,1988-12-31,12145,31456,43601
86,86568,1989-12-31,12645,30897,43542
86,86568,1990-12-31,13162,30339,43501
86,86568,1991-12-31,13703,29771,43474
86,86568,1992-12-31,14297,29249,43546
86,86568,1993-12-31,14177,18148,32325
86,86568,1994-12-31,15219,18491,33710
86,86568,1995-12-31,16264,18794,35058
86,86568,1996-12-31,17383,19106,36489
86,86568,1997-12-31,18714,19244,37958
86,86568,1998-12-31,20270,19260,39530
86,86568,1999-12-31,21961,19194,41155
86,86568,2000-12-31,23617,19091,42708
86,86568,2001-12-31,25154,19089,44243
86,86568,2002-12-31,26483,19204,45687
86,86568,2003-12-31,27633,19435,47068
86,86568,2004-12-31,28611,19724,48335
86,86568,2005-12-31,29507,20070,49577
86,86568,2006-12-31,30306,20463,50769
86,86568,2007-12-31,31078,20864,51942
86,86568,2008-12-31,31814,21306,53120
86,86568,2009-12-31,32538,21743,54281
86,86568,2010-12-31,33252,22214,55466
86,86568,2011-12-31,33965,22667,56632
86,86568,2012-12-31,34643,23122,57765
86,86568,2013-12-31,35317,23552,58869
86,86568,2014-12-31,35973,23979,59952
86,86568,2015-12-31,36655,24429,61084
86,86568,2016-12-31,37370,24915,62285
86,86568,2017-12-31,38162,25408,63570
86,86568,2018-12-31,38901,25966,64867
86,86568,2019-12-31,39733,26351,66084
86,86568,2020-12-31,40549,26662,67211
86,86568,2021-12-31,41270,26873,68143
86,86568,2022-12-31,41999,27075,69074
86,86568,2023-12-31,42730,27276,70006
86,86568,2024-12-31,43470,27497,70967
86,86568,2025-12-31,44218,27714,71932
86,86568,2026-12-31,44950,27932,72882
86,86568,2027-12-31,45694,28200,73894
86,86568,2028-12-31,46435,28424,74859
86,86568,2029-12-31,47198,28687,75885
86,86568,2030-12-31,47930,28946,76876
86,86568,2031-12-31,48661,29237,77898
86,86568,2032-12-31,49381,29521,78902
86,86568,2033-12-31,50089,29810,79899
86,86568,2034-12-31,50795,30157,80952
86,86568,2035-12-31,51486,30616,82102
86,86569,1985-12-31,0,0,0
86,86569,1986-12-31,0,0,0
86,86569,1987-12-31,0,0,0
86,86569,1988-12-31,0,0,0
86,86569,1989-12-31,0,0,0
86,86569,1990-12-31,0,0,0
86,86569,1991-12-31,0,0,0
86,86569,1992-12-31,0,0,0
86,86569,1993-12-31,1491,10071,11562
86,86569,1994-12-31,1663,10051,11714
86,86569,1995-12-31,1843,10024,11867
86,86569,1996-12-31,2019,10001,12020
86,86569,1997-12-31,2240,9912,12152
86,86569,1998-12-31,2504,9746,12250
86,86569,1999-12-31,2769,9556,12325
86,86569,2000-12-31,3064,9383,12447
86,86569,2001-12-31,3308,9212,12520
86,86569,2002-12-31,3522,9120,12642
86,86569,2003-12-31,3739,9082,12821
86,86569,2004-12-31,3932,9081,13013
86,86569,2005-12-31,4123,9108,13231
86,86569,2006-12-31,4292,9155,13447
86,86569,2007-12-31,4437,9220,13657
86,86569,2008-12-31,4584,9281,13865
86,86569,2009-12-31,4739,9347,14086
86,86569,2010-12-31,4870,9427,14297
86,86569,2011-12-31,5085,9482,14567
86,86569,2012-12-31,5245,9576,14821
86,86569,2013-12-31,5391,9633,15024
86,86569,2014-12-31,5546,9686,15232
86,86569,2015-12-31,5673,9745,15418
86,86569,2016-12-31,5773,9823,15596
86,86569,2017-12-31,5921,9903,15824
86,86569,2018-12-31,6089,10006,16095
86,86569,2019-12-31,6248,9785,16033
86,86569,2020-12-31,6397,9610,16007
86,86569,2021-12-31,6542,9684,16226
86,86569,2022-12-31,6691,9757,16448
86,86569,2023-12-31,6840,9829,16669
86,86569,2024-12-31,6989,9908,16897
86,86569,2025-12-31,7136,9984,17120
86,86569,2026-12-31,7288,10067,17355
86,86569,2027-12-31,7432,10121,17553
86,86569,2028-12-31,7581,10209,17790
86,86569,2029-12-31,7716,10304,18020
86,86569,2030-12-31,7854,10392,18246
86,86569,2031-12-31,7995,10470,18465
86,86569,2032-12-31,8131,10570,18701
86,86569,2033-12-31,8255,10676,18931
86,86569,2034-12-31,8388,10747,19135
86,86569,2035-12-31,8515,10862,19377
86,86571,1985-12-31,0,0,0
86,86571,1986-12-31,0,0,0
86,86571,1987-12-31,0,0,0
86,86571,1988-12-31,0,0,0
86,86571,1989-12-31,0,0,0
86,86571,1990-12-31,0,0,0
86,86571,1991-12-31,0,0,0
86,86571,1992-12-31,0,0,0
86,86571,1993-12-31,1884,18115,19999
86,86571,1994-12-31,2018,18608,20626
86,86571,1995-12-31,2124,19129,21253
86,86571,1996-12-31,2249,19610,21859
86,86571,1997-12-31,2422,19946,22368
86,86571,1998-12-31,2600,20158,22758
86,86571,1999-12-31,2789,20280,23069
86,86571,2000-12-31,2988,20316,23304
86,86571,2001-12-31,3142,20496,23638
86,86571,2002-12-31,3304,20766,24070
86,86571,2003-12-31,3413,21151,24564
86,86571,2004-12-31,3529,21627,25156
86,86571,2005-12-31,3610,22176,25786
86,86571,2006-12-31,3707,22747,26454
86,86571,2007-12-31,3788,23377,27165
86,86571,2008-12-31,3870,24012,27882
86,86571,2009-12-31,3948,24659,28607
86,86571,2010-12-31,4003,25317,29320
86,86571,2011-12-31,4096,25995,30091
86,86571,2012-12-31,4155,26640,30795
86,86571,2013-12-31,4231,27286,31517
86,86571,2014-12-31,4277,27909,32186
86,86571,2015-12-31,4341,28574,32915
86,86571,2016-12-31,4417,29249,33666
86,86571,2017-12-31,4517,29970,34487
86,86571,2018-12-31,4629,30761,35390
86,86571,2019-12-31,4714,31338,36052
86,86571,2020-12-31,4792,31873,36665
86,86571,2021-12-31,5048,32125,37173
86,86571,2022-12-31,5315,32367,37682
86,86571,2023-12-31,5583,32607,38190
86,86571,2024-12-31,5732,32854,38586
86,86571,2025-12-31,5861,33154,39015
86,86571,2026-12-31,5962,33434,39396
86,86571,2027-12-31,6072,33760,39832
86,86571,2028-12-31,6171,34087,40258
86,86571,2029-12-31,6279,34406,40685
86,86571,2030-12-31,6380,34816,41196
86,86571,2031-12-31,6484,35210,41694
86,86571,2032-12-31,6583,35643,42226
86,86571,2033-12-31,6679,36149,42828
86,86571,2034-12-31,6795,36745,43540
86,86571,2035-12-31,6880,37396,44276
86,86573,1985-12-31,3833,6587,10420
86,86573,1986-12-31,4007,6844,10851
86,86573,1987-12-31,4112,7153,11265
86,86573,1988-12-31,4256,7423,11679
86,86573,1989-12-31,4413,7693,12106
86,86573,1990-12-31,4572,7944,12516
86,86573,1991-12-31,4737,8203,12940
86,86573,1992-12-31,4924,8471,13395
86,86573,1993-12-31,4841,9019,13860
86,86573,1994-12-31,5198,9280,14478
86,86573,1995-12-31,5527,9562,15089
86,86573,1996-12-31,5895,9837,15732
86,86573,1997-12-31,6326,10031,16357
86,86573,1998-12-31,6841,10135,16976
86,86573,1999-12-31,7369,10186,17555
86,86573,2000-12-31,7922,10240,18162
86,86573,2001-12-31,8430,10320,18750
86,86573,2002-12-31,8851,10462,19313
86,86573,2003-12-31,9206,10648,19854
86,86573,2004-12-31,9517,10921,20438
86,86573,2005-12-31,9808,11212,21020
86,86573,2006-12-31,10056,11530,21586
86,86573,2007-12-31,10298,11848,22146
86,86573,2008-12-31,10518,12178,22696
86,86573,2009-12-31,10757,12524,23281
86,86573,2010-12-31,10984,12879,23863
86,86573,2011-12-31,11184,13223,24407
86,86573,2012-12-31,11406,13555,24961
86,86573,2013-12-31,11620,13904,25524
86,86573,2014-12-31,11815,14222,26037
86,86573,2015-12-31,12028,14574,26602
86,86573,2016-12-31,12259,14910,27169
86,86573,2017-12-31,12445,15266,27711
86,86573,2018-12-31,12755,15713,28468
86,86573,2019-12-31,13036,15965,29001
86,86573,2020-12-31,13296,16198,29494
86,86573,2021-12-31,13577,16326,29903
86,86573,2022-12-31,13863,16449,30312
86,86573,2023-12-31,14150,16571,30721
86,86573,2024-12-31,14425,16716,31141
86,86573,2025-12-31,14694,16829,31523
86,86573,2026-12-31,14953,17007,31960
86,86573,2027-12-31,15216,17142,32358
86,86573,2028-12-31,15485,17316,32801
86,86573,2029-12-31,15727,17519,33246
86,86573,2030-12-31,15971,17698,33669
86,86573,2031-12-31,16231,17926,34157
86,86573,2032-12-31,16474,18143,34617
86,86573,2033-12-31,16718,18394,35112
86,86573,2034-12-31,16947,18728,35675
86,86573,2035-12-31,17183,19082,36265
86,86749,1985-12-31,4412,2111,6523
86,86749,1986-12-31,4429,2221,6650
86,86749,1987-12-31,4441,2285,6726
86,86749,1988-12-31,4482,2381,6863
86,86749,1989-12-31,4536,2465,7001
86,86749,1990-12-31,4605,2540,7145
86,86749,1991-12-31,4670,2637,7307
86,86749,1992-12-31,4769,2703,7472
86,86749,1993-12-31,4624,2863,7487
86,86749,1994-12-31,4887,2934,7821
86,86749,1995-12-31,5129,3007,8136
86,86749,1996-12-31,5404,3111,8515
86,86749,1997-12-31,5737,3169,8906
86,86749,1998-12-31,6128,3206,9334
86,86749,1999-12-31,6511,3212,9723
86,86749,2000-12-31,6956,3233,10189
86,86749,2001-12-31,7345,3242,10587
86,86749,2002-12-31,7644,3264,10908
86,86749,2003-12-31,7885,3331,11216
86,86749,2004-12-31,8091,3415,11506
86,86749,2005-12-31,8276,3506,11782
86,86749,2006-12-31,8430,3595,12025
86,86749,2007-12-31,8590,3699,12289
86,86749,2008-12-31,8727,3794,12521
86,86749,2009-12-31,8868,3894,12762
86,86749,2010-12-31,9005,4010,13015
86,86749,2011-12-31,9131,4124,13255
86,86749,2012-12-31,9264,4240,13504
86,86749,2013-12-31,9387,4319,13706
86,86749,2014-12-31,9505,4445,13950
86,86749,2015-12-31,9691,4555,14246
86,86749,2016-12-31,9724,4660,14384
86,86749,2017-12-31,9858,4784,14642
86,86749,2018-12-31,10059,4881,14940
86,86749,2019-12-31,10079,5138,15217
86,86749,2020-12-31,10150,5323,15473
86,86749,2021-12-31,10322,5365,15687
86,86749,2022-12-31,10497,5405,15902
86,86749,2023-12-31,10670,5446,16116
86,86749,2024-12-31,10857,5483,16340
86,86749,2025-12-31,11052,5528,16580
86,86749,2026-12-31,11253,5555,16808
86,86749,2027-12-31,11443,5623,17066
86,86749,2028-12-31,11637,5660,17297
86,86749,2029-12-31,11827,5688,17515
86,86749,2030-12-31,12012,5754,17766
86,86749,2031-12-31,12193,5799,17992
86,86749,2032-12-31,12389,5853,18242
86,86749,2033-12-31,12573,5923,18496
86,86749,2034-12-31,12759,5964,18723
86,86749,2035-12-31,12952,6033,18985
86,86755,1985-12-31,2164,1690,3854
86,86755,1986-12-31,2100,1703,3803
86,86755,1987-12-31,2116,1703,3819
86,86755,1988-12-31,2093,1706,3799
86,86755,1989-12-31,2060,1726,3786
86,86755,1990-12-31,2053,1756,3809
86,86755,1991-12-31,2061,1779,3840
86,86755,1992-12-31,2046,1782,3828
86,86755,1993-12-31,1976,1846,3822
86,86755,1994-12-31,2049,1910,3959
86,86755,1995-12-31,2128,1914,4042
86,86755,1996-12-31,2181,1922,4103
86,86755,1997-12-31,2297,1919,4216
86,86755,1998-12-31,2425,1893,4318
86,86755,1999-12-31,2578,1845,4423
86,86755,2000-12-31,2704,1853,4557
86,86755,2001-12-31,2812,1847,4659
86,86755,2002-12-31,2929,1853,4782
86,86755,2003-12-31,2983,1842,4825
86,86755,2004-12-31,3050,1855,4905
86,86755,2005-12-31,3065,1879,4944
86,86755,2006-12-31,3115,1919,5034
86,86755,2007-12-31,3123,1942,5065
86,86755,2008-12-31,3156,1977,5133
86,86755,2009-12-31,3155,2009,5164
86,86755,2010-12-31,3246,2045,5291
86,86755,2011-12-31,3251,2049,5300
86,86755,2012-12-31,3243,2090,5333
86,86755,2013-12-31,3217,2129,5346
86,86755,2014-12-31,3218,2189,5407
86,86755,2015-12-31,3236,2219,5455
86,86755,2016-12-31,3285,2218,5503
86,86755,2017-12-31,3324,2237,5561
86,86755,2018-12-31,3385,2260,5645
86,86755,2019-12-31,3325,2260,5585
86,86755,2020-12-31,3306,2261,5567
86,86755,2021-12-31,3365,2278,5643
86,86755,2022-12-31,3424,2296,5720
86,86755,2023-12-31,3484,2313,5797
86,86755,2024-12-31,3552,2337,5889
86,86755,2025-12-31,3607,2350,5957
86,86755,2026-12-31,3675,2369,6044
86,86755,2027-12-31,3744,2377,6121
86,86755,2028-12-31,3808,2381,6189
86,86755,2029-12-31,3872,2412,6284
86,86755,2030-12-31,3933,2421,6354
86,86755,2031-12-31,3991,2438,6429
86,86755,2032-12-31,4050,2442,6492
86,86755,2033-12-31,4113,2439,6552
86,86755,2034-12-31,4176,2446,6622
86,86755,2035-12-31,4233,2423,6656
86,86757,1985-12-31,0,0,0
86,86757,1986-12-31,0,0,0
86,86757,1987-12-31,0,0,0
86,86757,1988-12-31,0,0,0
86,86757,1989-12-31,0,0,0
86,86757,1990-12-31,0,0,0
86,86757,1991-12-31,0,0,0
86,86757,1992-12-31,0,0,0
86,86757,1993-12-31,0,0,0
86,86757,1994-12-31,1991,9826,11817
86,86757,1995-12-31,2123,10004,12127
86,86757,1996-12-31,2271,10165,12436
86,86757,1997-12-31,2442,10252,12694
86,86757,1998-12-31,2631,10253,12884
86,86757,1999-12-31,2822,10222,13044
86,86757,2000-12-31,3065,10221,13286
86,86757,2001-12-31,3246,10204,13450
86,86757,2002-12-31,3394,10274,13668
86,86757,2003-12-31,3519,10383,13902
86,86757,2004-12-31,3646,10544,14190
86,86757,2005-12-31,3759,10714,14473
86,86757,2006-12-31,3863,10941,14804
86,86757,2007-12-31,3966,11158,15124
86,86757,2008-12-31,4062,11392,15454
86,86757,2009-12-31,4139,11615,15754
86,86757,2010-12-31,4228,11869,16097
86,86757,2011-12-31,4306,12116,16422
86,86757,2012-12-31,4373,12340,16713
86,86757,2013-12-31,4488,12572,17060
86,86757,2014-12-31,4612,12825,17437
86,86757,2015-12-31,4644,13056,17700
86,86757,2016-12-31,4702,13339,18041
86,86757,2017-12-31,4805,13550,18355
86,86757,2018-12-31,4912,13868,18780
86,86757,2019-12-31,5043,14076,19119
86,86757,2020-12-31,5168,14266,19434
86,86757,2021-12-31,5324,14379,19703
86,86757,2022-12-31,5486,14487,19973
86,86757,2023-12-31,5647,14595,20242
86,86757,2024-12-31,5785,14701,20486
86,86757,2025-12-31,5909,14832,20741
86,86757,2026-12-31,6029,14951,20980
86,86757,2027-12-31,6131,15081,21212
86,86757,2028-12-31,6239,15217,21456
86,86757,2029-12-31,6342,15376,21718
86,86757,2030-12-31,6448,15508,21956
86,86757,2031-12-31,6537,15673,22210
86,86757,2032-12-31,6644,15830,22474
86,86757,2033-12-31,6739,16006,22745
86,86757,2034-12-31,6840,16209,23049
86,86757,2035-12-31,6940,16457,23397
86,86760,1985-12-31,1631,1796,3427
86,86760,1986-12-31,1584,1835,3419
86,86760,1987-12-31,1639,1906,3545
86,86760,1988-12-31,1641,1961,3602
86,86760,1989-12-31,1649,2028,3677
86,86760,1990-12-31,1680,2105,3785
86,86760,1991-12-31,1680,2161,3841
86,86760,1992-12-31,1718,2221,3939
86,86760,1993-12-31,1659,2338,3997
86,86760,1994-12-31,1752,2408,4160
86,86760,1995-12-31,1832,2469,4301
86,86760,1996-12-31,1930,2537,4467
86,86760,1997-12-31,2037,2589,4626
86,86760,1998-12-31,2182,2604,4786
86,86760,1999-12-31,2362,2582,4944
86,86760,2000-12-31,2429,2593,5022
86,86760,2001-12-31,2580,2603,5183
86,86760,2002-12-31,2689,2624,5313
86,86760,2003-12-31,2787,2653,5440
86,86760,2004-12-31,2872,2707,5579
86,86760,2005-12-31,2926,2779,5705
86,86760,2006-12-31,2980,2847,5827
86,86760,2007-12-31,2990,2923,5913
86,86760,2008-12-31,3019,3009,6028
86,86760,2009-12-31,3057,3113,6170
86,86760,2010-12-31,3130,3185,6315
86,86760,2011-12-31,3159,3281,6440
86,86760,2012-12-31,3202,3352,6554
86,86760,2013-12-31,3257,3413,6670
86,86760,2014-12-31,3269,3508,6777
86,86760,2015-12-31,3298,3572,6870
86,86760,2016-12-31,3312,3677,6989
86,86760,2017-12-31,3396,3764,7160
86,86760,2018-12-31,3476,3814,7290
86,86760,2019-12-31,3452,3832,7284
86,86760,2020-12-31,3425,3883,7308
86,86760,2021-12-31,3496,3912,7408
86,86760,2022-12-31,3570,3939,7509
86,86760,2023-12-31,3645,3965,7610
86,86760,2024-12-31,3712,3982,7694
86,86760,2025-12-31,3786,4018,7804
86,86760,2026-12-31,3845,4032,7877
86,86760,2027-12-31,3919,4070,7989
86,86760,2028-12-31,3986,4098,8084
86,86760,2029-12-31,4052,4123,8175
86,86760,2030-12-31,4124,4142,8266
86,86760,2031-12-31,4185,4188,8373
86,86760,2032-12-31,4243,4220,8463
86,86760,2033-12-31,4311,4245,8556
86,86760,2034-12-31,4378,4267,8645
86,86760,2035-12-31,4425,4277,8702
86,86865,1985-12-31,2711,9371,12082
86,86865,1986-12-31,2993,12390,15383
86,86865,1987-12-31,3283,15319,18602
86,86865,1988-12-31,3522,18217,21739
86,86865,1989-12-31,3807,21072,24879
86,86865,1990-12-31,4052,23893,27945
86,86865,1991-12-31,4317,26658,30975
86,86865,1992-12-31,4605,29378,33983
86,86865,1993-12-31,4614,33195,37809
86,86865,1994-12-31,5025,21237,26262
86,86865,1995-12-31,5480,21103,26583
86,86865,1996-12-31,5907,20937,26844
86,86865,1997-12-31,6423,20640,27063
86,86865,1998-12-31,7021,20195,27216
86,86865,1999-12-31,7682,19710,27392
86,86865,2000-12-31,8332,19196,27528
86,86865,2001-12-31,8926,18805,27731
86,86865,2002-12-31,9465,18535,28000
86,86865,2003-12-31,9962,18354,28316
86,86865,2004-12-31,10375,18267,28642
86,86865,2005-12-31,10744,18195,28939
86,86865,2006-12-31,11106,18178,29284
86,86865,2007-12-31,11435,18175,29610
86,86865,2008-12-31,11783,18204,29987
86,86865,2009-12-31,12080,18227,30307
86,86865,2010-12-31,12388,18269,30657
86,86865,2011-12-31,12718,18333,31051
86,86865,2012-12-31,13010,18335,31345
86,86865,2013-12-31,13301,18365,31666
86,86865,2014-12-31,13594,18368,31962
86,86865,2015-12-31,13892,18374,32266
86,86865,2016-12-31,14256,18402,32658
86,86865,2017-12-31,14519,18472,32991
86,86865,2018-12-31,14882,18575,33457
86,86865,2019-12-31,15299,18783,34082
86,86865,2020-12-31,15705,18955,34660
86,86865,2021-12-31,16035,19105,35140
86,86865,2022-12-31,16373,19248,35621
86,86865,2023-12-31,16709,19392,36101
86,86865,2024-12-31,17033,19558,36591
86,86865,2025-12-31,17360,19666,37026
86,86865,2026-12-31,17679,19859,37538
86,86865,2027-12-31,17998,20007,38005
86,86865,2028-12-31,18312,20184,38496
86,86865,2029-12-31,18623,20352,38975
86,86865,2030-12-31,18927,20534,39461
86,86865,2031-12-31,19233,20703,39936
86,86865,2032-12-31,19537,20884,40421
86,86865,2033-12-31,19819,21045,40864
86,86865,2034-12-31,20108,21239,41347
86,86865,2035-12-31,20395,21492,41887
86,86885,1985-12-31,2679,9899,12578
86,86885,1986-12-31,2897,9848,12745
86,86885,1987-12-31,3156,9824,12980
86,86885,1988-12-31,3395,9779,13174
86,86885,1989-12-31,3611,9755,13366
86,86885,1990-12-31,3834,9717,13551
86,86885,1991-12-31,4083,9685,13768
86,86885,1992-12-31,4320,9659,13979
86,86885,1993-12-31,4343,9936,14279
86,86885,1994-12-31,4715,9966,14681
86,86885,1995-12-31,5109,9938,15047
86,86885,1996-12-31,5518,9922,15440
86,86885,1997-12-31,5999,9824,15823
86,86885,1998-12-31,6565,9684,16249
86,86885,1999-12-31,7148,9467,16615
86,86885,2000-12-31,7751,9270,17021
86,86885,2001-12-31,8313,9133,17446
86,86885,2002-12-31,8819,9032,17851
86,86885,2003-12-31,9255,8994,18249
86,86885,2004-12-31,9623,9015,18638
86,86885,2005-12-31,9980,9046,19026
86,86885,2006-12-31,10294,9076,19370
86,86885,2007-12-31,10612,9162,19774
86,86885,2008-12-31,10901,9210,20111
86,86885,2009-12-31,11198,9279,20477
86,86885,2010-12-31,11497,9363,20860
86,86885,2011-12-31,11766,9431,21197
86,86885,2012-12-31,12077,9522,21599
86,86885,2013-12-31,12323,9568,21891
86,86885,2014-12-31,12631,9633,22264
86,86885,2015-12-31,12866,9696,22562
86,86885,2016-12-31,13176,9783,22959
86,86885,2017-12-31,13398,9870,23268
86,86885,2018-12-31,13742,9958,23700
86,86885,2019-12-31,14190,9683,23873
86,86885,2020-12-31,14588,9508,24096
86,86885,2021-12-31,14844,9581,24425
86,86885,2022-12-31,15106,9653,24759
86,86885,2023-12-31,15368,9725,25093
86,86885,2024-12-31,15643,9804,25447
86,86885,2025-12-31,15926,9904,25830
86,86885,2026-12-31,16219,9969,26188
86,86885,2027-12-31,16506,10056,26562
86,86885,2028-12-31,16793,10143,26936
86,86885,2029-12-31,17066,10217,27283
86,86885,2030-12-31,17347,10339,27686
86,86885,2031-12-31,17624,10424,28048
86,86885,2032-12-31,17883,10543,28426
86,86885,2033-12-31,18160,10677,28837
86,86885,2034-12-31,18410,10826,29236
86,86885,2035-12-31,18678,11029,29707
88,88001,1985-12-31,25934,11423,37357
88,88001,1986-12-31,27248,11910,39158
88,88001,1987-12-31,28544,12351,40895
88,88001,1988-12-31,29760,12758,42518
88,88001,1989-12-31,31022,13165,44187
88,88001,1990-12-31,32187,13541,45728
88,88001,1991-12-31,33325,13907,47232
88,88001,1992-12-31,34398,14204,48602
88,88001,1993-12-31,35318,14483,49801
88,88001,1994-12-31,36228,14728,50956
88,88001,1995-12-31,37017,14900,51917
88,88001,1996-12-31,37707,15089,52796
88,88001,1997-12-31,38320,15199,53519
88,88001,1998-12-31,38871,15301,54172
88,88001,1999-12-31,39337,15397,54734
88,88001,2000-12-31,39736,15440,55176
88,88001,2001-12-31,40131,15433,55564
88,88001,2002-12-31,40385,15415,55800
88,88001,2003-12-31,40589,15393,55982
88,88001,2004-12-31,40779,15333,56112
88,88001,2005-12-31,40839,15247,56086
88,88001,2006-12-31,40867,15159,56026
88,88001,2007-12-31,40950,15060,56010
88,88001,2008-12-31,40949,14988,55937
88,88001,2009-12-31,41006,14872,55878
88,88001,2010-12-31,41017,14744,55761
88,88001,2011-12-31,41030,14633,55663
88,88001,2012-12-31,41065,14530,55595
88,88001,2013-12-31,41086,14455,55541
88,88001,2014-12-31,41187,14321,55508
88,88001,2015-12-31,41185,14222,55407
88,88001,2016-12-31,41214,14069,55283
88,88001,2017-12-31,41392,14057,55449
88,88001,2018-12-31,41400,13891,55291
88,88001,2019-12-31,41703,14655,56358
88,88001,2020-12-31,42024,15409,57433
88,88001,2021-12-31,42404,15912,58316
88,88001,2022-12-31,42776,16041,58817
88,88001,2023-12-31,43175,16034,59209
88,88001,2024-12-31,43565,15967,59532
88,88001,2025-12-31,43940,15851,59791
88,88001,2026-12-31,44282,15663,59945
88,88001,2027-12-31,44602,15432,60034
88,88001,2028-12-31,44899,15151,60050
88,88001,2029-12-31,45170,14821,59991
88,88001,2030-12-31,45396,14446,59842
88,88001,2031-12-31,45617,14056,59673
88,88001,2032-12-31,45822,13669,59491
88,88001,2033-12-31,46010,13281,59291
88,88001,2034-12-31,46195,12901,59096
88,88001,2035-12-31,46351,12539,58890
88,88564,1985-12-31,3804,144,3948
88,88564,1986-12-31,3907,196,4103
88,88564,1987-12-31,3999,296,4295
88,88564,1988-12-31,4126,409,4535
88,88564,1989-12-31,4168,499,4667
88,88564,1990-12-31,4255,597,4852
88,88564,1991-12-31,4297,696,4993
88,88564,1992-12-31,4351,823,5174
88,88564,1993-12-31,4424,913,5337
88,88564,1994-12-31,4417,1008,5425
88,88564,1995-12-31,4437,1124,5561
88,88564,1996-12-31,4439,1202,5641
88,88564,1997-12-31,4440,1304,5744
88,88564,1998-12-31,4411,1397,5808
88,88564,1999-12-31,4405,1468,5873
88,88564,2000-12-31,4408,1548,5956
88,88564,2001-12-31,4325,1658,5983
88,88564,2002-12-31,4309,1734,6043
88,88564,2003-12-31,4257,1801,6058
88,88564,2004-12-31,4188,1862,6050
88,88564,2005-12-31,4114,1920,6034
88,88564,2006-12-31,4081,1979,6060
88,88564,2007-12-31,4001,2029,6030
88,88564,2008-12-31,3975,2059,6034
88,88564,2009-12-31,3884,2113,5997
88,88564,2010-12-31,3841,2185,6026
88,88564,2011-12-31,3808,2240,6048
88,88564,2012-12-31,3759,2279,6038
88,88564,2013-12-31,3718,2284,6002
88,88564,2014-12-31,3602,2353,5955
88,88564,2015-12-31,3616,2383,5999
88,88564,2016-12-31,3610,2465,6075
88,88564,2017-12-31,3454,2406,5860
88,88564,2018-12-31,3493,2496,5989
88,88564,2019-12-31,3519,2605,6124
88,88564,2020-12-31,3546,2713,6259
88,88564,2021-12-31,3555,2801,6356
88,88564,2022-12-31,3587,2824,6411
88,88564,2023-12-31,3632,2822,6454
88,88564,2024-12-31,3669,2811,6480
88,88564,2025-12-31,3696,2782,6478
88,88564,2026-12-31,3731,2759,6490
88,88564,2027-12-31,3760,2717,6477
88,88564,2028-12-31,3781,2665,6446
88,88564,2029-12-31,3798,2606,6404
88,88564,2030-12-31,3829,2539,6368
88,88564,2031-12-31,3843,2465,6308
88,88564,2032-12-31,3859,2396,6255
88,88564,2033-12-31,3877,2335,6212
88,88564,2034-12-31,3884,2274,6158
88,88564,2035-12-31,3906,2202,6108
91,91001,1985-12-31,15938,4704,20642
91,91001,1986-12-31,16598,4892,21490
91,91001,1987-12-31,17287,5105,22392
91,91001,1988-12-31,17974,5324,23298
91,91001,1989-12-31,18627,5547,24174
91,91001,1990-12-31,19273,5755,25028
91,91001,1991-12-31,19935,5976,25911
91,91001,1992-12-31,20579,6172,26751
91,91001,1993-12-31,21202,6369,27571
91,91001,1994-12-31,21796,6547,28343
91,91001,1995-12-31,22363,6760,29123
91,91001,1996-12-31,22928,6930,29858
91,91001,1997-12-31,23460,7157,30617
91,91001,1998-12-31,23955,7421,31376
91,91001,1999-12-31,24454,7750,32204
91,91001,2000-12-31,24921,8107,33028
91,91001,2001-12-31,25330,8423,33753
91,91001,2002-12-31,25798,8770,34568
91,91001,2003-12-31,26202,9199,35401
91,91001,2004-12-31,26589,9572,36161
91,91001,2005-12-31,26952,9902,36854
91,91001,2006-12-31,27336,10261,37597
91,91001,2007-12-31,27759,10644,38403
91,91001,2008-12-31,28226,11016,39242
91,91001,2009-12-31,28708,11391,40099
91,91001,2010-12-31,29212,11797,41009
91,91001,2011-12-31,29755,12163,41918
91,91001,2012-12-31,30278,12528,42806
91,91001,2013-12-31,30778,12905,43683
91,91001,2014-12-31,31266,13291,44557
91,91001,2015-12-31,31775,13639,45414
91,91001,2016-12-31,32321,13980,46301
91,91001,2017-12-31,32867,14337,47204
91,91001,2018-12-31,33503,14641,48144
91,91001,2019-12-31,34303,14615,48918
91,91001,2020-12-31,35191,14546,49737
91,91001,2021-12-31,36152,14659,50811
91,91001,2022-12-31,37216,14787,52003
91,91001,2023-12-31,38364,14929,53293
91,91001,2024-12-31,39534,15103,54637
91,91001,2025-12-31,40738,15277,56015
91,91001,2026-12-31,41934,15456,57390
91,91001,2027-12-31,43181,15669,58850
91,91001,2028-12-31,44420,15889,60309
91,91001,2029-12-31,45653,16116,61769
91,91001,2030-12-31,46909,16388,63297
91,91001,2031-12-31,48168,16653,64821
91,91001,2032-12-31,49427,16943,66370
91,91001,2033-12-31,50693,17217,67910
91,91001,2034-12-31,51961,17492,69453
91,91001,2035-12-31,53232,17789,71021
91,91263,1985-12-31,0,1875,1875
91,91263,1986-12-31,0,2175,2175
91,91263,1987-12-31,0,2418,2418
91,91263,1988-12-31,0,2613,2613
91,91263,1989-12-31,0,2801,2801
91,91263,1990-12-31,0,2994,2994
91,91263,1991-12-31,0,3185,3185
91,91263,1992-12-31,0,3329,3329
91,91263,1993-12-31,0,3502,3502
91,91263,1994-12-31,0,3659,3659
91,91263,1995-12-31,0,3796,3796
91,91263,1996-12-31,0,3946,3946
91,91263,1997-12-31,0,4124,4124
91,91263,1998-12-31,0,3342,3342
91,91263,1999-12-31,0,3259,3259
91,91263,2000-12-31,0,3195,3195
91,91263,2001-12-31,0,3139,3139
91,91263,2002-12-31,0,3056,3056
91,91263,2003-12-31,0,3007,3007
91,91263,2004-12-31,0,2923,2923
91,91263,2005-12-31,0,2879,2879
91,91263,2006-12-31,0,2815,2815
91,91263,2007-12-31,0,2761,2761
91,91263,2008-12-31,0,2683,2683
91,91263,2009-12-31,0,2637,2637
91,91263,2010-12-31,0,2582,2582
91,91263,2011-12-31,0,2523,2523
91,91263,2012-12-31,0,2464,2464
91,91263,2013-12-31,0,2396,2396
91,91263,2014-12-31,0,2308,2308
91,91263,2015-12-31,0,2259,2259
91,91263,2016-12-31,0,2201,2201
91,91263,2017-12-31,0,2136,2136
91,91263,2018-12-31,0,2100,2100
91,91263,2019-12-31,0,2077,2077
91,91263,2020-12-31,0,2077,2077
91,91263,2021-12-31,0,2093,2093
91,91263,2022-12-31,0,2111,2111
91,91263,2023-12-31,0,2131,2131
91,91263,2024-12-31,0,2157,2157
91,91263,2025-12-31,0,2179,2179
91,91263,2026-12-31,0,2197,2197
91,91263,2027-12-31,0,2234,2234
91,91263,2028-12-31,0,2265,2265
91,91263,2029-12-31,0,2306,2306
91,91263,2030-12-31,0,2342,2342
91,91263,2031-12-31,0,2373,2373
91,91263,2032-12-31,0,2409,2409
91,91263,2033-12-31,0,2450,2450
91,91263,2034-12-31,0,2486,2486
91,91263,2035-12-31,0,2524,2524
91,91405,1985-12-31,0,2612,2612
91,91405,1986-12-31,0,2679,2679
91,91405,1987-12-31,0,2741,2741
91,91405,1988-12-31,0,2817,2817
91,91405,1989-12-31,0,2879,2879
91,91405,1990-12-31,0,2951,2951
91,91405,1991-12-31,0,3028,3028
91,91405,1992-12-31,0,3140,3140
91,91405,1993-12-31,0,3205,3205
91,91405,1994-12-31,0,3273,3273
91,91405,1995-12-31,0,3353,3353
91,91405,1996-12-31,0,3422,3422
91,91405,1997-12-31,0,3521,3521
91,91405,1998-12-31,0,2362,2362
91,91405,1999-12-31,0,2371,2371
91,91405,2000-12-31,0,2377,2377
91,91405,2001-12-31,0,2405,2405
91,91405,2002-12-31,0,2455,2455
91,91405,2003-12-31,0,2490,2490
91,91405,2004-12-31,0,2509,2509
91,91405,2005-12-31,0,2532,2532
91,91405,2006-12-31,0,2571,2571
91,91405,2007-12-31,0,2613,2613
91,91405,2008-12-31,0,2651,2651
91,91405,2009-12-31,0,2684,2684
91,91405,2010-12-31,0,2706,2706
91,91405,2011-12-31,0,2737,2737
91,91405,2012-12-31,0,2767,2767
91,91405,2013-12-31,0,2803,2803
91,91405,2014-12-31,0,2834,2834
91,91405,2015-12-31,0,2837,2837
91,91405,2016-12-31,0,2882,2882
91,91405,2017-12-31,0,2910,2910
91,91405,2018-12-31,0,2967,2967
91,91405,2019-12-31,0,2947,2947
91,91405,2020-12-31,0,2955,2955
91,91405,2021-12-31,0,2978,2978
91,91405,2022-12-31,0,3004,3004
91,91405,2023-12-31,0,3032,3032
91,91405,2024-12-31,0,3051,3051
91,91405,2025-12-31,0,3093,3093
91,91405,2026-12-31,0,3142,3142
91,91405,2027-12-31,0,3161,3161
91,91405,2028-12-31,0,3198,3198
91,91405,2029-12-31,0,3263,3263
91,91405,2030-12-31,0,3310,3310
91,91405,2031-12-31,0,3362,3362
91,91405,2032-12-31,0,3418,3418
91,91405,2033-12-31,0,3491,3491
91,91405,2034-12-31,0,3542,3542
91,91405,2035-12-31,0,3612,3612
91,91407,1985-12-31,0,1072,1072
91,91407,1986-12-31,0,1166,1166
91,91407,1987-12-31,0,1231,1231
91,91407,1988-12-31,0,1299,1299
91,91407,1989-12-31,0,1371,1371
91,91407,1990-12-31,0,1441,1441
91,91407,1991-12-31,0,1476,1476
91,91407,1992-12-31,0,1518,1518
91,91407,1993-12-31,0,1588,1588
91,91407,1994-12-31,0,1644,1644
91,91407,1995-12-31,0,1687,1687
91,91407,1996-12-31,0,1767,1767
91,91407,1997-12-31,0,1809,1809
91,91407,1998-12-31,0,1874,1874
91,91407,1999-12-31,0,1991,1991
91,91407,2000-12-31,0,2081,2081
91,91407,2001-12-31,0,2161,2161
91,91407,2002-12-31,0,2256,2256
91,91407,2003-12-31,0,2349,2349
91,91407,2004-12-31,0,2454,2454
91,91407,2005-12-31,0,2506,2506
91,91407,2006-12-31,0,2632,2632
91,91407,2007-12-31,0,2722,2722
91,91407,2008-12-31,0,2843,2843
91,91407,2009-12-31,0,2934,2934
91,91407,2010-12-31,0,3037,3037
91,91407,2011-12-31,0,3148,3148
91,91407,2012-12-31,0,3225,3225
91,91407,2013-12-31,0,3324,3324
91,91407,2014-12-31,0,3413,3413
91,91407,2015-12-31,0,3516,3516
91,91407,2016-12-31,0,3590,3590
91,91407,2017-12-31,0,3709,3709
91,91407,2018-12-31,0,3820,3820
91,91407,2019-12-31,0,3882,3882
91,91407,2020-12-31,0,3947,3947
91,91407,2021-12-31,0,3978,3978
91,91407,2022-12-31,0,4013,4013
91,91407,2023-12-31,0,4051,4051
91,91407,2024-12-31,0,4107,4107
91,91407,2025-12-31,0,4131,4131
91,91407,2026-12-31,0,4188,4188
91,91407,2027-12-31,0,4257,4257
91,91407,2028-12-31,0,4312,4312
91,91407,2029-12-31,0,4381,4381
91,91407,2030-12-31,0,4442,4442
91,91407,2031-12-31,0,4529,4529
91,91407,2032-12-31,0,4604,4604
91,91407,2033-12-31,0,4662,4662
91,91407,2034-12-31,0,4752,4752
91,91407,2035-12-31,0,4829,4829
91,91430,1985-12-31,0,0,0
91,91430,1986-12-31,0,0,0
91,91430,1987-12-31,0,0,0
91,91430,1988-12-31,0,0,0
91,91430,1989-12-31,0,0,0
91,91430,1990-12-31,0,0,0
91,91430,1991-12-31,0,0,0
91,91430,1992-12-31,0,0,0
91,91430,1993-12-31,0,0,0
91,91430,1994-12-31,0,0,0
91,91430,1995-12-31,0,0,0
91,91430,1996-12-31,0,0,0
91,91430,1997-12-31,0,851,851
91,91430,1998-12-31,0,836,836
91,91430,1999-12-31,0,817,817
91,91430,2000-12-31,0,814,814
91,91430,2001-12-31,0,797,797
91,91430,2002-12-31,0,806,806
91,91430,2003-12-31,0,771,771
91,91430,2004-12-31,0,770,770
91,91430,2005-12-31,0,772,772
91,91430,2006-12-31,0,748,748
91,91430,2007-12-31,0,748,748
91,91430,2008-12-31,0,750,750
91,91430,2009-12-31,0,730,730
91,91430,2010-12-31,0,739,739
91,91430,2011-12-31,0,712,712
91,91430,2012-12-31,0,680,680
91,91430,2013-12-31,0,673,673
91,91430,2014-12-31,0,657,657
91,91430,2015-12-31,0,647,647
91,91430,2016-12-31,0,645,645
91,91430,2017-12-31,0,641,641
91,91430,2018-12-31,0,644,644
91,91430,2019-12-31,0,652,652
91,91430,2020-12-31,0,662,662
91,91430,2021-12-31,0,667,667
91,91430,2022-12-31,0,673,673
91,91430,2023-12-31,0,679,679
91,91430,2024-12-31,0,701,701
91,91430,2025-12-31,0,705,705
91,91430,2026-12-31,0,715,715
91,91430,2027-12-31,0,720,720
91,91430,2028-12-31,0,725,725
91,91430,2029-12-31,0,735,735
91,91430,2030-12-31,0,746,746
91,91430,2031-12-31,0,758,758
91,91430,2032-12-31,0,760,760
91,91430,2033-12-31,0,779,779
91,91430,2034-12-31,0,792,792
91,91430,2035-12-31,0,804,804
91,91460,1985-12-31,0,1765,1765
91,91460,1986-12-31,0,1723,1723
91,91460,1987-12-31,0,1819,1819
91,91460,1988-12-31,0,1900,1900
91,91460,1989-12-31,0,1964,1964
91,91460,1990-12-31,0,2041,2041
91,91460,1991-12-31,0,2163,2163
91,91460,1992-12-31,0,2228,2228
91,91460,1993-12-31,0,2328,2328
91,91460,1994-12-31,0,2379,2379
91,91460,1995-12-31,0,2465,2465
91,91460,1996-12-31,0,2506,2506
91,91460,1997-12-31,0,1620,1620
91,91460,1998-12-31,0,1631,1631
91,91460,1999-12-31,0,1641,1641
91,91460,2000-12-31,0,1642,1642
91,91460,2001-12-31,0,1654,1654
91,91460,2002-12-31,0,1647,1647
91,91460,2003-12-31,0,1651,1651
91,91460,2004-12-31,0,1659,1659
91,91460,2005-12-31,0,1693,1693
91,91460,2006-12-31,0,1695,1695
91,91460,2007-12-31,0,1701,1701
91,91460,2008-12-31,0,1702,1702
91,91460,2009-12-31,0,1714,1714
91,91460,2010-12-31,0,1719,1719
91,91460,2011-12-31,0,1740,1740
91,91460,2012-12-31,0,1760,1760
91,91460,2013-12-31,0,1771,1771
91,91460,2014-12-31,0,1787,1787
91,91460,2015-12-31,0,1800,1800
91,91460,2016-12-31,0,1795,1795
91,91460,2017-12-31,0,1821,1821
91,91460,2018-12-31,0,1850,1850
91,91460,2019-12-31,0,1860,1860
91,91460,2020-12-31,0,1879,1879
91,91460,2021-12-31,0,1894,1894
91,91460,2022-12-31,0,1910,1910
91,91460,2023-12-31,0,1929,1929
91,91460,2024-12-31,0,1937,1937
91,91460,2025-12-31,0,1968,1968
91,91460,2026-12-31,0,1995,1995
91,91460,2027-12-31,0,2018,2018
91,91460,2028-12-31,0,2042,2042
91,91460,2029-12-31,0,2073,2073
91,91460,2030-12-31,0,2103,2103
91,91460,2031-12-31,0,2138,2138
91,91460,2032-12-31,0,2179,2179
91,91460,2033-12-31,0,2198,2198
91,91460,2034-12-31,0,2238,2238
91,91460,2035-12-31,0,2263,2263
91,91530,1985-12-31,0,0,0
91,91530,1986-12-31,0,0,0
91,91530,1987-12-31,0,0,0
91,91530,1988-12-31,0,0,0
91,91530,1989-12-31,0,0,0
91,91530,1990-12-31,0,0,0
91,91530,1991-12-31,0,0,0
91,91530,1992-12-31,0,0,0
91,91530,1993-12-31,0,0,0
91,91530,1994-12-31,0,0,0
91,91530,1995-12-31,0,0,0
91,91530,1996-12-31,0,0,0
91,91530,1997-12-31,0,0,0
91,91530,1998-12-31,0,960,960
91,91530,1999-12-31,0,955,955
91,91530,2000-12-31,0,923,923
91,91530,2001-12-31,0,916,916
91,91530,2002-12-31,0,915,915
91,91530,2003-12-31,0,877,877
91,91530,2004-12-31,0,877,877
91,91530,2005-12-31,0,885,885
91,91530,2006-12-31,0,870,870
91,91530,2007-12-31,0,870,870
91,91530,2008-12-31,0,853,853
91,91530,2009-12-31,0,839,839
91,91530,2010-12-31,0,839,839
91,91530,2011-12-31,0,834,834
91,91530,2012-12-31,0,824,824
91,91530,2013-12-31,0,799,799
91,91530,2014-12-31,0,769,769
91,91530,2015-12-31,0,758,758
91,91530,2016-12-31,0,748,748
91,91530,2017-12-31,0,735,735
91,91530,2018-12-31,0,748,748
91,91530,2019-12-31,0,759,759
91,91530,2020-12-31,0,771,771
91,91530,2021-12-31,0,777,777
91,91530,2022-12-31,0,784,784
91,91530,2023-12-31,0,791,791
91,91530,2024-12-31,0,792,792
91,91530,2025-12-31,0,801,801
91,91530,2026-12-31,0,811,811
91,91530,2027-12-31,0,821,821
91,91530,2028-12-31,0,839,839
91,91530,2029-12-31,0,848,848
91,91530,2030-12-31,0,862,862
91,91530,2031-12-31,0,874,874
91,91530,2032-12-31,0,886,886
91,91530,2033-12-31,0,899,899
91,91530,2034-12-31,0,920,920
91,91530,2035-12-31,0,938,938
91,91536,1985-12-31,0,0,0
91,91536,1986-12-31,0,0,0
91,91536,1987-12-31,0,0,0
91,91536,1988-12-31,0,0,0
91,91536,1989-12-31,0,0,0
91,91536,1990-12-31,0,0,0
91,91536,1991-12-31,0,0,0
91,91536,1992-12-31,0,0,0
91,91536,1993-12-31,0,0,0
91,91536,1994-12-31,0,0,0
91,91536,1995-12-31,0,0,0
91,91536,1996-12-31,0,0,0
91,91536,1997-12-31,0,0,0
91,91536,1998-12-31,0,1078,1078
91,91536,1999-12-31,0,1089,1089
91,91536,2000-12-31,0,1079,1079
91,91536,2001-12-31,0,1067,1067
91,91536,2002-12-31,0,1076,1076
91,91536,2003-12-31,0,1050,1050
91,91536,2004-12-31,0,1047,1047
91,91536,2005-12-31,0,1065,1065
91,91536,2006-12-31,0,1060,1060
91,91536,2007-12-31,0,1051,1051
91,91536,2008-12-31,0,1052,1052
91,91536,2009-12-31,0,1043,1043
91,91536,2010-12-31,0,1042,1042
91,91536,2011-12-31,0,1048,1048
91,91536,2012-12-31,0,1035,1035
91,91536,2013-12-31,0,1023,1023
91,91536,2014-12-31,0,1007,1007
91,91536,2015-12-31,0,1002,1002
91,91536,2016-12-31,0,1003,1003
91,91536,2017-12-31,0,1004,1004
91,91536,2018-12-31,0,1013,1013
91,91536,2019-12-31,0,1027,1027
91,91536,2020-12-31,0,1042,1042
91,91536,2021-12-31,0,1050,1050
91,91536,2022-12-31,0,1059,1059
91,91536,2023-12-31,0,1070,1070
91,91536,2024-12-31,0,1076,1076
91,91536,2025-12-31,0,1089,1089
91,91536,2026-12-31,0,1099,1099
91,91536,2027-12-31,0,1112,1112
91,91536,2028-12-31,0,1140,1140
91,91536,2029-12-31,0,1143,1143
91,91536,2030-12-31,0,1159,1159
91,91536,2031-12-31,0,1178,1178
91,91536,2032-12-31,0,1194,1194
91,91536,2033-12-31,0,1230,1230
91,91536,2034-12-31,0,1242,1242
91,91536,2035-12-31,0,1259,1259
91,91540,1985-12-31,459,1727,2186
91,91540,1986-12-31,603,1795,2398
91,91540,1987-12-31,708,1898,2606
91,91540,1988-12-31,804,2012,2816
91,91540,1989-12-31,918,2128,3046
91,91540,1990-12-31,1021,2237,3258
91,91540,1991-12-31,1112,2324,3436
91,91540,1992-12-31,1217,2442,3659
91,91540,1993-12-31,1315,2534,3849
91,91540,1994-12-31,1414,2617,4031
91,91540,1995-12-31,1525,2708,4233
91,91540,1996-12-31,1609,2792,4401
91,91540,1997-12-31,1715,2905,4620
91,91540,1998-12-31,1816,3034,4850
91,91540,1999-12-31,1910,3174,5084
91,91540,2000-12-31,1999,3312,5311
91,91540,2001-12-31,2115,3506,5621
91,91540,2002-12-31,2152,3665,5817
91,91540,2003-12-31,2231,3828,6059
91,91540,2004-12-31,2309,3971,6280
91,91540,2005-12-31,2389,4138,6527
91,91540,2006-12-31,2469,4306,6775
91,91540,2007-12-31,2559,4465,7024
91,91540,2008-12-31,2615,4621,7236
91,91540,2009-12-31,2706,4787,7493
91,91540,2010-12-31,2815,4946,7761
91,91540,2011-12-31,2900,5114,8014
91,91540,2012-12-31,2990,5305,8295
91,91540,2013-12-31,3088,5465,8553
91,91540,2014-12-31,3198,5640,8838
91,91540,2015-12-31,3298,5791,9089
91,91540,2016-12-31,3383,5930,9313
91,91540,2017-12-31,3463,6060,9523
91,91540,2018-12-31,3544,6200,9744
91,91540,2019-12-31,3665,6332,9997
91,91540,2020-12-31,3786,6453,10239
91,91540,2021-12-31,3956,6504,10460
91,91540,2022-12-31,4144,6561,10705
91,91540,2023-12-31,4347,6624,10971
91,91540,2024-12-31,4547,6689,11236
91,91540,2025-12-31,4721,6779,11500
91,91540,2026-12-31,4914,6848,11762
91,91540,2027-12-31,5063,6938,12001
91,91540,2028-12-31,5219,7038,12257
91,91540,2029-12-31,5380,7145,12525
91,91540,2030-12-31,5526,7264,12790
91,91540,2031-12-31,5677,7387,13064
91,91540,2032-12-31,5831,7512,13343
91,91540,2033-12-31,5980,7651,13631
91,91540,2034-12-31,6129,7787,13916
91,91540,2035-12-31,6279,7910,14189
91,91669,1985-12-31,0,1012,1012
91,91669,1986-12-31,0,1070,1070
91,91669,1987-12-31,0,1030,1030
91,91669,1988-12-31,0,1008,1008
91,91669,1989-12-31,0,1009,1009
91,91669,1990-12-31,0,988,988
91,91669,1991-12-31,0,968,968
91,91669,1992-12-31,0,978,978
91,91669,1993-12-31,0,971,971
91,91669,1994-12-31,0,1003,1003
91,91669,1995-12-31,0,980,980
91,91669,1996-12-31,0,993,993
91,91669,1997-12-31,0,988,988
91,91669,1998-12-31,0,1018,1018
91,91669,1999-12-31,0,1053,1053
91,91669,2000-12-31,0,1112,1112
91,91669,2001-12-31,0,1139,1139
91,91669,2002-12-31,0,1166,1166
91,91669,2003-12-31,0,1181,1181
91,91669,2004-12-31,0,1227,1227
91,91669,2005-12-31,0,1250,1250
91,91669,2006-12-31,0,1319,1319
91,91669,2007-12-31,0,1342,1342
91,91669,2008-12-31,0,1381,1381
91,91669,2009-12-31,0,1428,1428
91,91669,2010-12-31,0,1453,1453
91,91669,2011-12-31,0,1494,1494
91,91669,2012-12-31,0,1534,1534
91,91669,2013-12-31,0,1567,1567
91,91669,2014-12-31,0,1589,1589
91,91669,2015-12-31,0,1628,1628
91,91669,2016-12-31,0,1669,1669
91,91669,2017-12-31,0,1700,1700
91,91669,2018-12-31,0,1758,1758
91,91669,2019-12-31,0,1765,1765
91,91669,2020-12-31,0,1772,1772
91,91669,2021-12-31,0,1786,1786
91,91669,2022-12-31,0,1801,1801
91,91669,2023-12-31,0,1818,1818
91,91669,2024-12-31,0,1831,1831
91,91669,2025-12-31,0,1849,1849
91,91669,2026-12-31,0,1873,1873
91,91669,2027-12-31,0,1898,1898
91,91669,2028-12-31,0,1928,1928
91,91669,2029-12-31,0,1960,1960
91,91669,2030-12-31,0,1993,1993
91,91669,2031-12-31,0,2022,2022
91,91669,2032-12-31,0,2055,2055
91,91669,2033-12-31,0,2070,2070
91,91669,2034-12-31,0,2104,2104
91,91669,2035-12-31,0,2135,2135
91,91798,1985-12-31,0,1385,1385
91,91798,1986-12-31,0,1455,1455
91,91798,1987-12-31,0,1485,1485
91,91798,1988-12-31,0,1524,1524
91,91798,1989-12-31,0,1563,1563
91,91798,1990-12-31,0,1606,1606
91,91798,1991-12-31,0,1630,1630
91,91798,1992-12-31,0,1673,1673
91,91798,1993-12-31,0,1714,1714
91,91798,1994-12-31,0,1778,1778
91,91798,1995-12-31,0,1818,1818
91,91798,1996-12-31,0,1873,1873
91,91798,1997-12-31,0,1902,1902
91,91798,1998-12-31,0,1970,1970
91,91798,1999-12-31,0,2054,2054
91,91798,2000-12-31,0,2163,2163
91,91798,2001-12-31,0,2259,2259
91,91798,2002-12-31,0,2320,2320
91,91798,2003-12-31,0,2408,2408
91,91798,2004-12-31,0,2507,2507
91,91798,2005-12-31,0,2617,2617
91,91798,2006-12-31,0,2702,2702
91,91798,2007-12-31,0,2793,2793
91,91798,2008-12-31,0,2898,2898
91,91798,2009-12-31,0,3015,3015
91,91798,2010-12-31,0,3104,3104
91,91798,2011-12-31,0,3193,3193
91,91798,2012-12-31,0,3291,3291
91,91798,2013-12-31,0,3361,3361
91,91798,2014-12-31,0,3456,3456
91,91798,2015-12-31,0,3535,3535
91,91798,2016-12-31,0,3643,3643
91,91798,2017-12-31,0,3721,3721
91,91798,2018-12-31,0,3801,3801
91,91798,2019-12-31,0,3869,3869
91,91798,2020-12-31,0,3939,3939
91,91798,2021-12-31,0,3970,3970
91,91798,2022-12-31,0,4005,4005
91,91798,2023-12-31,0,4043,4043
91,91798,2024-12-31,0,4081,4081
91,91798,2025-12-31,0,4122,4122
91,91798,2026-12-31,0,4182,4182
91,91798,2027-12-31,0,4237,4237
91,91798,2028-12-31,0,4295,4295
91,91798,2029-12-31,0,4356,4356
91,91798,2030-12-31,0,4428,4428
91,91798,2031-12-31,0,4511,4511
91,91798,2032-12-31,0,4585,4585
91,91798,2033-12-31,0,4671,4671
91,91798,2034-12-31,0,4744,4744
91,91798,2035-12-31,0,4829,4829
94,94001,1985-12-31,4887,4893,9780
94,94001,1986-12-31,5062,4717,9779
94,94001,1987-12-31,5255,4822,10077
94,94001,1988-12-31,5457,4928,10385
94,94001,1989-12-31,5655,5053,10708
94,94001,1990-12-31,5890,5145,11035
94,94001,1991-12-31,6153,5347,11500
94,94001,1992-12-31,6258,5469,11727
94,94001,1993-12-31,6626,5554,12180
94,94001,1994-12-31,7066,5598,12664
94,94001,1995-12-31,7547,5667,13214
94,94001,1996-12-31,8082,5695,13777
94,94001,1997-12-31,8635,5829,14464
94,94001,1998-12-31,9195,5970,15165
94,94001,1999-12-31,9759,6047,15806
94,94001,2000-12-31,10294,6189,16483
94,94001,2001-12-31,10842,6394,17236
94,94001,2002-12-31,11367,6618,17985
94,94001,2003-12-31,11880,6848,18728
94,94001,2004-12-31,12388,7052,19440
94,94001,2005-12-31,12884,7308,20192
94,94001,2006-12-31,13392,7539,20931
94,94001,2007-12-31,13906,7802,21708
94,94001,2008-12-31,14434,8062,22496
94,94001,2009-12-31,14972,8336,23308
94,94001,2010-12-31,15495,8635,24130
94,94001,2011-12-31,16035,8925,24960
94,94001,2012-12-31,16578,9205,25783
94,94001,2013-12-31,17126,9507,26633
94,94001,2014-12-31,17673,9821,27494
94,94001,2015-12-31,18237,10127,28364
94,94001,2016-12-31,18843,10444,29287
94,94001,2017-12-31,19486,10803,30289
94,94001,2018-12-31,20279,11235,31514
94,94001,2019-12-31,21334,11339,32673
94,94001,2020-12-31,22251,11432,33683
94,94001,2021-12-31,22905,11496,34401
94,94001,2022-12-31,23434,11529,34963
94,94001,2023-12-31,23948,11551,35499
94,94001,2024-12-31,24443,11615,36058
94,94001,2025-12-31,24918,11669,36587
94,94001,2026-12-31,25376,11758,37134
94,94001,2027-12-31,25816,11858,37674
94,94001,2028-12-31,26240,11981,38221
94,94001,2029-12-31,26647,12138,38785
94,94001,2030-12-31,27036,12317,39353
94,94001,2031-12-31,27414,12518,39932
94,94001,2032-12-31,27780,12698,40478
94,94001,2033-12-31,28137,12867,41004
94,94001,2034-12-31,28484,13051,41535
94,94001,2035-12-31,28824,13223,42047
94,94343,1985-12-31,0,2151,2151
94,94343,1986-12-31,0,2294,2294
94,94343,1987-12-31,0,2538,2538
94,94343,1988-12-31,0,2732,2732
94,94343,1989-12-31,0,2930,2930
94,94343,1990-12-31,0,3104,3104
94,94343,1991-12-31,0,1402,1402
94,94343,1992-12-31,0,1666,1666
94,94343,1993-12-31,0,1919,1919
94,94343,1994-12-31,0,2171,2171
94,94343,1995-12-31,0,2339,2339
94,94343,1996-12-31,0,2561,2561
94,94343,1997-12-31,0,2737,2737
94,94343,1998-12-31,0,2913,2913
94,94343,1999-12-31,0,3105,3105
94,94343,2000-12-31,0,3251,3251
94,94343,2001-12-31,0,3506,3506
94,94343,2002-12-31,0,3721,3721
94,94343,2003-12-31,0,3929,3929
94,94343,2004-12-31,0,4148,4148
94,94343,2005-12-31,0,4435,4435
94,94343,2006-12-31,0,4647,4647
94,94343,2007-12-31,0,4918,4918
94,94343,2008-12-31,0,5159,5159
94,94343,2009-12-31,0,5438,5438
94,94343,2010-12-31,0,5721,5721
94,94343,2011-12-31,0,5990,5990
94,94343,2012-12-31,0,6261,6261
94,94343,2013-12-31,0,6542,6542
94,94343,2014-12-31,0,6806,6806
94,94343,2015-12-31,0,7082,7082
94,94343,2016-12-31,0,7385,7385
94,94343,2017-12-31,0,7708,7708
94,94343,2018-12-31,0,8088,8088
94,94343,2019-12-31,0,8042,8042
94,94343,2020-12-31,1000,8054,9054
94,94343,2021-12-31,1006,8098,9104
94,94343,2022-12-31,1002,8129,9131
94,94343,2023-12-31,1010,8137,9147
94,94343,2024-12-31,1030,8141,9171
94,94343,2025-12-31,1046,8179,9225
94,94343,2026-12-31,1060,8219,9279
94,94343,2027-12-31,1091,8279,9370
94,94343,2028-12-31,1127,8369,9496
94,94343,2029-12-31,1141,8466,9607
94,94343,2030-12-31,1164,8588,9752
94,94343,2031-12-31,1192,8705,9897
94,94343,2032-12-31,1215,8842,10057
94,94343,2033-12-31,1246,8978,10224
94,94343,2034-12-31,1272,9098,10370
94,94343,2035-12-31,1297,9214,10511
94,94663,1985-12-31,0,0,0
94,94663,1986-12-31,0,0,0
94,94663,1987-12-31,0,0,0
94,94663,1988-12-31,0,0,0
94,94663,1989-12-31,0,0,0
94,94663,1990-12-31,0,0,0
94,94663,1991-12-31,0,1632,1632
94,94663,1992-12-31,0,1598,1598
94,94663,1993-12-31,0,1502,1502
94,94663,1994-12-31,0,1415,1415
94,94663,1995-12-31,0,1353,1353
94,94663,1996-12-31,0,1300,1300
94,94663,1997-12-31,0,1205,1205
94,94663,1998-12-31,0,1188,1188
94,94663,1999-12-31,0,1145,1145
94,94663,2000-12-31,0,1114,1114
94,94663,2001-12-31,0,1093,1093
94,94663,2002-12-31,0,1085,1085
94,94663,2003-12-31,0,1081,1081
94,94663,2004-12-31,0,1074,1074
94,94663,2005-12-31,0,1063,1063
94,94663,2006-12-31,0,1074,1074
94,94663,2007-12-31,0,1073,1073
94,94663,2008-12-31,0,1055,1055
94,94663,2009-12-31,0,1034,1034
94,94663,2010-12-31,0,1055,1055
94,94663,2011-12-31,0,1047,1047
94,94663,2012-12-31,0,1042,1042
94,94663,2013-12-31,0,1030,1030
94,94663,2014-12-31,0,1018,1018
94,94663,2015-12-31,0,1038,1038
94,94663,2016-12-31,0,1051,1051
94,94663,2017-12-31,0,1032,1032
94,94663,2018-12-31,0,1022,1022
94,94663,2019-12-31,0,1048,1048
94,94663,2020-12-31,0,0,0
94,94663,2021-12-31,0,0,0
94,94663,2022-12-31,0,0,0
94,94663,2023-12-31,0,0,0
94,94663,2024-12-31,0,0,0
94,94663,2025-12-31,0,0,0
94,94663,2026-12-31,0,0,0
94,94663,2027-12-31,0,0,0
94,94663,2028-12-31,0,0,0
94,94663,2029-12-31,0,0,0
94,94663,2030-12-31,0,0,0
94,94663,2031-12-31,0,0,0
94,94663,2032-12-31,0,0,0
94,94663,2033-12-31,0,0,0
94,94663,2034-12-31,0,0,0
94,94663,2035-12-31,0,0,0
94,94883,1985-12-31,0,526,526
94,94883,1986-12-31,0,631,631
94,94883,1987-12-31,0,656,656
94,94883,1988-12-31,0,652,652
94,94883,1989-12-31,0,656,656
94,94883,1990-12-31,0,690,690
94,94883,1991-12-31,0,771,771
94,94883,1992-12-31,0,784,784
94,94883,1993-12-31,0,795,795
94,94883,1994-12-31,0,778,778
94,94883,1995-12-31,0,797,797
94,94883,1996-12-31,0,792,792
94,94883,1997-12-31,0,812,812
94,94883,1998-12-31,0,817,817
94,94883,1999-12-31,0,835,835
94,94883,2000-12-31,0,911,911
94,94883,2001-12-31,0,931,931
94,94883,2002-12-31,0,959,959
94,94883,2003-12-31,0,993,993
94,94883,2004-12-31,0,1023,1023
94,94883,2005-12-31,0,1078,1078
94,94883,2006-12-31,0,1120,1120
94,94883,2007-12-31,0,1129,1129
94,94883,2008-12-31,0,1169,1169
94,94883,2009-12-31,0,1219,1219
94,94883,2010-12-31,0,1252,1252
94,94883,2011-12-31,0,1292,1292
94,94883,2012-12-31,0,1335,1335
94,94883,2013-12-31,0,1392,1392
94,94883,2014-12-31,0,1443,1443
94,94883,2015-12-31,0,1481,1481
94,94883,2016-12-31,0,1538,1538
94,94883,2017-12-31,0,1602,1602
94,94883,2018-12-31,0,1667,1667
94,94883,2019-12-31,0,1706,1706
94,94883,2020-12-31,0,1743,1743
94,94883,2021-12-31,0,1753,1753
94,94883,2022-12-31,0,1758,1758
94,94883,2023-12-31,0,1761,1761
94,94883,2024-12-31,0,1772,1772
94,94883,2025-12-31,0,1780,1780
94,94883,2026-12-31,0,1787,1787
94,94883,2027-12-31,0,1808,1808
94,94883,2028-12-31,0,1804,1804
94,94883,2029-12-31,0,1844,1844
94,94883,2030-12-31,0,1873,1873
94,94883,2031-12-31,0,1917,1917
94,94883,2032-12-31,0,1937,1937
94,94883,2033-12-31,0,1962,1962
94,94883,2034-12-31,0,1993,1993
94,94883,2035-12-31,0,2017,2017
94,94884,1985-12-31,0,1180,1180
94,94884,1986-12-31,0,1200,1200
94,94884,1987-12-31,0,1170,1170
94,94884,1988-12-31,0,1130,1130
94,94884,1989-12-31,0,1128,1128
94,94884,1990-12-31,0,1123,1123
94,94884,1991-12-31,0,1143,1143
94,94884,1992-12-31,0,1152,1152
94,94884,1993-12-31,0,1136,1136
94,94884,1994-12-31,0,1122,1122
94,94884,1995-12-31,0,1116,1116
94,94884,1996-12-31,0,1117,1117
94,94884,1997-12-31,0,1144,1144
94,94884,1998-12-31,0,1129,1129
94,94884,1999-12-31,0,1155,1155
94,94884,2000-12-31,0,1165,1165
94,94884,2001-12-31,0,1164,1164
94,94884,2002-12-31,0,1191,1191
94,94884,2003-12-31,0,1226,1226
94,94884,2004-12-31,0,1255,1255
94,94884,2005-12-31,0,1282,1282
94,94884,2006-12-31,0,1311,1311
94,94884,2007-12-31,0,1354,1354
94,94884,2008-12-31,0,1396,1396
94,94884,2009-12-31,0,1444,1444
94,94884,2010-12-31,0,1491,1491
94,94884,2011-12-31,0,1512,1512
94,94884,2012-12-31,0,1552,1552
94,94884,2013-12-31,0,1598,1598
94,94884,2014-12-31,0,1647,1647
94,94884,2015-12-31,0,1696,1696
94,94884,2016-12-31,0,1745,1745
94,94884,2017-12-31,0,1789,1789
94,94884,2018-12-31,0,1874,1874
94,94884,2019-12-31,0,1934,1934
94,94884,2020-12-31,0,1984,1984
94,94884,2021-12-31,0,1995,1995
94,94884,2022-12-31,0,2001,2001
94,94884,2023-12-31,0,2005,2005
94,94884,2024-12-31,0,2006,2006
94,94884,2025-12-31,0,2015,2015
94,94884,2026-12-31,0,2033,2033
94,94884,2027-12-31,0,2039,2039
94,94884,2028-12-31,0,2056,2056
94,94884,2029-12-31,0,2083,2083
94,94884,2030-12-31,0,2121,2121
94,94884,2031-12-31,0,2143,2143
94,94884,2032-12-31,0,2167,2167
94,94884,2033-12-31,0,2223,2223
94,94884,2034-12-31,0,2246,2246
94,94884,2035-12-31,0,2265,2265
94,94885,1985-12-31,0,48,48
94,94885,1986-12-31,0,170,170
94,94885,1987-12-31,0,148,148
94,94885,1988-12-31,0,139,139
94,94885,1989-12-31,0,128,128
94,94885,1990-12-31,0,118,118
94,94885,1991-12-31,0,108,108
94,94885,1992-12-31,0,161,161
94,94885,1993-12-31,0,123,123
94,94885,1994-12-31,0,139,139
94,94885,1995-12-31,0,146,146
94,94885,1996-12-31,0,153,153
94,94885,1997-12-31,0,176,176
94,94885,1998-12-31,0,171,171
94,94885,1999-12-31,0,175,175
94,94885,2000-12-31,0,194,194
94,94885,2001-12-31,0,199,199
94,94885,2002-12-31,0,205,205
94,94885,2003-12-31,0,209,209
94,94885,2004-12-31,0,211,211
94,94885,2005-12-31,0,209,209
94,94885,2006-12-31,0,210,210
94,94885,2007-12-31,0,213,213
94,94885,2008-12-31,0,241,241
94,94885,2009-12-31,0,241,241
94,94885,2010-12-31,0,242,242
94,94885,2011-12-31,0,240,240
94,94885,2012-12-31,0,254,254
94,94885,2013-12-31,0,254,254
94,94885,2014-12-31,0,257,257
94,94885,2015-12-31,0,264,264
94,94885,2016-12-31,0,262,262
94,94885,2017-12-31,0,265,265
94,94885,2018-12-31,0,279,279
94,94885,2019-12-31,0,288,288
94,94885,2020-12-31,0,296,296
94,94885,2021-12-31,0,298,298
94,94885,2022-12-31,0,299,299
94,94885,2023-12-31,0,299,299
94,94885,2024-12-31,0,286,286
94,94885,2025-12-31,0,286,286
94,94885,2026-12-31,0,289,289
94,94885,2027-12-31,0,291,291
94,94885,2028-12-31,0,296,296
94,94885,2029-12-31,0,297,297
94,94885,2030-12-31,0,301,301
94,94885,2031-12-31,0,302,302
94,94885,2032-12-31,0,313,313
94,94885,2033-12-31,0,324,324
94,94885,2034-12-31,0,326,326
94,94885,2035-12-31,0,335,335
94,94886,1985-12-31,0,708,708
94,94886,1986-12-31,0,635,635
94,94886,1987-12-31,0,621,621
94,94886,1988-12-31,0,706,706
94,94886,1989-12-31,0,671,671
94,94886,1990-12-31,0,641,641
94,94886,1991-12-31,0,633,633
94,94886,1992-12-31,0,631,631
94,94886,1993-12-31,0,602,602
94,94886,1994-12-31,0,573,573
94,94886,1995-12-31,0,572,572
94,94886,1996-12-31,0,583,583
94,94886,1997-12-31,0,554,554
94,94886,1998-12-31,0,551,551
94,94886,1999-12-31,0,586,586
94,94886,2000-12-31,0,607,607
94,94886,2001-12-31,0,550,550
94,94886,2002-12-31,0,596,596
94,94886,2003-12-31,0,583,583
94,94886,2004-12-31,0,660,660
94,94886,2005-12-31,0,613,613
94,94886,2006-12-31,0,634,634
94,94886,2007-12-31,0,662,662
94,94886,2008-12-31,0,706,706
94,94886,2009-12-31,0,714,714
94,94886,2010-12-31,0,699,699
94,94886,2011-12-31,0,736,736
94,94886,2012-12-31,0,763,763
94,94886,2013-12-31,0,769,769
94,94886,2014-12-31,0,776,776
94,94886,2015-12-31,0,787,787
94,94886,2016-12-31,0,814,814
94,94886,2017-12-31,0,837,837
94,94886,2018-12-31,0,863,863
94,94886,2019-12-31,0,886,886
94,94886,2020-12-31,0,903,903
94,94886,2021-12-31,0,908,908
94,94886,2022-12-31,0,911,911
94,94886,2023-12-31,0,912,912
94,94886,2024-12-31,0,915,915
94,94886,2025-12-31,0,916,916
94,94886,2026-12-31,0,926,926
94,94886,2027-12-31,0,942,942
94,94886,2028-12-31,0,946,946
94,94886,2029-12-31,0,956,956
94,94886,2030-12-31,0,966,966
94,94886,2031-12-31,0,985,985
94,94886,2032-12-31,0,1009,1009
94,94886,2033-12-31,0,1003,1003
94,94886,2034-12-31,0,1027,1027
94,94886,2035-12-31,0,1058,1058
94,94887,1985-12-31,0,814,814
94,94887,1986-12-31,0,837,837
94,94887,1987-12-31,0,868,868
94,94887,1988-12-31,0,886,886
94,94887,1989-12-31,0,892,892
94,94887,1990-12-31,0,902,902
94,94887,1991-12-31,0,918,918
94,94887,1992-12-31,0,933,933
94,94887,1993-12-31,0,965,965
94,94887,1994-12-31,0,953,953
94,94887,1995-12-31,0,980,980
94,94887,1996-12-31,0,989,989
94,94887,1997-12-31,0,1009,1009
94,94887,1998-12-31,0,1029,1029
94,94887,1999-12-31,0,1057,1057
94,94887,2000-12-31,0,1090,1090
94,94887,2001-12-31,0,1139,1139
94,94887,2002-12-31,0,1114,1114
94,94887,2003-12-31,0,1174,1174
94,94887,2004-12-31,0,1200,1200
94,94887,2005-12-31,0,1243,1243
94,94887,2006-12-31,0,1327,1327
94,94887,2007-12-31,0,1354,1354
94,94887,2008-12-31,0,1396,1396
94,94887,2009-12-31,0,1435,1435
94,94887,2010-12-31,0,1485,1485
94,94887,2011-12-31,0,1546,1546
94,94887,2012-12-31,0,1589,1589
94,94887,2013-12-31,0,1624,1624
94,94887,2014-12-31,0,1669,1669
94,94887,2015-12-31,0,1724,1724
94,94887,2016-12-31,0,1778,1778
94,94887,2017-12-31,0,1844,1844
94,94887,2018-12-31,0,1899,1899
94,94887,2019-12-31,0,1959,1959
94,94887,2020-12-31,0,2011,2011
94,94887,2021-12-31,0,2023,2023
94,94887,2022-12-31,0,2028,2028
94,94887,2023-12-31,0,2032,2032
94,94887,2024-12-31,0,2036,2036
94,94887,2025-12-31,0,2048,2048
94,94887,2026-12-31,0,2062,2062
94,94887,2027-12-31,0,2077,2077
94,94887,2028-12-31,0,2111,2111
94,94887,2029-12-31,0,2143,2143
94,94887,2030-12-31,0,2171,2171
94,94887,2031-12-31,0,2199,2199
94,94887,2032-12-31,0,2230,2230
94,94887,2033-12-31,0,2260,2260
94,94887,2034-12-31,0,2277,2277
94,94887,2035-12-31,0,2297,2297
94,94888,1985-12-31,0,290,290
94,94888,1986-12-31,0,457,457
94,94888,1987-12-31,0,453,453
94,94888,1988-12-31,0,428,428
94,94888,1989-12-31,0,450,450
94,94888,1990-12-31,0,443,443
94,94888,1991-12-31,0,453,453
94,94888,1992-12-31,0,441,441
94,94888,1993-12-31,0,442,442
94,94888,1994-12-31,0,484,484
94,94888,1995-12-31,0,472,472
94,94888,1996-12-31,0,470,470
94,94888,1997-12-31,0,458,458
94,94888,1998-12-31,0,472,472
94,94888,1999-12-31,0,495,495
94,94888,2000-12-31,0,520,520
94,94888,2001-12-31,0,547,547
94,94888,2002-12-31,0,570,570
94,94888,2003-12-31,0,586,586
94,94888,2004-12-31,0,602,602
94,94888,2005-12-31,0,616,616
94,94888,2006-12-31,0,627,627
94,94888,2007-12-31,0,662,662
94,94888,2008-12-31,0,676,676
94,94888,2009-12-31,0,701,701
94,94888,2010-12-31,0,718,718
94,94888,2011-12-31,0,749,749
94,94888,2012-12-31,0,775,775
94,94888,2013-12-31,0,796,796
94,94888,2014-12-31,0,836,836
94,94888,2015-12-31,0,855,855
94,94888,2016-12-31,0,862,862
94,94888,2017-12-31,0,884,884
94,94888,2018-12-31,0,908,908
94,94888,2019-12-31,0,937,937
94,94888,2020-12-31,0,962,962
94,94888,2021-12-31,0,968,968
94,94888,2022-12-31,0,970,970
94,94888,2023-12-31,0,972,972
94,94888,2024-12-31,0,974,974
94,94888,2025-12-31,0,982,982
94,94888,2026-12-31,0,988,988
94,94888,2027-12-31,0,994,994
94,94888,2028-12-31,0,1006,1006
94,94888,2029-12-31,0,1008,1008
94,94888,2030-12-31,0,1026,1026
94,94888,2031-12-31,0,1051,1051
94,94888,2032-12-31,0,1075,1075
94,94888,2033-12-31,0,1083,1083
94,94888,2034-12-31,0,1099,1099
94,94888,2035-12-31,0,1116,1116
95,95001,1985-12-31,9122,16462,25584
95,95001,1986-12-31,10362,17911,28273
95,95001,1987-12-31,11554,19106,30660
95,95001,1988-12-31,12836,20054,32890
95,95001,1989-12-31,14147,20729,34876
95,95001,1990-12-31,15640,21119,36759
95,95001,1991-12-31,17161,21281,38442
95,95001,1992-12-31,18777,21253,40030
95,95001,1993-12-31,20522,21034,41556
95,95001,1994-12-31,22232,20697,42929
95,95001,1995-12-31,23942,20235,44177
95,95001,1996-12-31,25533,19812,45345
95,95001,1997-12-31,26987,19422,46409
95,95001,1998-12-31,28219,19059,47278
95,95001,1999-12-31,29350,18726,48076
95,95001,2000-12-31,30306,18452,48758
95,95001,2001-12-31,31032,18199,49231
95,95001,2002-12-31,31577,17922,49499
95,95001,2003-12-31,31934,17684,49618
95,95001,2004-12-31,32190,17402,49592
95,95001,2005-12-31,32158,17033,49191
95,95001,2006-12-31,32070,16709,48779
95,95001,2007-12-31,32034,16444,48478
95,95001,2008-12-31,32029,16207,48236
95,95001,2009-12-31,32105,15990,48095
95,95001,2010-12-31,32227,15858,48085
95,95001,2011-12-31,32432,15779,48211
95,95001,2012-12-31,32698,15730,48428
95,95001,2013-12-31,33042,15725,48767
95,95001,2014-12-31,33496,15772,49268
95,95001,2015-12-31,33980,15855,49835
95,95001,2016-12-31,34611,15997,50608
95,95001,2017-12-31,35342,16167,51509
95,95001,2018-12-31,36354,16461,52815
95,95001,2019-12-31,37557,16776,54333
95,95001,2020-12-31,38684,17136,55820
95,95001,2021-12-31,39613,17391,57004
95,95001,2022-12-31,40512,17694,58206
95,95001,2023-12-31,41412,18034,59446
95,95001,2024-12-31,42316,18387,60703
95,95001,2025-12-31,43172,18734,61906
95,95001,2026-12-31,43997,19105,63102
95,95001,2027-12-31,44793,19485,64278
95,95001,2028-12-31,45538,19872,65410
95,95001,2029-12-31,46254,20272,66526
95,95001,2030-12-31,46920,20684,67604
95,95001,2031-12-31,47541,21107,68648
95,95001,2032-12-31,48174,21527,69701
95,95001,2033-12-31,48772,21969,70741
95,95001,2034-12-31,49364,22407,71771
95,95001,2035-12-31,49940,22857,72797
95,95015,1985-12-31,424,2178,2602
95,95015,1986-12-31,553,2413,2966
95,95015,1987-12-31,682,2686,3368
95,95015,1988-12-31,826,2933,3759
95,95015,1989-12-31,979,3158,4137
95,95015,1990-12-31,1125,3349,4474
95,95015,1991-12-31,1310,3511,4821
95,95015,1992-12-31,1503,3619,5122
95,95015,1993-12-31,1704,3728,5432
95,95015,1994-12-31,1913,3787,5700
95,95015,1995-12-31,2118,3862,5980
95,95015,1996-12-31,2334,3886,6220
95,95015,1997-12-31,2515,3929,6444
95,95015,1998-12-31,2786,3946,6732
95,95015,1999-12-31,2940,3979,6919
95,95015,2000-12-31,3066,4032,7098
95,95015,2001-12-31,3185,4094,7279
95,95015,2002-12-31,3289,4150,7439
95,95015,2003-12-31,3379,4147,7526
95,95015,2004-12-31,3454,4194,7648
95,95015,2005-12-31,3486,4205,7691
95,95015,2006-12-31,3504,4200,7704
95,95015,2007-12-31,3541,4225,7766
95,95015,2008-12-31,3575,4251,7826
95,95015,2009-12-31,3604,4293,7897
95,95015,2010-12-31,3639,4347,7986
95,95015,2011-12-31,3727,4397,8124
95,95015,2012-12-31,3775,4465,8240
95,95015,2013-12-31,3870,4551,8421
95,95015,2014-12-31,3932,4648,8580
95,95015,2015-12-31,3992,4755,8747
95,95015,2016-12-31,4113,4863,8976
95,95015,2017-12-31,4238,5026,9264
95,95015,2018-12-31,4339,5189,9528
95,95015,2019-12-31,4482,5319,9801
95,95015,2020-12-31,4617,5452,10069
95,95015,2021-12-31,4749,5533,10282
95,95015,2022-12-31,4869,5630,10499
95,95015,2023-12-31,4986,5737,10723
95,95015,2024-12-31,5102,5842,10944
95,95015,2025-12-31,5202,5969,11171
95,95015,2026-12-31,5307,6073,11380
95,95015,2027-12-31,5399,6179,11578
95,95015,2028-12-31,5482,6306,11788
95,95015,2029-12-31,5565,6437,12002
95,95015,2030-12-31,5643,6564,12207
95,95015,2031-12-31,5726,6712,12438
95,95015,2032-12-31,5795,6871,12666
95,95015,2033-12-31,5857,7012,12869
95,95015,2034-12-31,5928,7162,13090
95,95015,2035-12-31,5996,7305,13301
95,95025,1985-12-31,450,2322,2772
95,95025,1986-12-31,461,2859,3320
95,95025,1987-12-31,591,3357,3948
95,95025,1988-12-31,646,3817,4463
95,95025,1989-12-31,801,4260,5061
95,95025,1990-12-31,923,4666,5589
95,95025,1991-12-31,1067,5017,6084
95,95025,1992-12-31,1228,5316,6544
95,95025,1993-12-31,1401,5652,7053
95,95025,1994-12-31,1556,5858,7414
95,95025,1995-12-31,1716,5991,7707
95,95025,1996-12-31,1914,6182,8096
95,95025,1997-12-31,2065,6316,8381
95,95025,1998-12-31,2194,6475,8669
95,95025,1999-12-31,2321,6662,8983
95,95025,2000-12-31,2441,6781,9222
95,95025,2001-12-31,2523,6913,9436
95,95025,2002-12-31,2602,7064,9666
95,95025,2003-12-31,2689,7205,9894
95,95025,2004-12-31,2713,7331,10044
95,95025,2005-12-31,2727,7435,10162
95,95025,2006-12-31,2752,7561,10313
95,95025,2007-12-31,2761,7681,10442
95,95025,2008-12-31,2782,7812,10594
95,95025,2009-12-31,2812,7961,10773
95,95025,2010-12-31,2860,8136,10996
95,95025,2011-12-31,2862,8327,11189
95,95025,2012-12-31,2929,8534,11463
95,95025,2013-12-31,2963,8745,11708
95,95025,2014-12-31,2993,8985,11978
95,95025,2015-12-31,3127,9255,12382
95,95025,2016-12-31,3190,9558,12748
95,95025,2017-12-31,3255,9876,13131
95,95025,2018-12-31,3355,10298,13653
95,95025,2019-12-31,3466,10218,13684
95,95025,2020-12-31,3570,10152,13722
95,95025,2021-12-31,3709,10301,14010
95,95025,2022-12-31,3825,10481,14306
95,95025,2023-12-31,3929,10681,14610
95,95025,2024-12-31,4010,10883,14893
95,95025,2025-12-31,4101,11099,15200
95,95025,2026-12-31,4178,11315,15493
95,95025,2027-12-31,4249,11545,15794
95,95025,2028-12-31,4323,11783,16106
95,95025,2029-12-31,4386,12025,16411
95,95025,2030-12-31,4453,12279,16732
95,95025,2031-12-31,4510,12543,17053
95,95025,2032-12-31,4563,12813,17376
95,95025,2033-12-31,4628,13109,17737
95,95025,2034-12-31,4679,13396,18075
95,95025,2035-12-31,4741,13681,18422
95,95200,1985-12-31,1009,2877,3886
95,95200,1986-12-31,1095,3192,4287
95,95200,1987-12-31,1167,3471,4638
95,95200,1988-12-31,1281,3727,5008
95,95200,1989-12-31,1345,3941,5286
95,95200,1990-12-31,1385,4126,5511
95,95200,1991-12-31,1471,4244,5715
95,95200,1992-12-31,1571,4329,5900
95,95200,1993-12-31,1660,4330,5990
95,95200,1994-12-31,1752,4295,6047
95,95200,1995-12-31,1842,4339,6181
95,95200,1996-12-31,1894,4305,6199
95,95200,1997-12-31,1984,4300,6284
95,95200,1998-12-31,2032,4302,6334
95,95200,1999-12-31,2059,4292,6351
95,95200,2000-12-31,2068,4301,6369
95,95200,2001-12-31,2083,4314,6397
95,95200,2002-12-31,2081,4321,6402
95,95200,2003-12-31,2069,4335,6404
95,95200,2004-12-31,2014,4337,6351
95,95200,2005-12-31,1973,4279,6252
95,95200,2006-12-31,1954,4251,6205
95,95200,2007-12-31,1924,4219,6143
95,95200,2008-12-31,1916,4214,6130
95,95200,2009-12-31,1883,4252,6135
95,95200,2010-12-31,1874,4253,6127
95,95200,2011-12-31,1854,4274,6128
95,95200,2012-12-31,1840,4310,6150
95,95200,2013-12-31,1827,4369,6196
95,95200,2014-12-31,1846,4429,6275
95,95200,2015-12-31,1857,4507,6364
95,95200,2016-12-31,1859,4605,6464
95,95200,2017-12-31,1898,4705,6603
95,95200,2018-12-31,1943,4828,6771
95,95200,2019-12-31,1874,5024,6898
95,95200,2020-12-31,1848,5198,7046
95,95200,2021-12-31,1919,5275,7194
95,95200,2022-12-31,1979,5367,7346
95,95200,2023-12-31,2032,5470,7502
95,95200,2024-12-31,2070,5572,7642
95,95200,2025-12-31,2115,5659,7774
95,95200,2026-12-31,2152,5767,7919
95,95200,2027-12-31,2188,5875,8063
95,95200,2028-12-31,2228,5976,8204
95,95200,2029-12-31,2252,6083,8335
95,95200,2030-12-31,2276,6208,8484
95,95200,2031-12-31,2316,6315,8631
95,95200,2032-12-31,2343,6408,8751
95,95200,2033-12-31,2381,6470,8851
95,95200,2034-12-31,2411,6532,8943
95,95200,2035-12-31,2431,6592,9023
97,97001,1985-12-31,2878,5692,8570
97,97001,1986-12-31,2850,5862,8712
97,97001,1987-12-31,2919,6093,9012
97,97001,1988-12-31,2988,6395,9383
97,97001,1989-12-31,3111,6675,9786
97,97001,1990-12-31,3185,6914,10099
97,97001,1991-12-31,3281,7157,10438
97,97001,1992-12-31,3431,7382,10813
97,97001,1993-12-31,3602,7630,11232
97,97001,1994-12-31,3718,7868,11586
97,97001,1995-12-31,3920,8058,11978
97,97001,1996-12-31,4054,8260,12314
97,97001,1997-12-31,4224,8519,12743
97,97001,1998-12-31,4408,8849,13257
97,97001,1999-12-31,4672,9183,13855
97,97001,2000-12-31,4910,9589,14499
97,97001,2001-12-31,5146,10022,15168
97,97001,2002-12-31,5401,10556,15957
97,97001,2003-12-31,5660,11166,16826
97,97001,2004-12-31,5948,11712,17660
97,97001,2005-12-31,6218,12342,18560
97,97001,2006-12-31,6487,12924,19411
97,97001,2007-12-31,6757,13516,20273
97,97001,2008-12-31,7045,14155,21200
97,97001,2009-12-31,7367,14812,22179
97,97001,2010-12-31,7641,15480,23121
97,97001,2011-12-31,7912,16123,24035
97,97001,2012-12-31,8204,16732,24936
97,97001,2013-12-31,8500,17263,25763
97,97001,2014-12-31,8771,17871,26642
97,97001,2015-12-31,9033,18430,27463
97,97001,2016-12-31,9313,19012,28325
97,97001,2017-12-31,9541,19526,29067
97,97001,2018-12-31,9746,20104,29850
97,97001,2019-12-31,10072,21230,31302
97,97001,2020-12-31,10399,22394,32793
97,97001,2021-12-31,10756,23551,34307
97,97001,2022-12-31,11117,24721,35838
97,97001,2023-12-31,11483,25941,37424
97,97001,2024-12-31,11848,27209,39057
97,97001,2025-12-31,12199,28476,40675
97,97001,2026-12-31,12535,29778,42313
97,97001,2027-12-31,12849,31081,43930
97,97001,2028-12-31,13157,32420,45577
97,97001,2029-12-31,13429,33766,47195
97,97001,2030-12-31,13707,35163,48870
97,97001,2031-12-31,13964,36666,50630
97,97001,2032-12-31,14206,38295,52501
97,97001,2033-12-31,14450,39958,54408
97,97001,2034-12-31,14695,41733,56428
97,97001,2035-12-31,14925,43730,58655
97,97161,1985-12-31,91,1350,1441
97,97161,1986-12-31,149,1139,1288
97,97161,1987-12-31,204,1189,1393
97,97161,1988-12-31,245,1138,1383
97,97161,1989-12-31,233,1110,1343
97,97161,1990-12-31,233,1079,1312
97,97161,1991-12-31,268,1031,1299
97,97161,1992-12-31,278,1021,1299
97,97161,1993-12-31,298,992,1290
97,97161,1994-12-31,367,918,1285
97,97161,1995-12-31,376,931,1307
97,97161,1996-12-31,451,924,1375
97,97161,1997-12-31,489,937,1426
97,97161,1998-12-31,513,930,1443
97,97161,1999-12-31,546,937,1483
97,97161,2000-12-31,548,961,1509
97,97161,2001-12-31,588,974,1562
97,97161,2002-12-31,624,1025,1649
97,97161,2003-12-31,682,1060,1742
97,97161,2004-12-31,726,1091,1817
97,97161,2005-12-31,778,1160,1938
97,97161,2006-12-31,834,1182,2016
97,97161,2007-12-31,859,1194,2053
97,97161,2008-12-31,914,1221,2135
97,97161,2009-12-31,966,1270,2236
97,97161,2010-12-31,1021,1288,2309
97,97161,2011-12-31,1074,1332,2406
97,97161,2012-12-31,1120,1347,2467
97,97161,2013-12-31,1172,1414,2586
97,97161,2014-12-31,1215,1437,2652
97,97161,2015-12-31,1255,1455,2710
97,97161,2016-12-31,1291,1477,2768
97,97161,2017-12-31,1341,1530,2871
97,97161,2018-12-31,1387,1528,2915
97,97161,2019-12-31,1451,1605,3056
97,97161,2020-12-31,1526,1675,3201
97,97161,2021-12-31,1588,1761,3349
97,97161,2022-12-31,1649,1849,3498
97,97161,2023-12-31,1713,1940,3653
97,97161,2024-12-31,1776,2033,3809
97,97161,2025-12-31,1825,2137,3962
97,97161,2026-12-31,1883,2237,4120
97,97161,2027-12-31,1933,2326,4259
97,97161,2028-12-31,1982,2409,4391
97,97161,2029-12-31,2038,2494,4532
97,97161,2030-12-31,2075,2576,4651
97,97161,2031-12-31,2118,2638,4756
97,97161,2032-12-31,2162,2675,4837
97,97161,2033-12-31,2201,2708,4909
97,97161,2034-12-31,2239,2746,4985
97,97161,2035-12-31,2281,2769,5050
97,97511,1985-12-31,0,808,808
97,97511,1986-12-31,0,922,922
97,97511,1987-12-31,0,999,999
97,97511,1988-12-31,0,1092,1092
97,97511,1989-12-31,0,1166,1166
97,97511,1990-12-31,0,1207,1207
97,97511,1991-12-31,0,1293,1293
97,97511,1992-12-31,0,1319,1319
97,97511,1993-12-31,0,1419,1419
97,97511,1994-12-31,0,1495,1495
97,97511,1995-12-31,0,1534,1534
97,97511,1996-12-31,0,1582,1582
97,97511,1997-12-31,0,1623,1623
97,97511,1998-12-31,0,1692,1692
97,97511,1999-12-31,0,1789,1789
97,97511,2000-12-31,0,1898,1898
97,97511,2001-12-31,0,2009,2009
97,97511,2002-12-31,0,2126,2126
97,97511,2003-12-31,0,2200,2200
97,97511,2004-12-31,0,2359,2359
97,97511,2005-12-31,0,2503,2503
97,97511,2006-12-31,0,2635,2635
97,97511,2007-12-31,0,2741,2741
97,97511,2008-12-31,0,2858,2858
97,97511,2009-12-31,0,2993,2993
97,97511,2010-12-31,0,3122,3122
97,97511,2011-12-31,0,3239,3239
97,97511,2012-12-31,0,3353,3353
97,97511,2013-12-31,0,3473,3473
97,97511,2014-12-31,0,3609,3609
97,97511,2015-12-31,0,3724,3724
97,97511,2016-12-31,0,3827,3827
97,97511,2017-12-31,0,3953,3953
97,97511,2018-12-31,0,4042,4042
97,97511,2019-12-31,0,4229,4229
97,97511,2020-12-31,0,4422,4422
97,97511,2021-12-31,0,4649,4649
97,97511,2022-12-31,0,4881,4881
97,97511,2023-12-31,0,5121,5121
97,97511,2024-12-31,0,5353,5353
97,97511,2025-12-31,0,5617,5617
97,97511,2026-12-31,0,5868,5868
97,97511,2027-12-31,0,6118,6118
97,97511,2028-12-31,0,6368,6368
97,97511,2029-12-31,0,6591,6591
97,97511,2030-12-31,0,6790,6790
97,97511,2031-12-31,0,6921,6921
97,97511,2032-12-31,0,6969,6969
97,97511,2033-12-31,0,7008,7008
97,97511,2034-12-31,0,6941,6941
97,97511,2035-12-31,0,6690,6690
97,97666,1985-12-31,12,307,319
97,97666,1986-12-31,91,402,493
97,97666,1987-12-31,84,400,484
97,97666,1988-12-31,92,371,463
97,97666,1989-12-31,109,414,523
97,97666,1990-12-31,182,428,610
97,97666,1991-12-31,197,456,653
97,97666,1992-12-31,212,452,664
97,97666,1993-12-31,215,447,662
97,97666,1994-12-31,236,495,731
97,97666,1995-12-31,248,502,750
97,97666,1996-12-31,263,548,811
97,97666,1997-12-31,293,550,843
97,97666,1998-12-31,320,570,890
97,97666,1999-12-31,302,591,893
97,97666,2000-12-31,352,626,978
97,97666,2001-12-31,392,645,1037
97,97666,2002-12-31,432,685,1117
97,97666,2003-12-31,452,720,1172
97,97666,2004-12-31,487,739,1226
97,97666,2005-12-31,529,792,1321
97,97666,2006-12-31,569,831,1400
97,97666,2007-12-31,642,869,1511
97,97666,2008-12-31,662,902,1564
97,97666,2009-12-31,674,939,1613
97,97666,2010-12-31,728,975,1703
97,97666,2011-12-31,773,1013,1786
97,97666,2012-12-31,804,1065,1869
97,97666,2013-12-31,807,1110,1917
97,97666,2014-12-31,829,1133,1962
97,97666,2015-12-31,863,1186,2049
97,97666,2016-12-31,877,1207,2084
97,97666,2017-12-31,920,1243,2163
97,97666,2018-12-31,957,1258,2215
97,97666,2019-12-31,989,1329,2318
97,97666,2020-12-31,1022,1401,2423
97,97666,2021-12-31,1061,1473,2534
97,97666,2022-12-31,1100,1547,2647
97,97666,2023-12-31,1142,1623,2765
97,97666,2024-12-31,1173,1695,2868
97,97666,2025-12-31,1217,1757,2974
97,97666,2026-12-31,1250,1840,3090
97,97666,2027-12-31,1294,1932,3226
97,97666,2028-12-31,1324,2018,3342
97,97666,2029-12-31,1363,2114,3477
97,97666,2030-12-31,1392,2174,3566
97,97666,2031-12-31,1421,2259,3680
97,97666,2032-12-31,1458,2356,3814
97,97666,2033-12-31,1491,2451,3942
97,97666,2034-12-31,1518,2534,4052
97,97666,2035-12-31,1551,2616,4167
97,97777,1985-12-31,0,294,294
97,97777,1986-12-31,0,385,385
97,97777,1987-12-31,0,362,362
97,97777,1988-12-31,0,356,356
97,97777,1989-12-31,0,311,311
97,97777,1990-12-31,0,310,310
97,97777,1991-12-31,0,301,301
97,97777,1992-12-31,0,355,355
97,97777,1993-12-31,0,334,334
97,97777,1994-12-31,0,333,333
97,97777,1995-12-31,0,359,359
97,97777,1996-12-31,0,371,371
97,97777,1997-12-31,0,397,397
97,97777,1998-12-31,0,404,404
97,97777,1999-12-31,0,411,411
97,97777,2000-12-31,0,414,414
97,97777,2001-12-31,0,452,452
97,97777,2002-12-31,0,413,413
97,97777,2003-12-31,0,425,425
97,97777,2004-12-31,0,452,452
97,97777,2005-12-31,0,474,474
97,97777,2006-12-31,0,458,458
97,97777,2007-12-31,0,549,549
97,97777,2008-12-31,0,564,564
97,97777,2009-12-31,0,569,569
97,97777,2010-12-31,0,589,589
97,97777,2011-12-31,0,588,588
97,97777,2012-12-31,0,632,632
97,97777,2013-12-31,0,671,671
97,97777,2014-12-31,0,667,667
97,97777,2015-12-31,0,699,699
97,97777,2016-12-31,0,715,715
97,97777,2017-12-31,0,726,726
97,97777,2018-12-31,0,727,727
97,97777,2019-12-31,0,749,749
97,97777,2020-12-31,0,776,776
97,97777,2021-12-31,0,816,816
97,97777,2022-12-31,0,857,857
97,97777,2023-12-31,0,899,899
97,97777,2024-12-31,0,935,935
97,97777,2025-12-31,0,970,970
97,97777,2026-12-31,0,1013,1013
97,97777,2027-12-31,0,1059,1059
97,97777,2028-12-31,0,1106,1106
97,97777,2029-12-31,0,1159,1159
97,97777,2030-12-31,0,1221,1221
97,97777,2031-12-31,0,1261,1261
97,97777,2032-12-31,0,1300,1300
97,97777,2033-12-31,0,1338,1338
97,97777,2034-12-31,0,1393,1393
97,97777,2035-12-31,0,1442,1442
97,97889,1985-12-31,0,516,516
97,97889,1986-12-31,0,573,573
97,97889,1987-12-31,0,542,542
97,97889,1988-12-31,0,528,528
97,97889,1989-12-31,0,500,500
97,97889,1990-12-31,0,517,517
97,97889,1991-12-31,0,504,504
97,97889,1992-12-31,0,491,491
97,97889,1993-12-31,0,483,483
97,97889,1994-12-31,0,486,486
97,97889,1995-12-31,0,501,501
97,97889,1996-12-31,0,509,509
97,97889,1997-12-31,0,521,521
97,97889,1998-12-31,0,541,541
97,97889,1999-12-31,0,566,566
97,97889,2000-12-31,0,577,577
97,97889,2001-12-31,0,622,622
97,97889,2002-12-31,0,652,652
97,97889,2003-12-31,0,682,682
97,97889,2004-12-31,0,722,722
97,97889,2005-12-31,0,665,665
97,97889,2006-12-31,0,738,738
97,97889,2007-12-31,0,754,754
97,97889,2008-12-31,0,802,802
97,97889,2009-12-31,0,804,804
97,97889,2010-12-31,0,833,833
97,97889,2011-12-31,0,886,886
97,97889,2012-12-31,0,908,908
97,97889,2013-12-31,0,943,943
97,97889,2014-12-31,0,977,977
97,97889,2015-12-31,0,993,993
97,97889,2016-12-31,0,1018,1018
97,97889,2017-12-31,0,1031,1031
97,97889,2018-12-31,0,1048,1048
97,97889,2019-12-31,0,1067,1067
97,97889,2020-12-31,0,1097,1097
97,97889,2021-12-31,0,1153,1153
97,97889,2022-12-31,0,1211,1211
97,97889,2023-12-31,0,1271,1271
97,97889,2024-12-31,0,1336,1336
97,97889,2025-12-31,0,1404,1404
97,97889,2026-12-31,0,1457,1457
97,97889,2027-12-31,0,1531,1531
97,97889,2028-12-31,0,1591,1591
97,97889,2029-12-31,0,1656,1656
97,97889,2030-12-31,0,1728,1728
97,97889,2031-12-31,0,1806,1806
97,97889,2032-12-31,0,1887,1887
97,97889,2033-12-31,0,1976,1976
97,97889,2034-12-31,0,2073,2073
97,97889,2035-12-31,0,2178,2178
99,99001,1985-12-31,9640,7327,16967
99,99001,1986-12-31,9617,6821,16438
99,99001,1987-12-31,9746,6482,16228
99,99001,1988-12-31,9895,6148,16043
99,99001,1989-12-31,10041,5915,15956
99,99001,1990-12-31,10169,5691,15860
99,99001,1991-12-31,10279,5524,15803
99,99001,1992-12-31,10445,5397,15842
99,99001,1993-12-31,10655,5286,15941
99,99001,1994-12-31,10832,5195,16027
99,99001,1995-12-31,11025,5134,16159
99,99001,1996-12-31,11254,5099,16353
99,99001,1997-12-31,11491,5061,16552
99,99001,1998-12-31,11744,5056,16800
99,99001,1999-12-31,12009,5068,17077
99,99001,2000-12-31,12215,5091,17306
99,99001,2001-12-31,12449,5106,17555
99,99001,2002-12-31,12685,5110,17795
99,99001,2003-12-31,12921,5139,18060
99,99001,2004-12-31,13126,5180,18306
99,99001,2005-12-31,13381,5225,18606
99,99001,2006-12-31,13573,5274,18847
99,99001,2007-12-31,13780,5311,19091
99,99001,2008-12-31,13955,5352,19307
99,99001,2009-12-31,14120,5409,19529
99,99001,2010-12-31,14254,5473,19727
99,99001,2011-12-31,14395,5519,19914
99,99001,2012-12-31,14469,5578,20047
99,99001,2013-12-31,14564,5572,20136
99,99001,2014-12-31,14626,5661,20287
99,99001,2015-12-31,14693,5706,20399
99,99001,2016-12-31,14782,5771,20553
99,99001,2017-12-31,14797,5849,20646
99,99001,2018-12-31,14974,5962,20936
99,99001,2019-12-31,15418,5056,20474
99,99001,2020-12-31,15697,4597,20294
99,99001,2021-12-31,15911,4667,20578
99,99001,2022-12-31,16069,4729,20798
99,99001,2023-12-31,16216,4791,21007
99,99001,2024-12-31,16224,4866,21090
99,99001,2025-12-31,16222,4938,21160
99,99001,2026-12-31,16222,5006,21228
99,99001,2027-12-31,16252,5074,21326
99,99001,2028-12-31,16281,5157,21438
99,99001,2029-12-31,16317,5235,21552
99,99001,2030-12-31,16364,5331,21695
99,99001,2031-12-31,16416,5418,21834
99,99001,2032-12-31,16441,5514,21955
99,99001,2033-12-31,16482,5598,22080
99,99001,2034-12-31,16511,5690,22201
99,99001,2035-12-31,16528,5776,22304
99,99524,1985-12-31,1699,5617,7316
99,99524,1986-12-31,1867,5233,7100
99,99524,1987-12-31,2009,4960,6969
99,99524,1988-12-31,2166,4691,6857
99,99524,1989-12-31,2307,4509,6816
99,99524,1990-12-31,2398,4355,6753
99,99524,1991-12-31,2568,4230,6798
99,99524,1992-12-31,2689,4127,6816
99,99524,1993-12-31,2827,4042,6869
99,99524,1994-12-31,2956,3967,6923
99,99524,1995-12-31,3097,3912,7009
99,99524,1996-12-31,3250,3870,7120
99,99524,1997-12-31,3343,3846,7189
99,99524,1998-12-31,3505,3828,7333
99,99524,1999-12-31,3634,3829,7463
99,99524,2000-12-31,3780,3838,7618
99,99524,2001-12-31,3907,3857,7764
99,99524,2002-12-31,4062,3869,7931
99,99524,2003-12-31,4207,3906,8113
99,99524,2004-12-31,4333,3948,8281
99,99524,2005-12-31,4450,3985,8435
99,99524,2006-12-31,4565,4018,8583
99,99524,2007-12-31,4671,4064,8735
99,99524,2008-12-31,4783,4119,8902
99,99524,2009-12-31,4890,4135,9025
99,99524,2010-12-31,4993,4161,9154
99,99524,2011-12-31,5093,4210,9303
99,99524,2012-12-31,5167,4259,9426
99,99524,2013-12-31,5284,4300,9584
99,99524,2014-12-31,5323,4344,9667
99,99524,2015-12-31,5371,4384,9755
99,99524,2016-12-31,5431,4432,9863
99,99524,2017-12-31,5564,4482,10046
99,99524,2018-12-31,5586,4536,10122
99,99524,2019-12-31,5823,3976,9799
99,99524,2020-12-31,5996,3612,9608
99,99524,2021-12-31,6076,3667,9743
99,99524,2022-12-31,6130,3716,9846
99,99524,2023-12-31,6181,3765,9946
99,99524,2024-12-31,6195,3820,10015
99,99524,2025-12-31,6204,3870,10074
99,99524,2026-12-31,6209,3932,10141
99,99524,2027-12-31,6214,3993,10207
99,99524,2028-12-31,6221,4060,10281
99,99524,2029-12-31,6233,4113,10346
99,99524,2030-12-31,6260,4187,10447
99,99524,2031-12-31,6268,4259,10527
99,99524,2032-12-31,6296,4330,10626
99,99524,2033-12-31,6313,4403,10716
99,99524,2034-12-31,6314,4472,10786
99,99524,2035-12-31,6314,4538,10852
99,99624,1985-12-31,549,1491,2040
99,99624,1986-12-31,675,1506,2181
99,99624,1987-12-31,744,1311,2055
99,99624,1988-12-31,794,1385,2179
99,99624,1989-12-31,845,1241,2086
99,99624,1990-12-31,923,1216,2139
99,99624,1991-12-31,998,1207,2205
99,99624,1992-12-31,1051,1184,2235
99,99624,1993-12-31,1090,1187,2277
99,99624,1994-12-31,1190,1187,2377
99,99624,1995-12-31,1234,1165,2399
99,99624,1996-12-31,1310,1233,2543
99,99624,1997-12-31,1374,1256,2630
99,99624,1998-12-31,1411,1267,2678
99,99624,1999-12-31,1474,1274,2748
99,99624,2000-12-31,1542,1188,2730
99,99624,2001-12-31,1615,1220,2835
99,99624,2002-12-31,1682,1253,2935
99,99624,2003-12-31,1730,1283,3013
99,99624,2004-12-31,1803,1311,3114
99,99624,2005-12-31,1860,1332,3192
99,99624,2006-12-31,1946,1396,3342
99,99624,2007-12-31,1986,1416,3402
99,99624,2008-12-31,2035,1444,3479
99,99624,2009-12-31,2078,1460,3538
99,99624,2010-12-31,2128,1484,3612
99,99624,2011-12-31,2146,1511,3657
99,99624,2012-12-31,2188,1525,3713
99,99624,2013-12-31,2210,1556,3766
99,99624,2014-12-31,2257,1579,3836
99,99624,2015-12-31,2305,1611,3916
99,99624,2016-12-31,2301,1641,3942
99,99624,2017-12-31,2355,1673,4028
99,99624,2018-12-31,2383,1676,4059
99,99624,2019-12-31,2526,1604,4130
99,99624,2020-12-31,2643,1550,4193
99,99624,2021-12-31,2679,1573,4252
99,99624,2022-12-31,2702,1595,4297
99,99624,2023-12-31,2724,1616,4340
99,99624,2024-12-31,2729,1638,4367
99,99624,2025-12-31,2745,1667,4412
99,99624,2026-12-31,2762,1683,4445
99,99624,2027-12-31,2770,1710,4480
99,99624,2028-12-31,2781,1728,4509
99,99624,2029-12-31,2796,1764,4560
99,99624,2030-12-31,2803,1800,4603
99,99624,2031-12-31,2820,1824,4644
99,99624,2032-12-31,2836,1854,4690
99,99624,2033-12-31,2839,1883,4722
99,99624,2034-12-31,2851,1917,4768
99,99624,2035-12-31,2861,1945,4806
99,99773,1985-12-31,703,14214,14917
99,99773,1986-12-31,834,16073,16907
99,99773,1987-12-31,903,17882,18785
99,99773,1988-12-31,971,19399,20370
99,99773,1989-12-31,1047,20956,22003
99,99773,1990-12-31,1150,22387,23537
99,99773,1991-12-31,1214,23735,24949
99,99773,1992-12-31,1306,25097,26403
99,99773,1993-12-31,1384,26479,27863
99,99773,1994-12-31,1423,27849,29272
99,99773,1995-12-31,1519,29252,30771
99,99773,1996-12-31,1546,30611,32157
99,99773,1997-12-31,1660,32056,33716
99,99773,1998-12-31,1723,33565,35288
99,99773,1999-12-31,1801,35106,36907
99,99773,2000-12-31,1904,36774,38678
99,99773,2001-12-31,1999,38370,40369
99,99773,2002-12-31,2060,40042,42102
99,99773,2003-12-31,2133,41715,43848
99,99773,2004-12-31,2219,43408,45627
99,99773,2005-12-31,2270,45141,47411
99,99773,2006-12-31,2333,46873,49206
99,99773,2007-12-31,2396,48691,51087
99,99773,2008-12-31,2465,50500,52965
99,99773,2009-12-31,2516,52383,54899
99,99773,2010-12-31,2571,54250,56821
99,99773,2011-12-31,2613,56115,58728
99,99773,2012-12-31,2682,57981,60663
99,99773,2013-12-31,2696,59875,62571
99,99773,2014-12-31,2745,61693,64438
99,99773,2015-12-31,2772,63550,66322
99,99773,2016-12-31,2817,65488,68305
99,99773,2017-12-31,2821,67518,70339
99,99773,2018-12-31,2890,69801,72691
99,99773,2019-12-31,3143,73053,76196
99,99773,2020-12-31,3373,75490,78863
99,99773,2021-12-31,3336,76648,79984
99,99773,2022-12-31,3156,77681,80837
99,99773,2023-12-31,2950,78701,81651
99,99773,2024-12-31,2940,79752,82692
99,99773,2025-12-31,2940,80861,83801
99,99773,2026-12-31,2949,82042,84991
99,99773,2027-12-31,2949,83286,86235
99,99773,2028-12-31,2957,84592,87549
99,99773,2029-12-31,2964,85974,88938
99,99773,2030-12-31,2968,87402,90370
99,99773,2031-12-31,2979,88900,91879
99,99773,2032-12-31,2985,90382,93367
99,99773,2033-12-31,2986,91867,94853
99,99773,2034-12-31,2992,93327,96319
99,99773,2035-12-31,3001,94793,97794
